节奏蓝调	Rhythm and blues 
吴海燕_(足球运动员)	Wu Haiyan_ (football player) 
+34	+34 
迪比沙林	Dibisarin 
马科恩-赖肖尔表记法	Markon-Reishol Table Notation 
芬兰-拉普语族	Finnish-Lappish 
电击hp	Electric shock hp 
格斗漫画	Fighting comics 
冲上云霄	Rush to the sky 
美国第1装甲军	U.S. 1st Armored Corps 
李昶旻	Li Changmin 
公共安全委员会	Public Safety Committee 
天主教纽西兰军中教长区	Catholic New Zealand Army Central District 
大连晟威	Dalian Shengwei 
博南扎_(犹他州)	Bonanza_ (Utah) 
巴卢韦利体育俱乐部	Barueri Sports Club 
瓦卢瓦王朝	Valois 
萨克森—科堡-哥达王朝	Saxony-Coburg-Gotha Dynasty 
南洋公学	Nanyang College 
李仙蕙	Li Xianhui 
盟国管制理事会	Allied Control Council 
川嶋纪子	Itoko Kawashima 
横东罕	Yokotohan 
台湾国训足球队	Taiwan National Football Team 
菅野信三	Shinzo Kanno 
南丹麦大区	Region of Southern Denmark 
新制度经济学	New Institutional Economics 
柏林普鲁士网球俱乐部	Prussian Tennis Club Berlin 
来自未来的史密特	Schmidt from the future 
痞子英雄	Ruffian hero 
大仪见优季	Ogimi Yuki 
格鲁吉亚总理	Prime Minister of Georgia 
澳大利亚外交部	Australian Ministry of Foreign Affairs 
李斯特城足球俱乐部	Liszt City Football Club 
广东日之泉足球俱乐部	Guangdong Sun Spring Football Club 
尚穆根·贾古玛	Shanmugen Jagumar 
奥地利经济学派	Austrian School of Economics 
绿色政治	Green politics 
【国家重点项目】	【National Key Project】 
万岁胜利者的桂冠	Long live the winner's crown 
张继正	Zhang Jizheng 
鞭笞核	Flogging nucleus 
london唱片公司	london record company 
秀逗魔导士	Sorcerer 
tatoi	τατόι 
向华强	Xiang Huaqiang 
广州美术学院	Guangzhou Art College 
国际共产主义研讨会	International Communism Symposium 
爱达荷州第二国会选区	Idaho Second Congressional District 
工商管理硕士	Master of Business Administration 
我的忆万面包	My Yiwan Bread 
怀旧女郎	Nostalgic girl 
藤原宫子	Fujiwara Miyako 
共同电视	Co-TV 
普利亚大公国	Grand Duchy of Puglia 
朝鲜劳动党永远的总书记	Permanent Secretary of the Workers' Party of Korea 
干拿	Dry 
仁义里	Renyili 
巴黎第五区	Paris 5th district 
韩国行政区划	Administrative divisions of South Korea 
生态社会主义	Ecological socialism 
保科正直	Hoshina Masanao 
英国首相_联合王国首相	Prime Minister of the United Kingdom_Prime Minister of the United Kingdom 
奥马哈_(内布拉斯加州)	Omaha_ (Nebraska) 
渡辺国武	Watanabe Kunitake 
波利尼西亚语支	Polynesian branch 
张卫_(足球运动员)	Zhang Wei_ (football player) 
米尔福德黑文侯爵	Marquis of Milford Haven 
副省级市	Vice-provincial city 
亚洲科技	Asia Technology 
卢森堡货运航空	Cargo Luxembourg 
冯王妃_(东宁)	Princess Feng_(Dongning) 
特林素体育会	Trinso Sports Club 
格芬公园球场	Geffen Park 
马丁吉他	Martin guitar 
比拉马体育会	Birama Sports Club 
邹欣倪	Zou Xinni 
卡尔九世	Karl IX 
爱的圆舞曲	Waltz of love 
广体飞机	Wide-body aircraft 
卫理钦	Wei Liqin 
巴蒂亚·宾特·哈桑公主	Princess Bhatia Bint Hassan 
旧量子论	Old quantum theory 
英国国防部	British Ministry of Defence 
krugozor	horizon 
俄勒冈大学	University of Oregon 
艾林文高	Ailing Wengao 
织田信孝	Oda Nobutaka 
丰臣氏	Toyotomi 
深圳宝安国际机场	Shenzhen Baoan International airport 
罗富国	Luo Fuguo 
snobol	Snowball 
其米德·赛汗比勒格	Qimid Saihanbileg 
猪狩祐贵	Yuki Igari 
法国司法部	French Ministry of Justice 
头文字d	Initial d 
潮汕话	Chaoshan dialect 
肇庆市体育中心	Zhaoqing Sports Center 
查尔斯·梅特卡夫，第一代梅特卡夫男爵	Charles Metcalf, the first Baron Metcalf 
军事占领	Military occupation 
坎德拉_(科贾埃利省)	Candela_ (Kocaeli Province) 
esmerine	grind 
美国海军部部长	Secretary of the Navy 
细叶榕	Ficus tenuifolia 
通用媒体光碟	Universal Media Disc 
金山隼树	Golden Mountain Falcon 
正二位	Positive two 
小爱德华·斯特蒂纽斯	Edward Stettinius Jr. 
马耳他总统	President of Malta 
苏嘉湖小片	Su Jiahu small film 
文艺复兴建筑	Renaissance architecture 
金敏均	Jin Minjun 
弗朗切斯科五世_(摩德纳)	Francesco V_ (Modena) 
美国联邦众议院	U.S. House of Representatives 
利华古逊足球俱乐部	Lihua Guson Football Club 
番禺会所华仁小学	Panyu Club Huaren Primary School 
科特布斯足球俱乐部	Cottbus Football Club 
邝广杰	Kwong Kwong Kit 
邓伯什足球俱乐部	Dun Bosh Football Club 
意大利银行	Bank of Italy 
廖长城	Liao Changcheng 
五所川原市	Goshogawara City 
百越	Baiyue 
苏联民政厅	Soviet Civil Affairs Office 
约翰·贝尔_(1797年出生)	John Bell_ (born in 1797) 
东方茱丽叶	Oriental Juliet 
杜克大学法学院	Duke University School of Law 
爱沙尼亚改革党	Estonian Reform Party 
何泽中	He Zezhong 
文化观光部2000年式	Ministry of Culture and Tourism 2000 
韩民族	Korean Nationality 
列宁勋章	Lenin Medal 
京极高次	Kyoto High School 
圣安阿德雷	San anne adre 
私立东海大学附属实验高级中学	Private Experimental High School Affiliated to Tunghai University 
中国社会科学院	Chinese Academy of Social Sciences 
.vg	.vg 
永平寺町	Eiheiji Town 
woooo!_(how_i_met_your_mother_episode)	woooo!_(how_i_met_your_mother_episode) 
织田鹤	Oda Tsuru 
美国联盟东区	American League East 
ambeon	ambeon 
所罗门群岛总督	Governor of Solomon Islands 
帝国航空舰队	Empire Air Fleet 
宋端宗	Song Duanzong 
整体人文主义	Holistic humanism 
上海航空	Shanghai Airlines 
伊斯兰世界大学联合会	Islamic World University Federation 
丹麦国王	King of Denmark 
松枝贺子	Noriko Matsueda 
合成流行	Synthetic pop 
法国七月革命	French July Revolution 
曾华倩	Zeng Huaqian 
基督教历史党	Christian History Party 
伊斯兰哲学	Islamic philosophy 
俄罗斯联邦管区	District of the Russian Federation 
多点触控	multi touch 
沃尔特-刚果语支	Walter-Congo branch 
九龙仔公园	Kowloon Tsai Park 
东燕里	Dongyanli 
龙骑士07	Dragon Knight 07 
波斯-阿拉伯字母系统	Persian-Arabic Alphabet System 
神话艺术	Mythological art 
大河内一楼	Grand Hanoi first floor 
陈维冠	Chen Weiguan 
叙利亚国王	King of Syria 
yes!_光之美少女5	yes!_Beautiful Girl of Light 5 
西藏自治区投资有限公司	Tibet Autonomous Region Investment Co., Ltd. 
category:明朝皇后	category:Ming Dynasty Queen 
越南社会主义共和国主席	Chairman of the Socialist Republic of Vietnam 
国防工业	Defense industry 
mp3	mp3 
掷弹骑兵团	Grenadier Regiment 
阿克萨群众起义	Aqsa mass uprising 
川井宪次	Kawai Kenji 
梁文音	Liang Wenyin 
纽波特市长	Mayor of Newport 
剑桥大学达尔文学院	Darwin College, Cambridge University 
学是学非	Learn right and wrong 
门户网站	Web portals 
合作游戏模式	Cooperative game mode 
第九届全国人民代表大会	The Ninth National People's Congress 
藏语方言	Tibetan dialect 
自传作家	Autobiography writer 
次女高音	Soprano 
大久保利通	Toshimichi Okubo 
美国中南部	South Central United States 
南苏门答腊省	South Sumatra 
埃塞俄比亚总理	Prime Minister of Ethiopia 
日本未来党	Tomorrow Party of Japan 
上海城市精神	Shanghai city spirit 
内吉梅丁·萨达克	Nejimedin Sadak 
石崎信弘	Nobuhiro Ishizaki 
mi-17直升机	mi-17 helicopter 
卢布林医科大学	Lublin Medical University 
广濑仁美	Hirose Hitomi 
卡尔-奥古斯特_(萨克森-魏玛-艾森纳赫)	Karl August (Saxony-Weimar-Eisenach) 
列奥十一世	Leo XI 
词曲作者	Songwriter 
wii遥控器	wii remote 
左翼社会主义者	Left-wing socialist 
北部非洲	North Africa 
杰斐逊城_(密苏里州)	Jefferson City_(Missouri) 
意大利共和党	Italian Republican Party 
promise/star	promise/star 
终身参议员	Senator for life 
关口和之	Sekiguchi and 
台北101/世贸站	Taipei 101/World Trade Center 
普利茅斯-萨顿_(英国议会选区)	Plymouth-Sutton_(British Parliamentary District) 
浦项钢园球场	Pohang Steel Park Stadium 
格拉斯哥安妮斯兰德_(苏格兰议会选区)	Glasgow Annesland_ (Scottish Parliament constituency) 
朱鸟_(天武天皇年号)	Shucho_ (Emperor Tenmu Year) 
多拿度	Donald 
山阴地方	San'in place 
迪奥高·费拉拿	Diogo Ferrana 
木卫一	Io 
太原武宿国际机场	Taiyuan Wusu International Airport 
模拟城市_(1989年游戏)	Sim City_ (1989 game) 
新式迷幻音乐	New psychedelic music 
土耳其议会	Turkish Parliament 
英国国籍法	British Nationality Law 
姚江山	Yao Jiangshan 
蒙古大汗	Mongolian Khan 
金基种	Gold base species 
打破的锁链	Broken chain 
戴安娜_(威尔士王妃)	Diana_ (Princess of Wales) 
阿尔贝一世_(比利时)	Albert I_(Belgium) 
航电设备	Avionics 
道琼斯工业平均指数	Dow Jones Industrial Average 
我要做老板	I want to be the boss 
民俗音乐	Folk music 
美中日光节约时间	US-China Daylight Saving Time 
花花公子拉瑞	Playboy Larry 
ncaa第一级	ncaa first level 
中华一番！	Chinese! 
湄公河三角洲	Mekong Delta 
卡拿丹尼斯	Canadnis 
达拉斯-沃思堡国际机场	Dallas-Fort Worth International Airport 
黑山独立日	Montenegro Independence Day 
香港警察车辆	Hong Kong Police Vehicle 
固伦和静公主	Gulun and Princess Jing 
毕打自己人	Beating yourself 
士砵亭水晶	Shiroting Crystal 
图拉爱.奥马.亚拉杜瓦	Tulaai Omar Yar'Adua 
米纳尔迪美国车队	Minardi American Team 
温井骏斗	Jundou Onjing 
大羊驼	Llama 
艺能动音	Artistic dynamic sound 
四川冠城足球俱乐部	Sichuan Guancheng Football Club 
孙新阳	Sun Xinyang 
全真道	Quanzhen Tao 
黎鸿英	Li Hongying 
永田拓也	Takuya Nagata 
诺曼底的西比拉	Sibila of Normandy 
以西结·桑普森	Ezekiel Sampson 
中山闽语	Zhongshan Min 
税金党	Tax party 
达勒姆县_(北卡罗来纳州)	Durham County_ (North Carolina) 
马伦哥战役	Battle of Marengo 
山东滕鼎足球俱乐部	Shandong Tengding Football Club 
数位图书馆	Digital library 
金鱼注意报	Goldfish note 
爱尔兰共和兄弟会	Irish Republican Brotherhood 
奥尔登堡王朝	Oldenburg Dynasty 
小伊斯雷尔·沃什伯恩	Israel Washburn Jr. 
一条秀子	Ichiko Hideko 
英厄姆县	Ingham County 
伍家岗长江大桥	Wujiagang Yangtze River Bridge 
陈豪_(政治人物)	Chen Hao_(Politician) 
开姆尼茨足球俱乐部	Chemnitz Football Club 
月轮陵	Lunar Tomb 
存在的三种层次	Three levels of existence 
拉拉·萨尔玛王妃	Princess Lara Salma 
韩国17岁以下国家足球队	South Korea Under-17 National Football Team 
印第安纳波利斯国际机场	Indianapolis International Airport 
肌肉松弛乐团	Muscle Relaxation Orchestra 
柬埔寨王后	Queen of Cambodia 
山下真	Yamashita 
爱尔兰下议院	Irish House of Commons 
原来是美男_(台湾电视剧)	It turned out to be a beautiful man_ (Taiwan TV series) 
德国20岁以下国家足球队	Germany under-20 national football team 
卜公体育会	Bu Gong Sports Club 
澳大利亚财政部长	Australian Minister of Finance 
环境保护主义	Environmentalism 
北浦正尚	Masanao Kitaura 
福灵安	Fulinan 
新店线	Xindian Line 
笹原修平	Shuhei Sasahara 
你照亮我星球	You light up my planet 
零插拔力插座	Zero insertion force socket 
德班国际机场	Durban International Airport 
普罗维登斯_(罗德岛州)	Providence_(Rhode Island) 
圣马田大学体育会	St Martin University Sports Club 
南昌西站	Nanchang West Railway Station 
迪普戴尔球场	Deepdale Stadium 
贸易及工业大臣	Minister of trade and industry 
澳大利亚农业、渔业和林业部	Australian Department of Agriculture, Fisheries and Forestry 
李斌_(女性官员)	Li Bin_(Female Official) 
新西兰自由党	New Zealand Liberal Party 
幸运☆星角色列表	Lucky☆Star Character List 
运动失调症	Movement disorders 
大乘佛教	Mahayana Buddhism 
中立一元论	Neutral monism 
女性天皇	Empress of Japan 
拜仁慕尼黑青年队	Bayern Munich Youth Team 
若弗鲁瓦五世_(安茹)	Geoffroy V_ (Anjou) 
恒河三角洲	Ganges Delta 
特斯拉涡轮发动机	Tesla turbo engine 
匆促乐团	Rush Orchestra 
.by	.by 
兔冢英志	Hideshi Totsuka 
先锋体育团	Pioneer Sports Team 
库兹威尔音乐系统	Kurzweil Music System 
中央宣传思想工作领导小组	Central Propaganda and Ideological Work Leading Group 
亚洲足球联合总会	Asian Football Federation 
大卫摩哈	David Moha 
酩悦·轩尼诗－路易·威登集团	Moet Hennessy-Louis Vuitton Group 
吉塞拉_(虔诚者路易之女)	Gisela_(Daughter of Louis the Pious) 
巴西参议院	Brazilian Senate 
西班牙参议院议长	Speaker of the Spanish Senate 
京都御所	Kyoto Imperial Palace 
穆罕默德·哈蒂卜·巴斯里	Mohamed Khatib Basri 
新泽西篮网	New Jersey Nets 
不丹体育场	Bhutan Stadium 
讼务律师	Solicitor 
多佛_(特拉华州)	Dover_ (Delaware) 
青木孝太	Kota Aoki 
鞑靼摇滚	Tatar Rock 
付费电视	Pay TV 
黄炎堃	Huang Yankun 
亦孙真哈敦	Yisun Zhenhadun 
八一大楼	Bayi Building 
海老川兼武	Kanetake Ebikawa 
诺斯科特男爵	Baron Northcote 
互补原理	Complementary principle 
斯特拉斯堡城区	Strasbourg City 
伊朗民主党	Iranian Democratic Party 
秘鲁天主教神学大学	Catholic Theological University of Peru 
哥伦布市议会	Columbus City Council 
web开放字型格式	web open font format 
英国大奖赛	British Grand Prix 
帕斯托竞技	Pasto Athletic 
乐视体育生态中心	LeTV Sports Ecological Center 
欧洲自由民主联盟	European Liberal Democratic Union 
江西省奥林匹克体育中心	Jiangxi Olympic Sports Center 
梅小惠	Mei Xiaohui 
堪察加半岛	Kamchatka 
泰国农民银行足球俱乐部	Thai Farmers Bank Football Club 
菲律宾标准时间	Philippine Standard Time 
菲利普·威廉_(奥兰治)	Philip William_ (Orange) 
城关镇	Chengguan Town 
简约音乐	Simple music 
格伦威尔男爵	Baron Glenwell 
莱昂王国	Kingdom of Leon 
傅明先	Fu Mingxian 
矶城皇子	Prince Kajo 
中华民国宪法	Constitution of the Republic of China 
澳门资讯频道	Macau Information Channel 
法国国防部	French Ministry of Defense 
常春藤盟校	Ivy League School 
联合舰队司令长官	Commander of the combined fleet 
西北希腊语	Northwestern Greek 
朱兆祥_(音韵学家)	Zhu Zhaoxiang_ (phonologist) 
中国中央电视台俄语国际频道	China Central Television Russian International Channel 
咸台永	Hamtayong 
拥抱太阳的月亮	The moon embracing the sun 
老阿格里皮娜	Agripina 
兰卡斯特公爵领地总裁	President of the Duke of Lancaster 
陈有兰溪	Chen Youlanxi 
商业创新及技能大臣	Minister of Business Innovation and Skills 
我是歌手_(第三季)	I am a singer_ (season 3) 
日本内阁	Cabinet of japan 
区彦媛	Ou Yanyuan 
那顺孟和	Na Shun Meng He 
桑德捷斯基足球俱乐部	Sandjeski Football Club 
阿拉伯联合酋长国足球协会	United Arab Emirates Football Association 
杭州动车运用所	Hangzhou EMU 
王伟忠	Wang Weizhong 
第二代约克公爵诺里奇的爱德华	Edward of Norwich, 2nd Duke of York 
查普曼大学	Chapman University 
波斯尼亚和黑塞哥维那联邦	Federation of Bosnia and Herzegovina 
一个机构两块牌子	Two brands per institution 
爱因斯坦场方程	Einstein Field Equation 
越柬战争	Vietnam-Cambodia war 
陈文茶	Chen Wencha 
内政大臣	Home Secretary 
wb电视台	wb television 
郑日冠	Zheng Riguan 
卫生大臣	Minister of Health 
电信设备	Telecommunications equipment 
大城情事	Great City Affair 
mohrungen	mohrungen 
郭金福	Guo Jinfu 
胡海泉	Hu Haiquan 
阿尔芒-埃曼纽尔·迪普莱西_(黎塞留公爵)	Armand-Emanuel Duplesi_ (Duke of Richelieu) 
glaswegian	glaswegian 
英国邮政总局局长	Director General of the United Kingdom Post Office 
交响情人梦_(日本电视剧)	Nodame Cantabile_ (Japanese TV Drama) 
加拿大下议院	Canadian House of Commons 
崔尹正	Cui Yinzheng 
尤里卡_(加利福尼亚州)	Eureka (California) 
巴基斯坦穆斯林联盟	Pakistan Muslim League 
华顶宫博厚亲王	Prince Bohou of Huading Palace 
新青少棒扬威记	The New Youth League 
布鲁塞尔南站	Brussels South Railway Station 
伊朗国家利益委员会	Iran National Interest Committee 
湖北华奥	Hubei Huaao 
北京师范大学	Beijing Normal University 
莱特豪斯波因特_(佛罗里达州)	Lighthouse Point_ (Florida) 
印度陆军	Indian Army 
波兰工人党	Polish Workers' Party 
file:明世宗像.jpg	file: Portrait of Ming Shizong.jpg 
中国足球甲级a组联赛	Chinese Football League A 
陈昭娘	Chen Zhaoniang 
新傣文	New Dai 
御用大律师	Queen's Counsel 
泉信也	Shinya Izumi 
巴黎圣日耳曼足球俱乐部_(女子足球队)	Paris Saint-Germain Football Club_ (Women's Football Team) 
行政公职局	Administration and Public Service Bureau 
美国陆军医疗队	U.S. Army Medical Corps 
池珍熙	Chi Jinxi 
卡文_(爱尔兰下议院选取)	Calvin_ (Selected by the Irish House of Commons) 
瓦尔达足球俱乐部	Varda Football Club 
法兰克福条约	Frankfurt Treaty 
慕尼黑植物协会	Munich Botanical Association 
卡森城_(内华达州)	Carson City_(Nevada) 
u.s._poggibonsi	u.s._poggibonsi 
吴蔚荣	Wu Weirong 
灰背隼直升机	Greyback Falcon helicopter 
非洲联盟委员会	African Union Commission 
法国总统列表	List of French Presidents 
妹尾隆佑	Ryusuke Senoo 
老友狗狗_(电视剧)	Friends Dog_ (TV series) 
dw运动场	dw sports field 
1995年亚洲女子足球锦标赛	1995 Asian Women's Football Championship 
伊丽莎伯二世	Elizabeth II 
microblaze	microblaze 
德国君主列表	List of German monarchs 
激进公民联盟	Radical Citizens League 
南燕里	Nanyanli 
泰罗芬斯体育会	Tyrolean Sports Club 
俄罗斯军事史	Russian military history 
宁国公主	Princess Ningguo 
美国物理学会	American Physical Society 
印度事务大臣	Minister of indian affairs 
塞萨洛尼基亚里士多德大学	Aristotle University of Thessaloniki 
神秘家族	Mystery family 
沃尔夫数学奖	Wolf Prize in Mathematics 
唱片制作人	Record producer 
徐洛锵	Xu Luoqiang 
新巡者	New Ranger 
世界贸易中心	The World Trade Center 
.cv	.cv 
文礼治	Bun Lizhi 
老爸老妈的浪漫史集数列表	A list of the romance episodes of Mom and Dad 
泰国银行	Bank of Thailand 
古尔迪奥拿	Guldiona 
新竹县立湖口高级中学	Hsinchu County Hukou Senior High School 
台湾观光学院	Taiwan Hospitality and Tourism University 
铨美国际	Quanmei International 
美琳达·盖茨	Melinda Gates 
新界乡议局	Heung Yee Kuk, New Territories 
国立武昌高师	National Wuchang Normal University 
阿拉伯复兴社会党－叙利亚地区	Arab Baath Socialist Party-Syrian Region 
捷克君主列表	List of Czech monarchs 
时装设计	fashion design 
杨咏莹	Yang Yongying 
藤原威子	Fujiwara Miko 
基督科学教会	Christian Science Church 
台湾闽南语罗马字拼音方案	The Pinyin Scheme of Romaji in Taiwanese Hokkien 
斯塔福德·诺思科特，第一代伊兹利伯爵	Stafford Northcote, the first Earl of Izli 
莱蒂西娅·玛丽亚公主	Princess Leticia Maria 
阿波罗16号	Apollo 16 
米哈伊一世_(罗马尼亚)	Mihai I_ (Romania) 
伊洛瓦底江	Irrawaddy 
机械工程师	Mechanical Engineers 
steelman	steelman 
统计力学	Statistical mechanics 
柏林自由大学	Free University of Berlin 
知觉之门	Door of Perception 
沙龙·庄士敦	Sharon Johnston 
bbc广播电台	bbc radio 
冲野将基	Okino Mamoki 
暨南大学	Jinan University 
教育总监	Education Director 
教宗和诺理一世	Pope and Nori I 
f-20虎鲨战斗机	f-20 Tiger Shark fighter 
纽约州城市列表	New York State City List 
塞利姆二世	Selim II 
罗克汉普顿_(澳大利亚国会选区)	Rockhampton_(Australian Parliamentary District) 
西班牙历史	Spanish history 
强纳斯唱片	Jonas Records 
阿方索三世_(莱昂)	Alfonso III_ (Leon) 
人类行为学	Human behavior 
通用电气ge90发动机	General Electric ge90 engine 
昆明航空	Kunming Airlines 
清太宗元妃	Concubine Yuan Seita 
两妻时代	The age of two wives 
捷克行政区划	Czech administrative divisions 
移动浏览器	Mobile browser 
瞿友宁	Qu Youning 
伊朗教育部	Ministry of Education of Iran 
神探夏洛克集数列表	Detective Sherlock episode list 
图形文件格式比较	Graphic file format comparison 
贝尔实验室	Bell Labs 
汉诺威国王	King of Hanover 
八核心	Eight core 
侧福晋	Side Fujin 
三立财经台	Sanli Financial Channel 
甲州胜沼之战	Battle of Koshu Katsunuma 
交谈循序程式	Conversation sequence program 
mips架构	mips architecture 
庆应义塾大学	Keio University 
中国共产党重庆市委员会	Chongqing Municipal Committee of the Communist Party of China 
独立运营	Independent operation 
利奥波多王子_(两西西里)	Prince Leopoldo_ (Two Sicily) 
波兰总统列表	List of Presidents of Poland 
新侨中学	Xinqiao Middle School 
国父纪念馆站	Sun Yat-sen Memorial Hall Station 
川崎裕之	Hiroyuki Kawasaki 
玉女素心剑法	Jade Girl Suxin Sword Technique 
科艺百代	Technology EMI 
教我爱的一切	Teach me everything I love 
哇哇映画	Wow movie 
蔚山现代尾浦造船海豚足球俱乐部	Ulsan Hyundai Mipo Shipbuilding Dolphin Football Club 
vezneciler	tellers 
中共最高人民检察院党组	Party Group of the Supreme People's Procuratorate of the Communist Party of China 
乌利泽电钢琴	Ulrich Electric Piano 
特里格拉夫足球俱乐部	Triglav Football Club 
炼钢工人	Steel worker 
跟上旋律	Keep up with the melody 
台北市私立中兴高级中学	Taipei Zhongxing Senior High School 
拉赫蒂足球俱乐部	Lahti Football Club 
梁国权	Liang Guoquan 
圣多默宗徒领衔教堂	Church of St. Thomas the Apostle 
bec特罗萨萨纳足球俱乐部	bec trossana football club 
.pk	.pk 
宇文姓	Yuwen Surname 
中国国民党主席	Chairman of the Chinese Kuomintang 
岩崎良明	Yoshiaki Iwasaki 
贞懿公主	Princess Zhenyi 
亚利桑那大学	University of Arizona 
荷兰军队	Dutch army 
英格兰按人口分类的地区列表	List of areas in England by population 
乡里大辅	Daisuke Township 
霍夫堡皇宫	Hofburg Imperial Palace 
江苏省徐州市第一中学	The First Middle School of Xuzhou City, Jiangsu Province 
南京夫子庙	Nanjing Confucius Temple 
罗撒西公爵	Duke of Rosacy 
七户町	Shichinohe Town 
对马海峡	Tsushima Strait 
永见万	Nagamiman 
核心马来-玻里尼西亚语支	Core Malay-Polynesian branch 
初濑亮	Hatsase Ryo 
气象办公室	Meteorological Office 
社会自由联盟	Social Freedom Alliance 
荷兰君主配偶列表	List of spouses of Dutch monarchs 
马赫反射	Mach reflection 
鲁能泰山足球学校	Luneng Taishan Football School 
帕洛马山天文台	Paloma Mountain Observatory 
不伪装的笑颜yes	Smile without pretending yes 
中央军事委员会国防动员部	National Defense Mobilization Department of the Central Military Commission 
鲍勃·麦克金南	Bob McKinnan 
竹东里	Zhudongli 
奇境传说	Wonderland 
向象贤	Xiang Xiangxian 
北美山区日光节约时间	Daylight Saving Time in North American Mountains 
威桑迪区政府	Wisandy District Government 
普利茅斯高中（印第安纳州）	Plymouth High School (Indiana) 
奥洛穆茨西格玛足球俱乐部	Olomouc Sigma Football Club 
东京放送控股	Tokyo Broadcasting Holdings 
印度的星序勋章	Order of the Stars of India 
fcr2001杜伊斯堡	fcr2001 Duisburg 
阮曾俊	Ruan Zengjun 
查尔顿竞技	Charlton Athletic 
拉特兰条约	Lateran Treaty 
教皇宫殿	Pope palace 
青少年流行音乐	Teen Pop 
西班牙皇家学院	Royal Spanish Academy 
寺川能人	Yoshito Terakawa 
龟井保子	Kamei Yasuko 
东台湾	Eastern Taiwan 
德雷克公式	Drake formula 
武田有祐	Takeda Yusuke 
城岛茂	Shigeru Jojima 
台北松山机场	Taipei Songshan Airport 
申民奎	Shen Minkui 
天体物理学	Astrophysics 
马可尼电子系统	Marconi Electronic System 
彭述之	Peng Shuzhi 
凯洛管理学院	Kellogg School of Management 
渡边博道	Hiromichi Watanabe 
发光二极管	led 
约翰霍普金斯大学保罗尼采高级国际问题研究院	Paul Nietzsche Institute for Advanced International Studies, Johns Hopkins University 
独立城_(密苏里州)	Independence_(Missouri) 
速霸陆汽车	Subaru Motor 
海地共和国银行	Bank of the Republic of Haiti 
幸福选择题	Happiness multiple choice 
幸福捕手	Happiness catcher 
政府税制调查会	Government Tax Investigation Committee 
莫利_(西约克郡)	Molly_ (West Yorkshire) 
澳门总督	Governor of Macau 
瑞士首都球场	Swiss Capital Stadium 
寻秦记_(电视剧)	Searching for the Qin_(TV series) 
铃木英哉	Hideya Suzuki 
王室教皇党勋章	Royal Papal Party Medal 
绿箭侠_(电视剧)	Arrow_(TV series) 
菲律宾众议院	House of Representatives of the Philippines 
樽床伸二	Shinji Tarutoko 
项雪龙	Xiang Xuelong 
大国民阿寇	Ako 
司马永祚	Sima Yongzuo 
袁彩云	Yuan Caiyun 
加拿大20岁以下国家足球队	Canadian Under-20 National Football Team 
杰克逊维尔州立大学	Jacksonville State University 
和山里	Heshanli 
中国优秀旅游城市	China's outstanding tourist city 
诺曼底公爵	Duke of Normandy 
放克摇滚	Funk rock 
巴贝什-鲍里亚大学	Babes-Boria University 
联合国大会67/19号决议	United Nations General Assembly Resolution 67/19 
泛亚美尼亚民族运动	Pan-armenian national movement 
阿联酋总统列表	List of Presidents of the UAE 
鲍常勇	Bao Changyong 
李雨阳	Li Yuyang 
国立首尔显忠院	National Seoul Hyeonchungwon 
意大利参议院	Italian Senate 
壮傣语支	Zhuang and Dai 
德意志帝国议会	Reichstag 
黄杰_(足球运动员)	Huang Jie_ (Football Player) 
中国特色社会主义	Socialism with Chinese Characteristics 
宏池政策研究会	Hongchi Policy Research Association 
necta	necta 
欧洲社会党	European Socialist Party 
塞内加尔国家足球队	Senegal National Football Team 
邻座的怪同学	the werid guy sit next to me 
联合基督教会	United Christian Church 
摩纳哥国家足球队	Monaco National Football Team 
布兰太尔_(马拉维)	Blantyre_(Malawi) 
心花朵朵开	Heart flowers blooming 
拉法耶特侯爵	Marquis de Lafayette 
贝德福德_(英国国会选区)	Bedford_(British Parliamentary District) 
迷幻流行	Psychedelic pop 
水原三星蓝羽	Suwon Three Star Blue Feather 
任桂辛	Ren Guixin 
澳大利亚总督	Governor of Australia 
蔚山文殊足球竞技场	Ulsan Munju Football Stadium 
火影忍者疾风传	Naruto Shippuden 
奥林匹亚俱乐部	Olympia Club 
台视文化公司	Taiwan Television Culture Company 
数学物理	Mathematical Physics 
高知县民歌	Kochi Folk Songs 
黎柏坚	Li Baijian 
普鲁士邦总理	Prime Minister of Prussia 
阿拉伯半岛	Arabian Peninsula 
德国联邦议院议长	Speaker of the German Bundestag 
约翰·马歇尔_(肯塔基州)	John Marshall_ (Kentucky) 
亚兰字母	Arranian 
贾伟南	Jia Weinan 
克里米亚国家议会	Crimea National Assembly 
索菲_(汉诺威选侯夫人)	Sophie_ (Lady Elector of Hannover) 
兰芝利_(科罗拉多州)	Laneigli_ (Colorado) 
新川崎站	New Kawasaki Station 
德国超级杯	German Super Cup 
安纳波利斯海军学院	Annapolis Naval Academy 
科因布拉集团	Coimbra Group 
模糊伦理学	Fuzzy ethics 
罗斯西公爵	Duke of Rossi 
霹雳mit	Thunder mit 
旧扎戈拉贝罗足球俱乐部	Old Zagorabello Football Club 
英格兰西南	South West England 
琅邪诸葛氏世系图	Lineage Diagram of Zhuge Clan of Langye 
安住淳	Azumi Jun 
北京科技大学	University of Science and Technology Beijing 
莲花车队	Lotus team 
许财利	Xu Caili 
西园誉志	Nishi Park Yushi 
汉特-曼西斯克	Khanty-Mansiysk 
玛格丽塔公主_(罗马尼亚)	Princess Margarita_(Romania) 
金融管理专员	Financial Controller 
阿方索_(两西西里)	Alfonso_ (Two Sicily) 
西北格拉斯哥_(英国国会选区)	Northwest Glasgow_(British Parliamentary District) 
东北英格兰_(欧洲议会选区)	Northeast England_(European Parliament constituency) 
惠建林	Hui Jianlin 
主滨了	Main beach 
蒙大拿州单一国会选区	Single congressional district of Montana 
开封话	Kaifeng 
数字生活网络联盟	Digital Life Network Alliance 
后清闲寺陵	Mausoleum of Hou Qingxian Temple 
巴林根	Balingen 
名单比例代表制	List proportional representation 
意大利银行行长	President of the Bank of Italy 
寿庄固伦公主	Princess Gulun 
黑糖玛奇朵	Brown Sugar Macchiato 
咎狗之血	Blame the dog's blood 
日升动画	Sunrise Animation 
赵昺	Zhao Bing 
中国共产党北京市第十一届委员会	The 11th Beijing Municipal Committee of the Communist Party of China 
光速蒙面侠21	Lightspeed Masked Man 21 
中央情报局	CIA 
宁河话	Ninghe dialect 
北京舞蹈学院	Beijing Dance Academy 
标准普尔500指数	Standard & Poor's 500 Index 
正义的上帝	Righteous god 
比安弗尼·马坦	Bienvenue Matan 
云雀iii型直升机	Skylark III helicopter 
白石藏王车站	Shiraishi Zao Station 
欧洲保守派和改革主义者联盟	European Union of Conservatives and Reformists 
核心马来-玻里尼西亚语	Core Malay-Polynesian 
马来西亚土著	Malaysian indigenous 
赵佑辰	Zhao Youchen 
百事中心	Pepsi Center 
岗嘎本孙峰	Gangga Bensun Peak 
法律博士	Doctor of Law 
菲律宾城市	Philippines cities 
marumo的规定	marumo rules 
达根奴	Dagenu 
比利时基督教社会党	Belgian Christian Socialist Party 
请问您今天要来点兔子吗？	Would you like some rabbits today? 
埃德蒙·沃克·赫德爵士，第八代从男爵	Sir Edmund Walker Hurd, 8th Generation from Baron 
letzigrund	last reason 
这里发现爱	Find love here 
鸟取县旗	Flag of Tottori Prefecture 
德国青年国家足球队	German Youth National Football Team 
深水里	Deep water 
公共管理	Public management 
双城记	Tale of Two Cities 
刘妃_(明思宗)	Concubine Liu_ (Ming Sizong) 
舰政本部	Ship administration headquarters 
越南20岁以下国家足球队	Vietnam Under-20 National Football Team 
东员町	Toincho 
河北华夏幸福	Hebei China Fortune 
尚比亚银行	Bank of Zambia 
自由妇女军	Free Women's Army 
乌尔比诺公国	Principality of Urbino 
木村贵宏	Kimura Takahiro 
墨西哥国家行动党	Mexican National Action Party 
亚美尼亚总理	Prime Minister of Armenia 
卡塔尔足球乙级联赛	Qatar Football League Two 
徐明朝	Xu Mingchao 
纳尔逊_(新西兰选区)	Nelson_(New Zealand Constituency) 
朝鲜劳动党中央委员会总书记	General Secretary of the Central Committee of the Workers' Party of Korea 
圣罗莎_(南里奥格兰德州)	Santa Rosa (Rio Grande do Sul) 
海军及陆战队勋章	Navy and Marine Corps Medal 
昂比伊	Ambiy 
海派甜心	Shanghai sweetheart 
木村光佑	Kimura Kosuke 
圣安德鲁斯大学体育联盟	University of St Andrews Sports League 
梅田绘理香	Umeda Erika 
就业大臣	Minister of Employment 
上村岬	Misaki Uemura 
明正天皇	Empress Meisho 
改进型韦格纳分布	Modified Wegener distribution 
阿富汗战争	War in Afghanistan 
英国广播公司商业分支	BBC Commercial Branch 
彼得森空军基地	Peterson Air Force Base 
额日西莫足球俱乐部	Erissimo Football Club 
台湾移动制作股份有限公司	Taiwan Mobile Production Co., Ltd. 
德意志联邦共和国基本法	Basic Law of the Federal Republic of Germany 
开普殖民地总督	Governor of Cape Colony 
美国第六集团军	US Sixth Army 
物理化学	Physical Chemistry 
意属东非	Italian East Africa 
中华民国空军	Republic of China Air Force 
刘吴惠兰	Liu Wuhuilan 
安萨里	Ansari 
芬兰-拉普语支	Finnish-Lappish branch 
巴西奥林匹克足球队	Brazil Olympic Football Team 
有机化学	Organic chemistry 
郑袭_(明郑)	Zheng Xi_(Ming Zheng) 
张皇后_(萧岿)	Queen Zhang_ (Xiao Kui) 
真岛浩	Hiro Mashima 
中国共产党纪律检查机关	Chinese Communist Party Disciplinary Inspection Agency 
zwijnaarde	swine earth 
森麻实·劳里-科里，第四代贝尔莫尔伯爵	Samashi Laurie-Curry, the 4th Earl of Belmore 
京沪高速动车组列车	Beijing-Shanghai high-speed EMU train 
法国甲组女子足球联赛	French Women's Football League 
萨拉科格鲁球场	Sarakoglu Stadium 
人权律师	Human rights lawyer 
第二次瓦格纳战役	Second Battle of Wagner 
稻田朋美	Tomomi Inada 
台湾省政府功能业务与组织调整	Functional Business and Organizational Adjustment of Taiwan Provincial Government 
历史小说	Historical novel 
外交及联邦事务大臣	Minister of foreign and federal affairs 
特别急行列车	Special express train 
阿尔巴尼亚王国_(1943年－1944年)	Kingdom of Albania_ (1943-1944) 
我们发财了	We got rich 
湖南师范大学附属中学	The High School Affiliated to Hunan Normal University 
大湖海军基地	Great Lakes Naval Base 
小笠原猛	Takeshi Ogasawara 
拿骚统治者列表	List of Nassau rulers 
德意志民主共和国部长会议	Council of Ministers of the German Democratic Republic 
厢型车	Van 
兹沃勒足球俱乐部	Zwolle Football Club 
乾隆帝皇十子	Ten sons of Emperor Qianlong 
织田秀子	Hideko Oda 
古拿奴	Gunano 
欧盟议会	European Parliament 
钓大鱼	Big fish 
安嫔李氏	Amy Lee 
寺田周平	Shuhei Terada 
甲骨文体育馆	Oracle Arena 
越南共产党中央政治局	Political Bureau of the Communist Party of Vietnam 
芝加哥齿轮	Chicago Gear 
社南里	Shenanli 
入境事务处	immigration Department 
康斯坦丁二世_(格鲁吉亚)	Constantine II_ (Georgia) 
山楂球场	Hawthorn Stadium 
南澳大利亚体育学院	South Australian Institute of Sport 
白俄罗斯苏维埃社会主义共和国	Belarusian Soviet Socialist Republic 
波琴ii	Bochen ii 
吕贝克足球俱乐部	Lubeck Football Club 
阮青贤	Ruan Qingxian 
金子一义	Gold is righteous 
神秘小说	Mystery novel 
岛屿地区	Island area 
斯泰普尔顿国际机场	Stapleton International Airport 
成海璃子	Riko Narumi 
太布尚弘	Naohiro Taifu 
梵蒂冈博物馆	Vatican Museums 
设乐町	Shirakucho 
山阳地方	Sanyang place 
国家铁路局	National Railway Administration 
吸血鬼猎人巴菲集数列表	Buffy the Vampire Slayer Episode List 
塞尔维亚正教	Serbian Orthodox 
汉平南越之战	Battle of Han Ping and South Vietnam 
核心密克罗尼西亚语	Core Micronesian 
钱达尔勒家族	Chandalli family 
朝鲜人民军总参谋部	General Staff of the Korean People's Army 
方孔钱	Square hole money 
湖南湘涛	Hunan Xiangtao 
美国州际公路辅助线列表	List of U.S. Interstate Routes 
魏玛的古典主义	Weimar Classicism 
天主教那空沙旺教区	Catholic Diocese of Nakhon Sawan 
索尼影业	Sony Pictures 
立陶宛摇滚	Lithuanian Rock 
反抗军同盟	Resistance League 
河合常则	Hehe Changzhi 
英国本土四角锦标赛	British Four Corners Championship 
欧洲马鹿	European red deer 
亚美尼亚高原	Armenian Plateau 
avx指令集	avx instruction set 
欧陆舞曲	Europa 
特斯拉定理	Tesla theorem 
美国内阁	U.S. Cabinet 
新干线e3系电力动车组	Shinkansen e3 series electric EMU 
丹尼森大学	Denison University 
西属几内亚	Spanish Guinea 
肖特基效应	Schottky effect 
松平松千代	Matsudaira 
.mm	.mm 
阿卡围城战	Siege of Acre 
利文斯顿足球俱乐部	Livingston Football Club 
nhk大河剧	nhk big river drama 
安道尔公国	Principality of Andorra 
外山和彦	Kazuhiko Toyama 
忠孝复兴站	Zhongxiao Fuxing Station 
莫斯科鱼雷足球俱乐部	Moscow Torpedo Football Club 
叙利亚反对派-伊拉克和黎凡特伊斯兰国冲突	Syrian opposition-Islamic State conflict in Iraq and the Levant 
长荣海运	Evergreen Shipping 
马利汉体育会	Malihan Sports Club 
福斯星空工作室	Fox Star Studio 
徐州站	Xuzhou Railway Station 
梅超风	Mei Chaofeng 
松鼠一型直升机	Squirrel helicopter 
泽列兹尼察足球俱乐部	Zeleznica Football Club 
夏季奥林匹克运动会田径比赛	Summer Olympic Games Track and Field Competition 
蒂利女男爵	Baroness Tilly 
全国人民代表大会专门委员会	Special Committee of the National People's Congress 
莉雅·宾特·侯赛因公主	Princess Leah Bent Hussein 
执行制作人	Executive producer 
江阴长江大桥	Jiangyin Yangtze River Bridge 
第一次鸦片战争	The First Opium War 
扬·比约克隆德	Jan Bjorkund 
尔龚语	Ergong 
肖洪达	Xiao Hongda 
桥本真司	Shinji Hashimoto 
新丰郡	Xinfeng County 
.id	.id 
类班图语群	Bantu group 
爱丽丝公主_(巴滕贝格)	Princess Alice_ (Battenberg) 
宋雅王后	Queen Song Ya 
中里崇宏	Takahiro Nakazato 
屏东延伸线	Pingtung Extension 
冈特的约翰	John of Gunter 
吴克烈	Wu Keli 
西和贺町	Nishiwaga Town 
日野汽车	Hino Motors 
第十届全国人民代表大会	Tenth National People's Congress 
fontevraud	fontevraud 
元哲学	Metaphilosophy 
金维映	Jin Weiying 
蠕蠕公主	Creepy Princess 
兰卡斯特大学	Lancaster University 
菲尔内-伏尔泰	Fernet-Voltaire 
自由民主制	Liberal democracy 
.io	.I 
罗渣士通讯集团	Rogers Communications Group 
机械加工	Machining 
慧妃_(康熙帝)	Concubine Hui_(Kangxi Emperor) 
贡多马尔足球俱乐部	Gondomar Football Club 
方济各	Francis 
中国共产党浙江省委员会	Zhejiang Provincial Committee of the Communist Party of China 
沙丘ii_新王朝	Dune ii_ New Dynasty 
育碧魁北克	Ubisoft Quebec 
司马姓	Sima Surname 
必胜客公园	Pizza Hut Park 
wikt:江苏	wikt: Jiangsu 
甘肃各市州地区生产总值列表	List of GDP of each city, prefecture and region in Gansu 
吉田豊	Yutaka Yoshida 
南非首相	Prime Minister of South Africa 
邵坚毅	Shao Jianyi 
簕杜鹃	Bougainvillea 
京乐吉本控股	Jingle Yoshimoto Holdings 
大浦兼武	Oura Kanetake 
东帝汶国家体育场	East Timor National Stadium 
窝阔台汗国	Wokotai Khanate 
jean-jacques_susini	jean-jacques_susini 
福瓦的玛格丽特	Margaret of Foix 
英国雷诺方程式冬季杯	British Formula Renault Winter Cup 
美国队长	Captain America 
陈太祖	Chen Taizu 
卡布尧市议会	Capujao City Council 
圣保利足球俱乐部	St. Pauli Football Club 
真室川町	Mamurogawa Town 
富田泰弘	Yasuhiro Tomita 
第聂伯罗彼得罗夫斯克大学	Dnipropetrovsk University 
s:交通部台湾铁路管理局组织条例	s:Organization Regulations of Taiwan Railway Administration, Ministry of Transportation 
印度尼西亚时间	Indonesia Time 
能见达也	Can meet Tatsuya 
core微架构	core microarchitecture 
飞行优异十字勋章	Flying Meritorious Cross 
中英联合联络小组	Sino-British Joint Liaison Group 
大力神四号	Hercules IV 
溪埔里	Xipuli 
超级计算机	supercomputer 
遭遇凯文·约翰逊	Encounter Kevin Johnson 
特命担当大臣	Minister in charge 
奥兰多国际机场	Orlando International Airport 
端庄固伦公主	Princess Gulun 
艾琳妮_(希腊公主)	Irene _ (Greek Princess) 
小井手翔太	Shota Koide 
顾祝同	Gu Zhutong 
匈牙利行政区划	Administrative divisions of Hungary 
湾岸：洛杉矶	Gulf Coast: Los Angeles 
.ph	.ph 
圣达尼老圣文策老圣殿总主教座堂_(克拉科夫)	St. Daniel’s Old St. Vince’s Old Basilica Cathedral_ (Krakow) 
电影配乐	Movie Soundtrack 
马尔代夫总统	President of Maldives 
国会金质奖章	Congressional Gold Medal 
喀麦隆17岁以下国家足球队	Cameroon Under-17 National Football Team 
马札尔铃木公司	Mazar Suzuki 
隼形目	Hayabusa 
匈牙利总理	Prime Minister of Hungary 
浩室音乐家列表	List of house musicians 
中央财政金融学院	Central School of Finance 
中国共产党全国代表大会	National Congress of the Communist Party of China 
奸人坚	Treacherous 
维多利亚时代	Victorian 
中华世纪坛	China Millennium Monument 
亚洲运动会	Asian Games 
开成町	Kaiseicho 
港兴里	Gangxingli 
小键琴	Harpsichord 
蛇行狸翻	Meandering raccoon dog 
图灵测试	Turing test 
雷丁_(加利福尼亚州)	Redding_ (California) 
拉乌尔_(西法兰克国王)	Raoul (King of West Franconia) 
俄罗斯联邦军队综合军事学院	General Military Academy of the Army of the Russian Federation 
欧盟委员会副主席	Vice President of the European Commission 
香农河畔卡里克	Carrick-on-Shannon 
毛里塔尼亚国歌	Mauritania National Anthem 
典选音乐	Classical music 
福克京阿	Fokkina 
皋月杜鹃	Gaoyue Rhododendron 
粒子束武器	Particle beam weapon 
第四代德文郡公爵威廉·卡文迪许	William Cavendish, 4th Duke of Devonshire 
金硕洙	Kim Suk-soo 
中国人民解放军总后勤部卫生部	Ministry of Health, General Logistics Department of the Chinese People's Liberation Army 
艾伦·森宝利，森宝利男爵	Alan Samboli, Baron Samboli 
百合鸥公司	Yuri Gull 
挪威国防军	Norwegian Defence Force 
巴斯克足球代表队	Basque National Football Team 
地狱少女	Hell Girl 
日韩合并	Japan-Korea merger 
基督教民主运动	Christian democratic movement 
纳斯达克100指数	Nasdaq 100 Index 
郑州铁路局	Zhengzhou Railway Bureau 
蒂米什瓦拉足球俱乐部	Timisoara Football Club 
赫曼_(密苏里州)	Herman_ (Missouri) 
美利坚大学	American University 
长春诚业	Changchun Chengye 
伊势原市	Isehara City 
倚天剑	Heavenly Sword 
印度民族起义	Indian National Uprising 
电影导演	Movie director 
国立霞丘陆上竞技场	National Kasumigaoka Land Arena 
西北闪米特语	Northwest Semitic 
工人国际法国支部	Workers International France Branch 
温哥华国际机场	Vancouver International Airport 
亚特兰提斯号太空梭	Space Shuttle Atlantis 
刘智爱	Liu Zhiai 
园田直	Sonoda Nao 
汶莱dpmm足球俱乐部	Brunei dpmm football club 
冲浪音乐	Surf music 
华谊兄弟传媒股份有限公司	Huayi Brothers Media Co., Ltd. 
奈良县民歌	Folk Songs of Nara Prefecture 
卡特·皮尤特施密特	Carter Pietschmidt 
区域中心城市	Regional center city 
佛罗里达国际大学体育场	Florida International University Stadium 
圣玛丽大学教堂	St. Mary's University Church 
莽古济	Mangguzi 
康顿议会	Condon Council 
湘南土话	Shonan dialect 
两德统一	Reunification of Germany 
邻家花美男	Beautiful boy next door 
历史哲学	Philosophy of history 
自由意志社会主义	Free will socialism 
流浪神差	Wanderlust 
美国唱片	American Records 
托里什联合	Torish United 
西班牙共产主义工人党_(1921年)	Spanish Communist Workers Party_ (1921) 
斯洛文尼亚国徽	National Emblem of Slovenia 
zh:mnet媒体	zh:mnet media 
英国最高法院院长	President of the Supreme Court of the United Kingdom 
希特勒内阁	Hitler's Cabinet 
吴镇宇	Wu Zhenyu 
陕西浐灞	Chanba, Shaanxi 
宫本武藏	Miyamoto Musashi 
查尔斯顿_(西弗吉尼亚州)	Charleston_ (West Virginia) 
松宫勋	Song Gongxun 
吴永春_(足球运动员)	Wu Yongchun_(football player) 
女王的诞生	The birth of the queen 
佩鲁贾	Perugia 
巾帼枭雄	Heroines 
桌面环境	Desktop environment 
两轮选举制	Two-round election 
清世祖废后	After Qing Shizu was abolished 
伦斯的朱迪斯	Judith of Lens 
旧金山市长	Mayor of San Francisco 
杰佛逊县_(肯塔基州)	Jefferson County_(Kentucky) 
北秋田市	Kitaakita City 
欧洲西部时间	Western European Time 
澳门格兰披治大赛车	Macau Grand Prix 
煤气灯下	Under the gas lamp 
欧塞尔足球俱乐部	Auxerre Football Club 
天主教波哥大总教区	Catholic Archdiocese of Bogota 
中岛和子	Kazuko Nakajima 
武汉会战	Battle of Wuhan 
禄东赞	Lu Dongzan 
安道尔足球总会	Andorra Football Association 
社会主义共和国	Socialist republic 
普罗旺斯的里希尔德	Rihild in Provence 
唐贺夫拿	Don Hefner 
江湾体育中心	Jiangwan Sports Center 
孤岛惊魂系列	Far Cry Series 
查尔斯·布兰登，第一代萨福克公爵	Charles Brandon, first Duke of Suffolk 
伊拉克内战	Iraqi Civil War 
陈树	Chen Shu 
可转移单票制	Transferable single ticket system 
爱沙尼亚足球协会	Estonian Football Association 
蛋黄果	Egg Yolk 
德摩根奖章	De Morgan Medal 
协和商工	Concord Commercial 
江苏省泰州中学	Taizhou Middle School, Jiangsu Province 
松田翔太	Shota Matsuda 
阿尔巴尼亚宪法	Albanian Constitution 
阿马多拉足球俱乐部	Amadora Football Club 
塞维亚足球俱乐部	Seville Football Club 
缅甸联邦议会民族院	National Council of the Union of Myanmar 
岛津幸	Shimazu Yuki 
班顿·波里路	Bandon Pori Road 
明斯特大学	University of Munster 
连南瑶族自治县	Liannan Yao Autonomous County 
成都天诚足球俱乐部	Chengdu Tiancheng Football Club 
南非洲足球协会议会	South African Football Association Parliament 
潘洛斯铺砖法	Penrose Brick Method 
沙姆军团	Sham Army 
第五届香港立法会	The 5th Hong Kong Legislative Council 
京成上野站	Keisei Ueno Station 
军事独裁	Military dictatorship 
阿基坦公爵列表	List of Duke of Aquitaine 
西部省_(巴布亚纽几内亚)	Western Province_ (Papua New Guinea) 
涪陵体育场	Fuling Stadium 
久迩宫朝彦亲王	Prince Asahiko Kyuomiya 
孝愍让皇后	Filial piety makes the queen 
赵宪	Zhao Xian 
左翼民族主义	Left-wing nationalism 
寿臧和硕公主	Shou Zang and Princess Heshuo 
罗德西亚元	Rhodesian Dollar 
路德维希二世_(黑森大公)	Ludwig II_ (Grand Duke of Hessen) 
奇幻漫画	Fantasy Comics 
刘载兴	Liu Zaixing 
希腊23岁以下国家足球队	Greece Under-23 National Football Team 
东森戏剧台	Dongsen Theatre 
roczyny	roches 
龚政豪	Gong Zhenghao 
切萨皮克能源球场	Chesapeake Energy Stadium 
美国军队总指挥官	U.S. Army Commander 
北京美国英语语言学院	Beijing American English Language Institute 
大阪市营地下铁	Osaka Municipal Subway 
昆明锐龙足球俱乐部	Kunming Ruilong Football Club 
城际铁路	Intercity Railway 
小龙斯派罗系列	Little Dragon Spyro Series 
池口修次	Shuji Ikeguchi 
洛林-法兰哥尼亚语	Lorraine-Franconian 
迷雾之岛	Misty Island 
富勒顿_(加利福尼亚州)	Fullerton_ (California) 
西温哥华_(不列颠哥伦比亚)	West Vancouver_(British Columbia) 
飞碟唱片	UFO records 
晋江祖昌体育场	Jinjiang Zuchang Stadium 
内阁厅长官	Chief of cabinet 
日本国政府	Government of Japan 
皇家唐桥井	Royal Tangqiao Well 
斯洛维尼亚银行	Bank of Slovenia 
伊诺力克工业股份	Innolic Industries 
耶稣基督后期圣徒教会	Church of Jesus Christ of Latter-day Saints 
埃及神话	Egyptian mythology 
越南国旗	Vietnam flag 
香港一元硬币	Hong Kong One Dollar Coin 
信仰破灭乐团	Disillusioned Orchestra 
大发hijet	大 发 shadows 
和裕皇贵妃	Concubine Heyu Emperor 
锡兰君主	Ceylon monarch 
澳大利亚南极领地	Australian Antarctic Territory 
陈璞如	Chen Puru 
sbs广播电视集团	sbs radio and television group 
世界大赛最有价值球员奖	World Series Most Valuable Player Award 
张雁名	Zhang Yanming 
美国民主党	United States Democratic Party 
苏州注音符号	Suzhou phonetic symbols 
爱沙尼亚总统	President of Estonia 
圣文生角战役_(1797年)	Battle of Cape Saint Vincent_ (1797) 
张华标	Zhang Huabiao 
添士拿	Tim Sner 
蒙大拿州各县列表	List of counties in Montana 
中国共产党党旗党徽	Flag and emblem of the Communist Party of China 
朝鲜民主主义人民共和国外务省	Ministry of Foreign Affairs of the Democratic People's Republic of Korea 
费尔盖拉斯足球俱乐部	Fergueiras Football Club 
动力运动	Dynamic movement 
扭量理论	Twist theory 
公视2台	PTV 2 
古巴共产党中央委员会第一书记	First Secretary of the Central Committee of the Communist Party of Cuba 
lubsko	lubsko 
李凤明	Li Fengming 
奥特鲁德公主(石勒苏益格-荷尔斯泰因-宗德堡-格吕克斯堡)	Princess Outrud (Schleswig-Holstein-Zonderberg-Glücksburg) 
塞西尔·哈姆斯沃斯，第一代哈姆斯沃斯男爵	Cecil Harmsworth, the first Baron Harmsworth 
邢李㷧	Xing Li 㷧 
拉玛六世	Rama VI 
数字电视	Digital Television 
c-295m	c-295m 
北大宫站	Beida Palace Station 
穆塔瓦基勒三世	Mutawakil III 
秋山津摩	Akiyama Tsuma 
绿地控股集团	Greenland Holding Group 
拉夫伯勒_(英国国会选区)	Loughborough_ (British Parliamentary District) 
石田美由纪	Miyuki Ishida 
德里红堡	Red Fort 
1707年联合法令	Union Act 1707 
未划定远西地区	Undelimited Far West Region 
葛逻禄语支	Geluolu branch 
托马斯·佩勒姆，第二代奇切斯特伯爵	Thomas Pelham, 2nd Earl of Chichester 
约翰·格奥尔格_(霍亨索伦)	John Georg_ (Hohenzollern) 
野泽秀行	Hideyuki Noso 
千年隼号	Millennium Falcon 
歌曲作者	Songwriter 
以色列航太工业	Israel Aerospace Industry 
埃尔温·冯·维茨莱本	Erwin von Witzleben 
周耀中	Zhou Yaozhong 
新福尔摩斯	New Holmes 
胡佛研究所	Hoover Institution 
大连台安老哥们足球俱乐部	Dalian Tai'an Old Friends Football Club 
曼尼托巴省新民主党	New Democratic Party of Manitoba 
哈佛大学文理学院	Harvard University School of Arts and Sciences 
勒诺克斯山医院	Lenox Hill Hospital 
小林雄次	Yuji Kobayashi 
伊凡五世	Ivan V 
绣球花	Hydrangea 
astro双星hd	astro double star hd 
新时代电视	New age television 
关诗敏	Guan Shimin 
圣若瑟书院	St. Joseph's College 
伊斯兰伊朗建设者联盟	Islamic iran builders union 
鹰司和子	Kazuko Takatsuka 
西班牙22岁以下国家足球队	Spain Under-22 National Football Team 
三一运动	Trinity Movement 
拉合尔管理科学大学	Lahore University of Management Sciences 
登吕遗址	Toro Ruins 
西班牙总统	President of Spain 
新泽西州州长	Governor of New Jersey 
利马联盟	Lima Union 
明尼苏达双城	Minnesota Twins 
南京金基地产	Nanjing Jinji Real Estate 
托金斯迪克度假酒店球馆	Talking Stick Resort Arena 
龙岩民系	Longyan Minxi 
林见如	Lin Jianru 
古典自由主义	Classical liberalism 
美国陆军部队司令部	U.S. Army Forces Command 
超威半导体	Chaowei Semiconductor 
弗朗索瓦二世，布列塔尼公爵	Francois II, Duke of Brittany 
胡志明共产主义青年团	Ho Chi Minh Communist Youth League 
黎彼得	Li Peter 
安徽师范大学	Anhui Normal University 
中国南方航空	China Southern Airlines 
【中国教育部区域与国别研究基地】	【Regional and National Research Bases of the Ministry of Education of China】 
莫沙高达	Mosha Gundam 
常飞亚	Chang Feiya 
欧锦棠	Ou Jintang 
贝尔206	Bell 206 
超级偶像1	Super idol 1 
湖南省公安厅	Hunan Provincial Public Security Department 
大野功统	Ono Gongtong 
前270年	270 years ago 
tvn月火连续剧	tvn moonfire series 
北京职工体育服务中心	Beijing Staff Sports Service Center 
皮亚特拉尼亚姆茨恰赫勒乌足球俱乐部	Piatra Neamtschahelau Football Club 
阿拉米达_(加利福尼亚州)	Alameda_ (California) 
亚利桑那州立大学	Arizona State University 
马里北部冲突	Conflict in northern Mali 
中央直辖区	Central Territory 
大流士一世	Darius I 
sbs月火连续剧	sbs moonfire series 
和硕端柔公主	Princess He Shuo Duan Rou 
第3次小泉内阁	The 3rd Koizumi Cabinet 
红宝石设计局	Ruby Design Bureau 
威塞克斯的玛格丽特	Margaret of Wessex 
浙江大学数学科学研究中心	Mathematical Research Center of Zhejiang University 
布列塔尼公爵列表	List of Dukes of Brittany 
丸桥祐介	Yusuke Maru 
agentsheets	agentsheets 
中国人民解放军少将	Major General of the Chinese People's Liberation Army 
中华人民共和国中央军事委员会	The Central Military Commission of the People's Republic of China 
爱尔兰上议院	Irish House of Lords 
乌拉圭足球乙级联赛	Uruguay Football Second Division 
北久保弘之	Hiroyuki Kitakubo 
李守信	Li Shouxin 
hb娱乐	hb entertainment 
平台游戏	Platform game 
许燕露	Xu Yanlu 
韩国放送公社	Korea Broadcasting Corporation 
希腊财政部	Greek Ministry of Finance 
储君配偶	Crown Prince's Spouse 
塞雷_(东比利牛斯省)	Cerès (Pyrenees-Orientales) 
中华民国最高行政法院	Supreme Administrative Court of the Republic of China 
日本天皇列表	List of Emperors of Japan 
berrouaghia	Screws 
强类型	Strong type 
李台熙	Lee Tae Hee 
barathrum	exposed 
高海宁	Gao Haining 
西班牙20岁以下国家足球队	Spain Under-20 National Football Team 
阮文安	Nguyen Van An 
西克斯图斯·亨利王子_(波旁-帕尔马)	Prince Sixtus Henry_ (Bourbon-Parma) 
王冠属地	Crown possession 
chromeo	chromeo 
辽宁各地级市地区生产总值列表	List of regional GDP of each city in Liaoning 
内湖省行政区划	Administrative divisions of Neihu Province 
席琳·狄翁	Celine Dion 
多数制	Majority 
1986年亚洲女子足球锦标赛	1986 Asian Women's Football Championship 
仁寿里_(冈山区)	Renshouli_(Gangshan District) 
登陆之日	Landing day 
利福得	Liford 
拉杰什·库斯拉帕里	Rajesh Kuslapari 
李受美	Li Shoumei 
郭宗清	Guo Zongqing 
国际组织	International organizations 
阿塞拜疆总统	President of Azerbaijan 
日本大学	Nihon University 
德国中央党	German Central Party 
法国荣誉军团勋章	French Legion of Honor 
中苏边界冲突	Sino-Soviet border conflict 
卡洛曼一世	Carloman I 
帕特·奎因	Pat Quinn 
波旁-帕尔玛家族	Bourbon-Parma family 
少年泰坦成员列表	List of Junior Titans 
中意大利联合省	United Province of Central Italy 
圣安德肋教堂_(科隆)	St. Andrew's Church_ (Cologne) 
中央军事委员会办公厅	General Office of the Central Military Commission 
摩德纳足球俱乐部	Modena Football Club 
岛津忠刚	Shimadzu Tadashi 
tnmk	tnmk 
中华民国陆军司令	Commander of the republic of china army 
下营区	Xiaying District 
青海各地州市地区生产总值列表	List of GDP of all prefectures and cities in Qinghai 
伊比利亚半岛	Iberian Peninsula 
奥斯曼帝国大空位期	Ottoman Empire 
自治领	Dominion 
涡轮扇发动机	Turbofan engine 
柬越战争	Cambodia-Vietnam War 
冒险漫画	Adventure Comics 
林夕	Lin Xi 
长岛昭久	Nagashima Akihisa 
英格兰君主配偶列表	List of spouses of the monarch of England 
狂飙突进运动	Hurricane forward movement 
中古波斯语	Middle Persian 
昭陵六骏图卷	Zhaoling Six Horses Scroll 
唐良智	Tang Liangzhi 
塞利亚_(特鲁埃尔省)	Sella_ (Teruel) 
第一次车臣战争	The first Chechen war 
克里欧人	Clio 
哈泰拿泰纳古尔	Hatenathanagur 
马其顿崛起	Rise of Macedonia 
车库朋克	Garage Punk 
咏春_(电视剧)	Wing Chun_ (TV series) 
泉泽仁	Quan Zeren 
斯托克斯定理	Stokes Theorem 
太阳公公	the sun 
韩惪洙	Han Dezhu 
齐锡麟	Qi Xilin 
格鲁吉亚-南奥塞梯冲突	Georgia-South Ossetia conflict 
圣母圣殿_(克拉科夫)	Basilica of Our Lady_ (Krakow) 
伊林娱乐	Yilin Entertainment 
北海银行	North Sea Bank 
荷兰19岁以下国家足球队	Netherlands Under-19 National Football Team 
国防部长(法国)列表	List of Ministers of Defense (France) 
爱尔兰布政司	Ireland 
意大利王国_(1861–1946)	Kingdom of Italy_(1861–1946) 
奥地利维也纳足球俱乐部	Vienna Football Club 
右翼力量联盟	Right wing power alliance 
参议院多数党党鞭	Senate Majority Whip 
情景喜剧	Sitcom 
意大利裔阿根廷人	Italian Argentine 
法国警队	French Police 
大雄宝殿	Daxiong Hall 
安妮-玛丽_(希腊王后)	Anne-Marie_ (Queen of Greece) 
汉口文化体育中心	Hankou Culture and Sports Center 
月刊少年ace	Monthly youth ace 
公民民族主义	Civic nationalism 
复星国际	Fosun International 
波斯湾战争	Persian Gulf War 
三爷里	Sanyeli 
田原丰	Tahara 
mannerheimintie	Mannerheimintie 
慈裕太后	Empress Dowager Ciyu 
国立政治大学	National Chengchi University 
船木结	Funaki knot 
科威特足球协会	Kuwait Football Association 
第一国务大臣	First minister of state 
学校的阶梯_(电视剧)	School Ladder_ (TV series) 
爱德华·卡文迪许，第十代德文郡公爵	Edward Cavendish, 10th Duke of Devonshire 
权敬原	Quan Jingyuan 
interscope唱片公司	interscope record company 
利沃诺足球俱乐部	Livorno Football Club 
阿拉贡的罗德里哥	Rodrigo of Aragon 
饭野町	Iino Town 
京都动画	Kyoto Animation 
湖南省立第三师范学校	Hunan Provincial Third Normal School 
女人30情定水舞间	Women's 30 Love Dancing Water House 
metropolitano球场	metropolitano stadium 
朝鲜劳动党中央委员会	Central Committee of the Workers' Party of Korea 
安藤永伦	Ando 
美国海军陆战队军乐团	U.S. Marine Corps Military Band 
.ae	.ae 
中央部属高校	Central-affiliated universities 
马来西亚统治者列表	List of rulers of Malaysia 
湄洲里	Meizhouli 
阿根廷摇滚	Argentine Rock 
美国正义会社	Justice of America 
智利20岁以下国家足球队	Chile Under-20 National Football Team 
太极乐队	Tai Chi Band 
有线电影强档	Strong file for cable movies 
申园昊	Shen Yuanhao 
有栖川宫炽仁亲王	Prince Yusugawa Palace Chihi 
廖晋硕	Liao Jinshuo 
第二方面军司令	Commander of the second front 
安纳波利斯集团	Annapolis Group 
海地克里奥尔语	Haitian Creole 
裸子植物门	Gymnosperm 
同温层红外线天文台	Stratospheric Infrared Observatory 
林幼芳	Lin Youfang 
坦噶尼喀地区总督	Governor of Tanganyika Region 
写实电影	Realistic movie 
布伦瑞克足球俱乐部	Brunswick Football Club 
恶魔奶爸	Devil Dad 
罗萨里奥中央	Rosario Central 
横滨高速铁道	Yokohama Express Railway 
悉尼奥林匹克足球俱乐部	Sydney Olympic Football Club 
蒋超良	Jiang Chaoliang 
双手互搏	Hands together 
福克纳选区	Faulkner Constituency 
秋元才加	Qiu Yuan Caijia 
高恩南	Gao Ennan 
穆卡托·诺托维狄格多	Mukato Notovedigdo 
血界战线	Blood Front 
热月政变	Hot Moon Coup 
欧洲现实主义	European Realism 
埃及镑	Egyptian Pound 
armv7	armv7 
葡萄牙奥林匹克足球队	Portugal Olympic Football Team 
沙特阿拉伯国徽	Saudi Arabia National Emblem 
比利时17岁以下国家足球队	Belgium Under-17 National Football Team 
游戏开发者	Game developer 
胡启澳	Hu Qiao 
东近江市	Higashiomi City 
福音摇滚	Gospel rock 
甲北里	Jiabei li 
圣萨巴斯战争	War of St. Sabas 
英国海外领土	British Overseas Territories 
游戏机历史_(第三世代)	Game console history_ (third generation) 
1999年亚洲女子足球锦标赛	1999 Asian Women's Football Championship 
八木征志	Masashi Yagi 
吴建新	Wu Jianxin 
tt语音	tt voice 
当代哲学	Contemporary philosophy 
罗本立	Robbenli 
中央人民政府卫生部	Ministry of Health of the Central People's Government 
吴咏琪	Gigi Wu 
智能手表	smart watch 
奈良八重樱	Nara Yaegashi 
地面电视	Terrestrial television 
伊朗国防工业局	Iranian Defense Industry Agency 
巴西民主运动党	Brazilian Democratic Movement Party 
独立游戏	Indie game 
贝里斯元	Belize Dollar 
英国地区政府	British regional government 
铃木公司	Suzuki Corporation 
龙凤斗	Dragon and phoenix 
牛津大学圣休学院	St. Hugh College, Oxford University 
主流爵士乐	Mainstream jazz 
李浚赫	Lee Jun Hyuk 
达德里·莱德，第三代哈罗比伯爵	Dudley Ryder, 3rd Earl of Harroby 
高贵的家园，你美丽的旗帜	Noble home, your beautiful banner 
全北现代汽车	Jeonbuk Hyundai Motor 
让·巴蒂斯特·盖_(马蒂尼亚克子爵)	Jean Baptiste Guyé (Viscount Martignac) 
海润影视	Hairun Television 
卡尔十二世	Karl XII 
高雄市立中正高级工业职业学校	Kaohsiung Zhongzheng Advanced Industrial Vocational School 
极轨道	Polar orbit 
东京都第18区	Tokyo's 18th district 
春秋航空	Spring Airlines 
日本海上自卫队	Japan Maritime Self-Defense Force 
萨克森-哥达-阿尔滕堡	Saxony-Gotha-Altenburg 
雅大墓地	Yada cemetery 
小策零敦多布	Kosaku Ling Tun Dob 
罗马尼亚经济和商业部	Romanian Ministry of Economy and Commerce 
沈阳城门	Shenyang City Gate 
王明方	Wang Mingfang 
佩德罗_(巴西帝国王子)	Pedro_ (Prince of the Brazilian Empire) 
原始宗教	Primitive religion 
吕珊珊	Lu Shanshan 
市场经济	Market economy 
凯恩的遗产系列	Kane's Legacy Series 
明知大学	Mingji University 
汪荣华	Wang Ronghua 
议会-经理制	Council-manager system 
pledis娱乐	pledis entertainment 
牟鹏飞	Mou Pengfei 
英格兰议会	Parliament of England 
李绮华	Li Qihua 
.ar	.With 
德瑞医生	Dr. Dre 
敖德萨海员足球俱乐部	Odessa Seamen Football Club 
转角＊遇到爱	Corner * meet love 
景盛通宝	Jingshengtongbao 
最终幻想xii	Final Fantasy xii 
200欧元纸币	200 euro banknotes 
一夜狂欢	Night party 
天宫一号	Tian-Gong 
罗森斯得实验站	Rosenstead Experimental Station 
弗里德里希·威廉_(霍亨索伦)	Friedrich Wilhelm (Hohenzollern) 
巴伐利亚的艾玛	Emma of Bavaria 
国防部政治作战局	Political Operations Bureau of the Ministry of Defense 
小池纯辉	Koike Junki 
全国广播公司	National Broadcasting Corporation 
意大利天主教民主党	Catholic Democratic Party of Italy 
联合车站_(印第安纳波利斯)	Union Station_ (Indianapolis) 
英国驻丹麦大使	British Ambassador to Denmark 
堪察加语系	Kamchatka language family 
非选区议员	Non-constituency councillor 
约翰十五世	John XV 
三星显示	Samsung Display 
华语流行	Popular Chinese 
奥斯卡最佳女主角奖	Oscar for Best Actress 
现代伊兰特	Hyundai Elantra 
乌克兰文	Ukrainian 
希腊总统列表	List of Presidents of Greece 
张富士夫	Zhang Fujifu 
基督教社会党	Christian Socialist Party 
中华东正教会	Chinese Orthodox Church 
三重县旗	Mie County Flag 
崔德新	Cui Dexin 
闭源软体	Closed source software 
抗日军政大学	Anti-Japanese Military and Political University 
西南通古斯语支	Southwest Tungusic 
1979年中越战争	1979 Sino-Vietnam War 
帕瑞萨娣丝二世	Parasades II 
福岛正则	Fukushima Masanori 
吉尔吉斯共和国国家银行	National Bank of the Kyrgyz Republic 
.pw	.pw 
俄罗斯二队	Russia second team 
北条时政	Hojo Current Affairs 
邹晓利	Zou Xiaoli 
比哈奇	Bihac 
威廉二世_(奥兰治)	William II_ (Orange) 
电子交易	Electronic transaction 
前卫出神音乐	Avant-garde trance music 
basquash!	basquash! 
火炬体育团	Torch Sports Team 
总增加值	Total value added 
尾张国	Owari 
山东省男子队_(2011年)	Shandong Men's Team_ (2011) 
国际关系现实主义	International Relations Realism 
瑞典省份议会	Swedish Provincial Council 
布洛姆贝格条约	Treaty of Blomberg 
罗贝托二世_(帕尔马)	Roberto II_ (Parma) 
宦海奇官	Eunuch 
美国联邦政府	U.S. Federal Government 
红色阵线战士同盟	Red Front Warrior League 
奥地利u18足球代表队	Austrian U18 Football Team 
英国驻法国大使	British Ambassador to France 
参议院少数党领袖	Senate Minority Leader 
苏黎世草蜢足球俱乐部	Zurich Grasshoppers Football Club 
下村博文	Hakubun Shimomura 
名侦探柯南	Detective Conan 
伦敦音乐与戏剧艺术学院	London School of Music and Dramatic Art 
申圭植	Shin Kyu Sik 
笠原绅司	Kasahara Shinji 
邓凯尔德王朝	Dunkeld Dynasty 
教宗巴斯加一世	Pope Basca I 
美国广播公司	ABC 
芝加哥袜队	Chicago Sox 
阿弗雷多·沛雷兹·卢巴卡巴	Alfredo Perez Lubacaba 
秘鲁陆军	Peruvian Army 
哥德字母	Gothic alphabet 
王哲_(足球裁判)	Wang Zhe_(Football Referee) 
意大利足球总会	Italian Football Association 
德利城足球俱乐部	Deli City Football Club 
江苏盐城鼎立足球俱乐部	Jiangsu Yancheng Dingli Football Club 
欧亚大陆	Eurasia 
埃迪尔内	Edirne 
牛津大学基督堂学院	Christ Church College, Oxford University 
国民公会	National Convention 
热河战役	Battle of Jehol 
慈文影视	Ciwen Television 
凯尔特融合	Celtic Fusion 
两伊战争	Iran-Iraq war 
上海轨道交通9号线	Shanghai Rail Transit Line 9 
台北市立松山高级工农职业学校	Taipei Songshan Advanced Industrial and Agricultural Vocational School 
哥伦比亚保守党	Conservative Party of Colombia 
末日三重奏	Doomsday Trio 
雪城(纽约州)	Syracuse (New York State) 
中华人民共和国政府	Government of the People's Republic of China 
李贻衡	Li Yiheng 
真仙魔大战	True fairy war 
武藤将吾	Shogo Muto 
第七届全国人民代表大会常务委员会	Standing Committee of the Seventh National People's Congress 
北京大学中国语言文学系	Department of Chinese Language and Literature, Peking University 
高地德语	High German 
我家3姊妹	My 3 sisters 
迪卡唱片公司	Deca Records 
美国国家安全委员会	National Security Council 
梅克伦堡-施特雷利茨的路易丝	Louise of Mecklenburg-Strelitz 
曾修读香港城市大学	Studied at City University of Hong Kong 
里泽体育	Rize Sports 
教宗路基约一世	Pope Luquillo I 
戈登_(英国国会选区)	Gordon_ (British Parliamentary District) 
沙特阿拉伯行政区划	Administrative divisions of Saudi Arabia 
科学教育	scientific education 
模拟直升机	Simulated helicopter 
并立制	Parallel system 
光明影院	Bright Cinema 
旅馆之嫁	Hotel marriage 
圣护院宫嘉言亲王	Prince Kayan 
巴伐利亚的玛利亚·约瑟法	Maria Josepha of Bavaria 
败犬女王	Queen of Losing Dogs 
罗宝生	Luo Baosheng 
柬埔寨内战	Cambodian Civil War 
乔治华盛顿大学法学院	George Washington University School of Law 
张恒浩	Zhang Henghao 
澳洲足协杯	Australian Football Association Cup 
简·西摩_(英格兰王后)	Jane Seymour_ (Queen of England) 
反恐战争服役奖章	Service Medal in the War on Terrorism 
不结盟运动	Non-aligned movement 
夏天的free&easy	Summer free&easy 
大寮延伸线	Daliao Extension 
尼泊尔君主列表	List of monarchs of Nepal 
何建中	He Jianzhong 
大众cc	Volkswagen cc 
马其顿国王列表	List of Kings of Macedonia 
3世纪	3rd century 
曼恩的阿黛尔	Adele of Mann 
弗兰克-瓦尔特·施泰因迈尔	Frank-Walter Steinmeier 
列格尼卡战役	Battle of Legnica 
寺田贵信	Takanobu Terada 
个人电脑	personal computer 
艾力·奥辛斯达拿	Alec Ossinstadner 
内梅西奥·迭兹体育场	Nemesio Diez Stadium 
罗马共和国_(18世纪)	Roman Republic_ (18th century) 
东条昭平	Tojo Shohei 
中国共产党广东省委员会	Guangdong Provincial Committee of the Communist Party of China 
岩佐守	Iwasamori 
爱国者联盟	Patriot League 
马来西亚足球协会	Malaysian Football Association 
路易萨·玛丽亚_(两西西里)	Luisa Maria_ (Two Sicily) 
越南船民	Vietnamese boat people 
无尽干渴_(穹顶之下)	Endless Thirst_ (under the dome) 
第三人称射击	Third person shooting 
恒星核合成	Stellar nucleosynthesis 
上野原市	Uenohara City 
第三次神圣战争	The third holy war 
西北大学_(伊利诺州)	Northwestern University_ (Illinois) 
嗨↑起来吧	Hey ↑ get up 
交响摇滚	Symphonic Rock 
管国伟	Guan Guowei 
阿伦草地体育会	Allen Meadows Sports Club 
计算神经科学	Computational Neuroscience 
太合麦田	Taihe Wheat Field 
入侵格林纳达	Invasion of Grenada 
季冠霖	Ji Guanlin 
爱尔兰君主配偶列表	List of spouses of Irish monarchs 
伊朗足球甲级联赛	Iran Football League 
缅甸标准时间	Myanmar Standard Time 
玛丽亚·德·拉斯·梅赛德斯_(阿斯图里亚斯女亲王)	Maria de las Mercedes_ (Prince of Asturias) 
城关区_(兰州市)	Chengguan District_(Lanzhou City) 
夏尔·施皮纳塞	Charles Spinasse 
关文深	Guan Wenshen 
克莱蒙特学院	Claremont College 
银河参议院	Galaxy Senate 
松田靖	Matsuda Yasushi 
近藤浩治	Koji Koji 
池田仲博	Nakahiro Ikeda 
1800年联合法令	Union Act 1800 
月刊少年gangan	Monthly Youth Gangan 
音效设计	Sound design 
波士顿篮球合作公司	Boston Basketball Cooperative 
苏联红军	Soviet Red Army 
谭翠珊	Tan Cuishan 
芬兰总理列表	List of Prime Ministers of Finland 
印度民族主义	Indian Nationalism 
小詹姆士·比克坎	James Bickcan Jr 
中华人民共和国农业部	Ministry of Agriculture of the People's Republic of China 
瓜达尔卡纳尔岛战役	Battle of Guadalcanal 
驻日美军	US troops stationed in Japan 
诺基亚产品列表	Nokia product list 
织田信治	Nobuharu Oda 
杜拉拉追婚记	Du Lala Marriage 
同塔足球俱乐部	Tong Thap Football Club 
义大利与盟国停战	Italy and the Allies Truce 
自由民主青年组织	Liberal Democratic Youth Organization 
福田贵代子	Fukuda Kiyoko 
切尔诺夫策大学	Chernivtsi University 
阿尔萨法体育俱乐部	Al Safa Sports Club 
海梅娜_(潘普洛纳)	Jaimena_ (Pamplona) 
中国货运航空	China Cargo Airlines 
刘文庆_(足球运动员)	Liu Wenqing_ (football player) 
异世奇人_(系列3)	Strange People_ (Series 3) 
伊朗外交部部长	Minister of Foreign Affairs of Iran 
李敏_(毛娇娇)	Li Min_(Mao Jiaojiao) 
渡边谦	Ken Watanabe 
伏林航空	Vueling Airlines 
日本进步党	Progressive Party of Japan 
北京金牌大风文化传播有限公司	Beijing Gold Medal Dafeng Culture Communication Co., Ltd. 
德国大学卓越计划	German University Excellence Program 
三保之松原	Miho no Matsubara 
滚石唱片	Rolling Stone Records 
东映广告	Toei Advertising 
车熙林	Che Xilin 
巴西国防部	Brazilian Ministry of Defense 
泰国人	Thai 
公共广播	Public broadcasting 
奥古斯塔斯·腓特烈王子_(萨西克斯公爵)	Prince Augustus Frederick_ (Duke of Sussex) 
昭宫犹仁亲王	Prince Yuren of Zhaogong 
2012年万千星辉颁奖典礼	2012 Thousand Thousand Stars Awards Ceremony 
苏格兰英语	Scottish English 
香港首席大法官	Chief Justice of Hong Kong 
南达科塔州立大学	South Dakota State University 
亨利五世_(神圣罗马帝国)	Henry V_ (Holy Roman Empire) 
东比惠车站	Higashibie Station 
巴基斯坦参议院	Senate of Pakistan 
法国工业和商业部	French Ministry of Industry and Commerce 
奇皇后_(电视剧)	Queen Qi_ (TV series) 
上田文雄	Fumio Ueda 
强相互作用	Strong interaction 
中央人民政府委员会	Central People's Government Committee 
米尔扎·马哈茂德汗	Mirza Mahmoud Khan 
安成公主	Princess Ancheng 
朝鲜民主主义人民共和国中央银行	Central Bank of the Democratic People's Republic of Korea 
第七届全国人民代表大会	Seventh National People's Congress 
松田正久	Masahisa Matsuda 
法属海外领地	French overseas territories 
贝阿特丽丝公主_(爱丁堡和萨克森-科堡-哥达)	Princess Beatrice_ (Edinburgh and Saxony-Coburg-Gotha) 
大洛杉矶地区	Greater Los Angeles 
葛爱美	Ge Aimei 
山额夫	Shan Nafu 
玛格·阿斯奎斯，牛津及阿斯奎斯伯爵夫人	Marg Asquith, Countess of Oxford and Asquith 
圣塔克拉拉大学	Santa Clara University 
恐怖游戏	Horror game 
赛门与葛芬柯	Simon and Geffenco 
国家国防科技工业局	National Defense Technology Industry Administration 
赖德_(新南威尔斯)	Ryder_ (New South Wales) 
法国工程师学院	French Institute of Engineering 
新北市私立光仁高级中学	New Taipei City Private Guangren Senior High School 
bet电视网	bet television network 
法国国王	King of France 
宋亚平	Song Yaping 
斯洛文尼亚总统列表	List of Presidents of Slovenia 
东三条第	Tosanjo 
反乌托邦	Dystopia 
吊人索	Sling 
近藤加寿尾	Kondo Kazuo 
hatehof	hatehof 
苏联军队	Soviet Army 
皆大欢喜_(时装电视剧)	Everyone Happy_ (Fashion TV Series) 
揆常在	揆常在 
伊朗郡	Iran County 
英格兰足总锦标	England Football Association Championship 
筑波未来市	Tsukuba Mirai City 
终极动员令：红色警戒	Ultimate Mobilization Order: Red Alert 
布里亚特共和国国旗	Flag of the Republic of Buryatia 
笃子内亲王	Prince Atsuko 
国际空间站	International Space Station 
池文一	Chi Wenyi 
和田彩花	Ayaka Wada 
义大利入侵阿尔巴尼亚	Italy invaded Albania 
林堡省国王专员列表	List of Commissioners of the King of Limburg 
八条宫智仁亲王	Prince Hachijo Miyachihito 
新生医护管理专科学校	Freshman Medical and Nursing Management College 
荷兰17岁以下国家足球队	Netherlands Under-17 National Football Team 
山乡望	Shanxiangwang 
新营区	Xinying District 
勃艮第统治者列表	List of Burgundy rulers 
中岛翔哉	Shoya Nakajima 
回到爱以前	back to the past love 
我们等你	we will wait for you 
吕多维克-奥斯卡·弗罗萨尔	Ludovic-Oscar Frosal 
阿姆斯特丹足球会	Amsterdam Football Club 
法兰西斯·西摩尔-康韦，第一代赫特福德侯爵	Francis Seymour-Conway, the first Marquis of Hertford 
命运战士	Soldier of Fortune 
普通翠鸟	Common kingfisher 
南云齐	Nan Yunqi 
卢福宁	Lu Funing 
电子浩室	Electronic house 
日本超级杯	Japan Super Cup 
李景杰	Li Jingjie 
核心马来-玻里尼西亚语族	Core Malay-Polynesian 
比利时银行	Bank of Belgium 
苏联空军	Soviet Air Force 
心之羽根	Kokoro no Hane 
纽约市市长	Mayor of New York City 
李大章	Li Dazhang 
金卷兼一	Kenichi Kanemaki 
冯·格康，玛格及合伙人建筑师事务所	Von Gerkan, Marg and Partners Architects 
尼泊尔政府首脑列表	List of Heads of Government of Nepal 
教宗维达	Pope Vader 
浦田直也	Naoya Urata 
沭城街道	Shucheng Jiedao 
他们的世界	Their world 
约瑟夫·克莱·斯泰尔斯·布莱克本	Joseph Clay Styles Blackburn 
惊悚小说	Thriller 
自由球员	Free agent 
澳大利亚17岁以下国家足球队	Australia Under-17 National Football Team 
爱的宿命	Fate of love 
陈晓_(足球运动员)	Chen Xiao_(Football Player) 
日本u20国家女子足球队	Japan U20 National Women's Football Team 
皇家马德里c队	Real Madrid C team 
裴厚民	Pei Houmin 
美洲河狸	American beaver 
河北省人民政府	Hebei Provincial People's Government 
鲛岛员规	Staff Rules 
李秀文_(李宗仁元配)	Li Xiuwen_ (with Li Zongren Yuan) 
utc+01	utc+01 
中国人民解放军火箭军	Chinese People's Liberation Army Rocket Force 
正亲町天皇	Emperor Ogimachi 
澳大利亚副总理	Deputy Prime Minister of Australia 
三浦友和_(音乐人)	Miura Tomokazu_ (Musician) 
爱沙尼亚总理	Prime Minister of Estonia 
爱情公寓_(电视剧)	Love Apartment_(TV series) 
伊拉克总统	President of Iraq 
g3_(演唱会)	g3_(concert) 
美国外交关系委员会	U.S. Council on Foreign Relations 
465号州际公路	Interstate 465 
贤叔辑娱乐经纪	Xian Shu Ji Entertainment Broker 
君士坦丁十一世	Constantine XI 
贝蒂科山脉	Betico Mountains 
世界锡安组织	World Zion Organization 
tms娱乐	tms entertainment 
藤原妍子	Fujiwara Yoko 
第二代康诺及斯特拉森公爵阿莱斯泰尔·温莎	Aleister Windsor, Duke of Connaught and Strathson 
漫威动画	Marvel Animation 
欧洲冠军联赛冠军主教练列表	UEFA Champions League champion coach list 
阵风战斗机	Rafale 
卡尔加里国际机场	Calgary International Airport 
路易七世	Louis VII 
敦阿都拉曼阿巴斯	Tun Abdul Rahman Abbas 
美国东南部	Southeastern United States 
传奇星娱乐	Legend Star Entertainment 
中国科学院院士	Academician of Chinese Academy of Sciences 
塞尔维亚－克罗埃西亚语	Serbo-Croatian 
罗汉柏	Lohan Bo 
电子游戏制片人	Video game producer 
山本启人	Hiroto Yamamoto 
幸存者：全明星	Survivor: All Star 
大不列颠岛	Great Britain 
仁献章圣皇后	Ren Xianzhang Saint Queen 
保罗·弗里德里希_(梅克伦堡-什未林)	Paul Friedrich_ (Mecklenburg-Schwerin) 
奥古斯都陵墓	Mausoleum of Augustus 
锡永足球俱乐部	Sion Football Club 
比利时众议院	Belgian House of Representatives 
自贡话	Zigong dialect 
马里足球协会	Mali Football Association 
方言字	Dialect characters 
东北乐天金鹰	Tohoku Lotte Golden Eagle 
皇家比斯查安特卫普足球会	Royal Bisca Antwerp Football Club 
澳洲17岁以下国家足球队	Australia Under-17 National Football Team 
渡边具能	Watanabe Gunno 
战锤40000：破晓之战	Warhammer 40,000: The Battle of Dawn 
布斯汉姆学校	Bootham School 
威尔斯救护车服务	Wales Ambulance Service 
超级英雄军团	Superhero Legion 
数码间谍	Digital spy 
欢乐计划	Joy plan 
神雕侠侣角色列表	Condor Heroes Character List 
爱尔兰共和主义	Irish Republicanism 
和硕	Heshuo 
莫尔德球场	Molde Stadium 
中央广播电视塔	Central Radio and Television Tower 
软摇滚	Soft rock 
德国房车大师赛	German Touring Car Masters 
法国20岁以下国球足球队	France under-20 national football team 
乔里奥斯军官学校	Chorios Military Academy 
西南英格兰	South West England 
南部皇后足球会	South Queens Football Club 
华策影视	Huace Television 
罗得岛州	Rhode Island 
水星领航员	Mercury Navigator 
mozilla产品列表	mozilla product list 
英联邦大学协会	Association of Commonwealth Universities 
天平胜宝	Tianping Shengbao 
德国足球乙级联赛	German Football League 
布兰代斯大学	Brandeis University 
唐朝君主列表	List of Tang Dynasty Monarchs 
迈亚密国际机场	Miami International Airport 
张永正	Zhang Yongzheng 
竹内成和	Shigekazu Takeuchi 
中国共产党甘肃省委员会	Gansu Provincial Committee of the Communist Party of China 
印度标准时	Indian Standard Time 
林奈奖章	Linnaeus Medal 
大韩民国外交部	Ministry of Foreign Affairs of the Republic of Korea 
菰野菊	Wild Chrysanthemum 
永安市场站	Yongan Market Station 
墨尔本胜利	Melbourne victory 
三协里	Sankyoli 
槙村怜	Makimura Rei 
湖滨中学	Lakeside Middle School 
德意志国经济部长	Minister of Economy of the German State 
武内崇	Takashi Takeuchi 
东欧平原	Eastern European Plain 
河森正治	Shoji Kawamori 
球员票选奖	Player vote award 
查干拉木·杜格尔苏伦	Chaganram Dugarsurun 
蔡强荣	Cai Qiangrong 
长岛海峡	Long Island Strait 
内田直哉	Naoya Uchida 
贾汉吉尔·巴达尔	Jahangir Badar 
范长龙	Fan Changlong 
unkle	unkle 
波音公务机	Boeing Business Jet 
捷克摇滚	Czech Rock 
宁妃_(雍正帝)	Concubine Ning_(Yongzheng Emperor) 
巨轮ii	Great Wheel II 
路易斯大学	Louis University 
家在半山芭	Home in mid-levels 
核心帝汶语群	Core Timorese 
日内瓦高级国际关系及发展学院	Geneva School of Advanced International Relations and Development 
阿涅利家族	Agnelli family 
斯堪的那维亚语支	Scandinavian branch 
野州川	Noshugawa 
巴基斯坦穆斯林联盟（谢里夫派）	Pakistan Muslim League (Sharif) 
莱昂主教座堂	León Cathedral 
西班牙共产主义青年联盟	Spanish Communist Youth League 
斯米尔尼阿波罗足球俱乐部	Smirny Apollo Football Club 
统一民主党	United democratic party 
三立台湾台	Sanli Taiwan 
赵健成	Zhao Jiancheng 
加利福尼亚州立大学	California State University 
巴西联邦共和国	Federal Republic of Brazil 
鸭子类型	Duck type 
大田皇女	Princess Ota 
元和_(后水尾天皇)	Genna_ (Emperor Gomizuo) 
因弗内斯足球俱乐部	Inverness Football Club 
苍穹之战神	God of War 
汉传佛教	Chinese Buddhism 
武田良太	Ryota Takeda 
哈伦海布	Harlenheim 
高素历	Gao Suli 
忘情森巴舞	Forgetful Samba 
路易斯·奥尔良-布拉干萨(1878–1920)	Luis Orleans-Braganza (1878–1920) 
新李嘉图学派	Neo-Ricardo School 
尔朱兆	Erjuzhao 
新中刚史	Tsuyoshi Shinchu 
柏立基	Bai Liji 
保加利亚绿党	Bulgarian Green Party 
杨天经	Yang Tianjing 
苏联共产党中央组织局	Central Organization Bureau of the Communist Party of the Soviet Union 
巴巴多斯君主	Monarch of Barbados 
大陆会议	Continental Congress 
扎赫拉大学	Zahra University 
阿雷马足球俱乐部	Arema football club 
美国独立宣言	United States Declaration of Independence 
阿尔巴尼亚历史	History of Albania 
深圳体育场	Shenzhen Stadium 
一条朝子	A Zhaozi 
阿尔希拉尔足球俱乐部	Al Hilal Football Club 
波兰军队	Polish army 
大连金州体育场	Dalian Golden State Stadium 
恶魔的谜语	The riddle of the devil 
桥本晃一	Hashimoto Koichi 
s:国防法	s: National Defense Law 
starry☆sky	starry☆sky 
北约克郡	North Yorkshire 
肯尼亚山	Mount Kenya 
中国人民政治协商会议第一届全体会议	The First Plenary Session of the Chinese People's Political Consultative Conference 
相贺照乡	Aiga Zhaoxiang 
新普罗维登斯岛	New Providence Island 
西班牙银圆	Spanish silver round 
台湾铁路管理局车站等级	Taiwan Railway Administration Station Level 
阿拉巴马州美国众议院议员列表	List of members of the U.S. House of Representatives of Alabama 
软件更新器	Software updater 
电子角色扮演游戏	Electronic role-playing game 
中共中央组织部	Organization Department of the CPC Central Committee 
实验物理学	Experimental physics 
考彭斯战役	Battle of Cowpens 
三一学院	Trinity College 
苏州站	Suzhou Railway Station 
皇家警察	Royal police 
功绩勋章	Medal of Merit 
察觉时已是单恋	It was unrequited love when I noticed it 
卢布林联合	Lublin Union 
亚洲和太平洋地区世界遗产列表	List of World Heritage Sites in Asia and the Pacific 
小米手机3	Mi mobile phone 3 
台北市立松山高级商业家事职业学校	Taipei Songshan Advanced Commercial and Family Care Vocational School 
卡诺路球场	Cano Road Stadium 
萨克森-科堡-萨尔费尔德	Saxony-Coburg-Saalfeld 
王顺妃_(明思宗)	Concubine Wang Shun_(Ming Sizong) 
肯塔基州第四国会选区	Fourth Congressional District of Kentucky 
光崎伸	Mitsusaki Shin 
埃格伯特_(威塞克斯)	Egbert_ (Wessex) 
洛迪马克	Lodimark 
黎瑞刚	Li Ruigang 
纳尔逊省	Nelson province 
黑塔vii：黑暗之塔	Dark Tower vii: The Tower of Darkness 
总统国家安全事务助理	Assistant to the president for national security affairs 
刚果解放民主力量同盟	League of Democratic Forces of the Liberation of Congo 
朝鲜国家青年足球队	North Korea National Youth Football Team 
广濑周	Hirose Week 
内田恭兵	Kyohei Uchida 
coponius	Coponius 
固伦温宪公主	Princess Gulun Wenxian 
仁川南洞亚运会橄榄球场	Incheon Namdong Asian Games Rugby Stadium 
十一月十三	November 13 
约瑟芬·德博阿尔内	Josephine De Boarnet 
巴列奥略王朝	Valleio 
心的东方	Heart of the East 
游说集团	Lobby group 
李影_(女子足球运动员)	Li Ying_(female football player) 
直辖殖民地	Direct colony 
醋娘子	Vinegar Lady 
曾志伟_(足球运动员)	Zeng Zhiwei_ (Football Player) 
台北市私立复兴小学	Taipei Private Fuxing Primary School 
马里-皮埃尔·柯尼希	Marie-Pierre Koenig 
台湾语假名	Taiwanese Kana 
台北市私立东方高级工商职业学校	Taipei City Private Oriental Advanced Business Vocational School 
黄金海岸市政府	Gold Coast City Council 
俄罗斯联邦委员会	Russian Federation Council 
胡衡华	Hu Henghua 
台湾蓝鹊	Taiwan Blue Magpie 
吴东勋	Wu Dongxun 
芭芭拉·皮尤特施密特	Barbara Pietschmidt 
英格兰及不列颠王位继承人列表	List of heirs to the throne of England and Britain 
乙女百合	Maiden lily 
国家信访局	National Bureau of Letters and Calls 
醒狮勋刀	Lion Dancer 
久米南町	Kumenan Town 
蒋建国	Jiang Jianguo 
杜塞道夫足球俱乐部	Dusseldorf Football Club 
心肌梗死	Myocardial infarction 
astro双星	astro double star 
梁志贤	Liang Zhixian 
肃明皇后	Queen Su Ming 
瓜分波兰	Partition of Poland 
西方哲学史	F 
多用途战机	Multipurpose fighter 
向前走向爱走	Walk forward 
诺曼第的爱玛	Emma of Normandy 
教政体制	Church system 
阿布扎比大奖赛	Abu Dhabi Grand Prix 
藤原能信	Fujiwara Noshin 
苏联文化部部长	Minister of Culture of the Soviet Union 
塞萨尔巴列霍大学竞技俱乐部	Cesar Vallejo University Athletic Club 
特兰西瓦尼亚总督	Governor of Transylvania 
阿尔及利亚足球协会	Algeria Football Association 
file:emperor_guangxu.jpg	file:emperor_光绪.jpg 
金炫成	Jin Xuancheng 
做自己	be yourself 
乔治亚大学	University of Georgia 
科斯定理	Coase Theorem 
天津市南开中学	Tianjin Nankai Middle School 
韩民求	Han Minqiu 
圣克拉拉大学	Santa Clara University 
舞蹈流行	Dance pop 
第几次的蓝天？	How many times is the blue sky? 
勃艮第的安斯加尔德	Ansgard of Burgundy 
欧洲足协杯	UEFA Cup 
第二届阿米尔·谢里夫丁内阁	The Second Cabinet of Amir Sharifuddin 
福元美穗	Fukumoto Miho 
朝鲜半岛军衔比较	Comparison of military ranks on the Korean Peninsula 
美国联邦军事院校	U.S. Federal Military Academy 
攻壳机动队_(美国电影)	Ghost in the Shell_ (American Movie) 
切尔诺莫雷足球俱乐部	Chernomore Football Club 
伦敦市议会	London City Council 
加速规	Accelerometer 
詹姆斯敦_(圣赫勒拿)	Jamestown_ (St. Helena) 
廖安丽	Liao Anli 
南洋理工大学	Nanyang Technological University 
朴哲民_(足球运动员)	Park Cheolmin_ (Football Player) 
中川秀直	Hidenao Nakagawa 
米尔顿凯恩斯西南_(英国国会选区)	Milton Keynes Southwest_(British Parliamentary District) 
肯塔基河	Kentucky river 
弗雷德里克·弗朗索瓦-马绍尔	Frederic Francois-Marshall 
爱尔兰根纲领	Irish Root Program 
中-东马来-波利尼西亚语支	Central-East Malay-Polynesian 
纽约宇宙	New York Universe 
新威斯敏斯特	New Westminster 
土耳其超级杯	Turkish Super Cup 
撒哈拉语族	Saharan 
gangbuster	Just buster 
达马苏斯二世	Damasus II 
潘凯恩	Pan Kane 
高进永	Takashinaga 
我的野蛮妈咪	My savage mom 
平面网格阵列封装	Planar Grid Array Package 
乌克兰摇滚	Ukrainian Rock 
相爱又如何	How about love 
贡萨格大学	Gonzaga University 
坎培拉体育场	Canberra Stadium 
吴登盛	Wu Thein Sheng 
高级着色器语言	High-level shader language 
印度尼西亚总统	President of Indonesia 
类刚果南方语支	Southern Congolese 
梁启超墓	Tomb of Liang Qichao 
mp魔幻力量	mp magic power 
肯塔基州第8国会选区	Kentucky's 8th Congressional District 
曹国公主	Princess Cao 
钢弦吉他	Steel string guitar 
空间摇滚	Space rock 
特薛禅	Te Xuechan 
戴美玉	Dai Meiyu 
淳皇后	Queen Jun 
柳俊秀	Liu Junxiu 
祐子内亲王	Yuko Naishinnō 
黄金唱片	Golden record 
尼克希奇足球俱乐部	Niksic Football Club 
斯巴达体育场_(吉尔吉斯)	Spartan Stadium_ (Kyrgyzstan) 
阿尔及利亚共和国临时政府	Provisional Government of the Republic of Algeria 
雏鸟乐队	Chicks 
李亨根	Li Henggen 
常陆宫	Hitachi Palace 
情人眼里高一d	One d high in the eyes of the lover 
黎维祎	Li Weiyi 
两圣地监护人	Guardian of the Two Holy Lands 
标致308	Peugeot 308 
荷兰中央银行	Dutch Central Bank 
精选辑	Featured 
循化撒拉族自治县	Xunhua Salar Autonomous County 
渠成_(足球运动员)	Qu Cheng_ (football player) 
西方哲学家	Western philosopher 
志免町	Shime Town 
折户伸治	Shinji Orito 
文山壮族苗族自治州	Wenshan Zhuang and Miao Autonomous Prefecture 
拿骚王朝	Nassau Dynasty 
台闽汉字	Taiwan and Fujian characters 
乌汶叻公主	Ubon Ratchathani Princess 
莉姆·阿里王妃	Princess Lim Ali 
小松宫彰仁亲王	Prince Akihito Komatsu 
余嘉慧	Yu Jiahui 
赫罗尔斯城堡球场	Herrols Castle Stadium 
巴斯特尔_(圣基茨和尼维斯)	Basseterre (Saint Kitts and Nevis) 
乌克兰东正教	Ukrainian Orthodox Church 
美国民主党副总统候选人	Democratic vice presidential candidate 
松原后	After Matsubara 
新加坡教育部	Singapore Ministry of Education 
阿尔泰共和国国旗	Flag of the Altai Republic 
美国的女子学院	American Women's College 
台风桑达_(2011年)	Typhoon Sundar_ (2011) 
s:国防部组织法	s: Organic Law of the Ministry of Defense 
通用电气公司t700	General Electric Company t700 
山野边义正	Yamanobe Yoshimasa 
武辉全	Wu Huiquan 
锂离子聚合物电池	Lithium ion polymer battery 
黄万伯	Huang Wanbo 
捷克足球协会	Czech Football Association 
犀利人妻	Fierce wife 
河北各地级市地区生产总值列表	List of regional GDP of each city in Hebei 
继业者	Successor 
芬兰大公	Grand Duke of Finland 
美国劳工部	U.S. Department of Labor 
贞元_(圆融天皇)	Sadamoto _ (Emperor Yuanrong) 
罗贝托大公_(奥地利-埃斯特)	Grand Duke Roberto_ (Austria-Este) 
竹中工务店	Takenaka Engineering Store 
藤原冰上娘	Fujiwara Ice Lady 
冨山达行	Laoshan Daxing 
八代六郎	Yashiro Rokuro 
凡尔赛条约	Treaty of Versailles 
章柏翰	Zhang Bohan 
瑟德港足球俱乐部	Soderport Football Club 
坦布里奇韦尔斯_(英国国会选区)	Tunbridge Wells_ (British Parliamentary District) 
缅甸行政区划	Administrative divisions of Myanmar 
多功能休旅车	Multifunctional RV 
格林县_(密苏里州)	Green County_(Missouri) 
盎格鲁-撒克逊人	Anglo-Saxon 
.jm	.jm 
中华人民共和国司法行政机关	Judicial Administration of the People's Republic of China 
美国邮区编码	U.S. ZIP Code 
紫草	Comfrey 
伏瓦德斯瓦夫·拉奇凯维奇	Vladslaw Rackiewicz 
萨瓦德尔足球俱乐部	Sabadell Football Club 
横山知伸	Yokoyama Chinobu 
五世王勋章	Order of King V 
达尔豪西大学	Dalhousie University 
周铁根	Zhou Tiegen 
中央美拉尼西亚	Central Melanesia 
川村荣二	Kawamura Eiji 
玛莉外宿中	Mary is staying out 
发展心理学	Developmental psychology 
美国海军部	U.S. Department of the Navy 
梁嘉琪	Liang Jiaqi 
亚历山大·戈尔·霍尔-鲁思文，第一代高里男爵	Alexander Gore Hall-Ruthven, the first Baron Gaurie 
亚历山大·赖德律-洛兰	Alexander Ryder-Lorland 
巴巴朗斯联合	Barbarance United 
二宫体育中心	Ninomiya Sports Center 
森本章之	Akiyuki Morimoto 
游戏机历史_(第五世代)	Game console history_ (fifth generation) 
浪速语	Naniwa 
中国国际电视总公司	China International Television Corporation 
和谐号crh380c型电力动车组	Harmony crh380c electric train set 
柏林围墙	Berlin Wall 
三间雅文	Sanjian Yawen 
尼日利亚众议院	Nigerian House of Representatives 
为随里	Wei Sui Li 
新加坡日占时期	Singapore's Japanese Occupation Period 
李英宗	Li Yingzong 
英国自由党	British Liberal Party 
后圆融天皇	Emperor Yuanrong 
格林斯比镇足球俱乐部	Greensby Town Football Club 
英格兰历史上的郡	County in England History 
国际扎普雷希奇足球俱乐部	International Zapresic Football Club 
ダニルソン	Danilson 
卡尔顿·梅利克三世	Carlton Melik III 
美国参议院军事委员会	U.S. Senate Armed Services Committee 
仙境影视公司	Wonderland Film and Television Company 
爱的再告白	Love again 
富士五湖	Fuji Five Lakes 
穆为民	Mu Weimin 
明尼苏达大学系统	University of Minnesota System 
西北伊朗语支	Northwestern Iranian 
南日德兰郡	South Jutland 
纽黑文机场	New Haven Airport 
第七代哈伍德伯爵乔治·拉塞尔斯	George Russels, 7th Earl of Harwood 
莱娜·耶尔姆-瓦伦	Lena Jerm-Valen 
武大伟	Wu Dawei 
纽芬兰岛	Newfoundland 
胡亚东	Hu Yadong 
fushë-bardhë	Field-White 
爱尔兰自由邦君主	Monarch of the Free State of Ireland 
冰岛商业高等专科学校	Iceland Business College 
阿富汗独立日	Afghanistan Independence Day 
石井康晴	Yasuharu Ishii 
平木一树	Hiraki Kazuki 
伊拉克国王	King of Iraq 
福冈机场	Fukuoka Airport 
吉马良斯维多利亚	Guimaraes Victoria 
大鳄町	Owani Town 
路德维格·霍尔斯泰因-莱德伯格	Ludwig Holstein-Leidberg 
.bz	.bz 
轻柔摇滚乐	Soft rock 
林肯镇区_(塞奇威克县)	Lincoln Township_ (Sedgwick County) 
孟加拉空军	Bangladesh Air Force 
以弗所	Ephesus 
克雷格_(科罗拉多州)	Craig_ (Colorado) 
安山木槿花足球俱乐部	Ansan Mugunghwa Football Club 
冈山路竹延伸线	Okayama Road Bamboo Extension Line 
维托里奥·阿梅迪奥三世	Vittorio Amedio III 
俄罗斯政府首脑列表	List of heads of government of Russia 
明道加斯·米凯拉	Mindaugas Michaela 
天普大学	Temple University 
李健恒	Li Jianheng 
夏洛特郡主_(瓦伦丁女公爵)	County Lord Charlotte_ (Duke of Valentin) 
非洲蓝调	African Blues 
第一届全国人民代表大会常务委员会	Standing Committee of the First National People's Congress 
大众高尔夫	Volkswagen Golf 
当代基督教音乐	Contemporary christian music 
段君毅	Duan Junyi 
悯郡王	King Min 
伊拉斯谟计划	Erasmus Project 
阿拉伯语变体	Arabic variants 
易卜拉欣·贾法里	Ibrahim Jafari 
台湾桃园国际机场	Taiwan Taoyuan International Airport 
美国东北部	Northeastern United States 
h&r	h&r 
原来爱·就是甜蜜	So love is sweet 
足利义持	Ashikaga Yoshimochi 
德国公共广播联盟	German Public Broadcasting Union 
纽马克特_(昆士兰州)	Newmarket_ (Queensland) 
泡桐属	Paulownia 
和硕和婉公主	Princess Heshuo and Wan 
亚洲田径锦标赛	Asian Athletics Championships 
国立武昌商科大学	National Wuchang University of Commerce 
庞士榤	Pang Shilu 
阿尔巴尼亚君主列表	List of monarchs of Albania 
陈慧瑛	Chen Huiying 
松波春子	Haruko Matsunami 
伊朗专家会议	Iranian Expert Meeting 
.fo	.fo 
马泰乌奇奖章	Mateuch Medal 
埃克哈特大师	Master Eckhart 
陈水扁政府	Chen Shuibian Government 
加速世界	Speed up the world 
利雅得艾沙比足球会	Riyadh Al Shabi Football Club 
后现代主义	Postmodernism 
2004年夏季奥林匹克运动会	2004 Summer Olympic Games 
亨德森_(肯塔基州)	Henderson_ (Kentucky) 
马丁公司	Martin Corporation 
伊拿克里斯足球会	Enakris Football Club 
东平里_(旗山区)	Dongpingli_(Qishan District) 
高敬命	High respect 
圣马力诺足球总会	San Marino Football Association 
揖斐川町	Ibigawa Town 
权良淑	Quan Liang Sook 
京成电铁	Keisei Electric Railway 
拉丁摇滚	Latin Rock 
用户界面	User Interface 
鹰司景子	Keiko Takatsukasa 
西村了	West Village 
kağan_söylemezgiller	kagan_söylemezgiller 
台北市役所	Taipei City Office 
德川色许姬	Tokugawa Sekiji 
金平一	Kim Pyong Il 
丁懋时	Ding Maoshi 
赵澯镐	Zhao Luohao 
元成宗	Yuan Chengzong 
伊丽莎白镇_(肯塔基州)	Elizabethtown_(Kentucky) 
列克提克亚语支	Lektician 
分时长期演进	Time-sharing long-term evolution 
三立戏剧台	Sanli Theatre 
中华台北足球代表队	Chinese Taipei National Football Team 
康拉德_(萨克森-迈宁根)	Conrad_(Saxony-Meiningen) 
吉塞拉_(路易二世之女)	Gisela_ (daughter of Louis II) 
阿拿翁薛胡	Anaoong Xuehu 
桑特堡战役	Battle of Fort Sant 
巴基斯坦制宪议会	Pakistan Constituent Assembly 
乔治·莱诺克斯勋爵	Lord George Lenox 
拜欧拉大学	Biola University 
非都市区	Non-urban area 
北安普顿县_(宾夕法尼亚州)	Northampton County_(Pennsylvania) 
斯洛伐克国民议会	National Assembly of Slovakia 
冯家瑞	Feng Jiarui 
突尼斯君主列表	List of Tunisian monarchs 
福岛瑞穗	Fukushima Mizuho 
印度统计研究所	Indian Institute of Statistics 
计算机工程	computer engineering 
闵先艺	Min Xianyi 
立体化学	Stereochemistry 
日本国宪法	Constitution of Japan 
php许可证	php license 
敬宫爱子内亲王	Prince 
大江皇女	Princess Oe 
国家主席	State president 
ios设备列表	ios device list 
于伟国	Yu Weiguo 
德川御三家	Tokugawa Misami 
义大利总理	Prime Minister of Italy 
昭慈皇后_(陈英宗)	Empress Zhaoci_ (Chen Yingzong) 
陈魏莲芷	Chen Weilianzhi 
香港特别行政区行政会议	Hong Kong Special Administrative Region Executive Council 
柔网势	Soft netting 
主播台女王	Anchor queen 
他宁·盖威迁	Tanin Gawiqian 
贝尔214	Bell 214 
国务院信息化工作办公室	State Council Information Office 
弗雷迪·默丘里	Freddie Mercury 
广州铁路（集团）公司	Guangzhou Railway (Group) Company 
以色列军事工业	Israeli military industry 
陈戎晖	Chen Ronghui 
俄亥俄州大学系统	Ohio University System 
拉脱维亚道路党	Latvian Road Party 
渡部大辅	Dai Watanabe 
2011–12年欧霸杯	2011-12 Europa Cup 
叶广荫	Ye Guangyin 
山本一太	Ichita Yamamoto 
汪啸风	Wang Xiaofeng 
考潭里	Khao Tan Li 
香港十元硬币	Hong Kong ten dollar coin 
逃亡者plan.b	Fugitive plan.b 
王城区集团	Intramuros Group 
哈萨克斯坦总理	Prime Minister of Kazakhstan 
高加索酋长国	Emirate of Caucasus 
恋爱喜剧	Love comedy 
不自然女孩/自然爱	Unnatural girl/natural love 
新特兰南_(英国国会选区)	New Trannan_(British Parliamentary District) 
德川昭武	Tokugawa Akitake 
zonnon	sun 
皇家达马迪球场	Royal Damadi Stadium 
莱茵兰-普法尔茨	Rhineland-Palatinate 
海南博盈海汉	Hainan Boying Haihan 
爱的初告白	First confession of love 
微软公司	Microsoft Corporation 
爱德华·奥索布卡-莫拉夫斯基	Edward Osobka-Moravsky 
菲利普·威廉_(奥兰治亲王)	Philip William_ (Prince of Orange) 
南非总督列表	List of Governors of South Africa 
破案天才奇娜	Genius Kina 
光中通宝	Guangzhongtongbao 
恩贝拉-沃内安特区	Embela-Voneant 
路易斯安那州众议院	Louisiana House of Representatives 
中部日光节约时间	Central Daylight Saving Time 
英格兰联赛锦标	English League Championship 
陈繁昌	Chen Fanchang 
李谌	Li Chen 
刘芷绚	Liu Zhixuan 
奥多尼奥四世_(莱昂)	Odono IV_ (Leon) 
gentbrugge	gentbrugge 
wikt:安徽	wikt: Anhui 
苏州大学	Suzhou University 
威廉姆斯镇_(马萨诸塞州)	Williamstown_(Massachusetts) 
新康德主义	Neo-Kantianism 
谢赫扎耶德大清真寺	Sheikh Zayed Grand Mosque 
小前锋	Small forward 
阮增龙	Ruan Zenglong 
四格漫画	Four-frame comics 
莱索托国王	King of Lesotho 
月球背面	Far side of the moon 
伊利诺伊州各县列表	List of counties in Illinois 
廖斐鸿	Liao Feihong 
郝治平	Hao Zhiping 
义都－达让语支	Yidu-Darrang 
坎伯兰公爵	Duke of Cumberland 
安茹公爵	Duke of Anjou 
立窝尼亚海岸	Livorno Coast 
超级碗后续节目列表	List of Super Bowl follow-up shows 
长滨博行	Hiroyuki Nagahama 
新河谷省	New River Valley 
梅津秀行	Hideyuki Umezu 
墨西哥20岁以下国家足球队	Mexico Under-20 National Football Team 
福岛县旗	Flag of Fukushima Prefecture 
仙台市交通局	Sendai City Transportation Bureau 
刘嘉和	Liu Jiahe 
柔佛dt足球俱乐部	Johor dt football club 
印度副总统	Vice President of India 
印度政府	Indian government 
红米手机	Redmi 
丰岛冈墓地	Toshimaoka Cemetery 
视觉化程式设计语言	Visual programming language 
沈阳城市建设学院	Shenyang Urban Construction College 
意大利自由党	Liberal Party of Italy 
三一华盛顿大学	Trinity Washington University 
美国男子学院	American Men's College 
松田秀知	Hidetomo Matsuda 
塞尔维亚足球超级联赛	Serbian Premier League 
加利福尼亚州第六国会选区	California Sixth Congressional District 
超害羞＆前卫	Super shy & avant-garde 
苏黎世条约	Zurich Treaty 
荷兰主教会议	Dutch Synod 
黄文永	Huang Wenyong 
火星之音	Voice of Mars 
神舟一号	Shenzhou One 
国立台北科技大学	National Taipei University of Technology 
科学超电磁炮	Scientific Railgun 
第十州	Tenth state 
都厅前站	Dutingqian Station 
王化成	Wang Huacheng 
神雕侠侣_(2014年电视剧)	Condor Heroes_(2014 TV series) 
橘嘉智子	Tachibana Katoko 
mi-8直升机	mi-8 helicopter 
蔡国威(足球运动员)	Cai Guowei (football player) 
阿空加瓜山	Aconcagua, sa. de 
贵阳龙洞堡国际机场	Guiyang Longdongbao International Airport 
徐柏园	Xu Baiyuan 
欧洲理事会	Council of Europe 
林政则	Lin Zhengze 
危机边缘_(第一季)	Edge of Crisis_ (Season One) 
民主行动党妇女组	Democratic Action Party Women's Group 
李盛霖	Li Shenglin 
中华人民共和国国务院机构编制	Establishment of the State Council of the People's Republic of China 
哥伦比亚自由党	Colombian Liberal Party 
哥德次文化	Gothic subculture 
济众院_(电视剧)	House of Representatives_(TV series) 
玻恩定则	Born rule 
张彭春	Zhang Pengchun 
尼顿·费拉拿	Niton Ferrana 
极速快感：无限	Speed Pleasure: Infinite 
使徒圣胡安与传播者教堂，普拉维亚的圣提安内斯	Church of San Juan and the Evangelist of the Apostles, San Tiennes of Pravia 
法罗群岛执法官与总理列表	List of Faroe Islands Marshals and Prime Ministers 
韩国小姐_(电视剧)	Miss Korea_(TV series) 
徐誉庭	Xu Yuting 
afsnee	afsnee 
埃塞尔博尔德_(威塞克斯)	Ethelbold_ (Wessex) 
韦佛利议会	Waverly Council 
石毛秀树	Shimao Hideki 
世界大学运动会	World University Games 
薛西斯二世	Xerxes II 
让-路易·科斯居尔	Jean-Louis Cosgul 
帕萨迪纳市立学院	Pasadena City College 
谢世杰	Xie Shijie 
唐德宗	Tang Dezong 
科摩罗法郎	Comorian Franc 
阿齐语-占语群	Azi-Cham Group 
乌龙派出所	Oolong Police Station 
白川由美	Yumi Shirakawa 
木下高彰	Takaaki Kinoshita 
汤浅笃	Yuasa Atsushi 
悬疑小说	Suspense novel 
赛博人的崛起	The rise of the cyberman 
活出坚强	Live strong 
恶汉小说	Evil man novel 
美国非建制属地	U.S. non-establishment territories 
奥地利超级杯	Austrian Super Cup 
教宗哈德良一世	Pope Hadrian I 
埃斯特加拉勒足球俱乐部	Este Gallal Football Club 
阿德莱德机场	Adelaide Airport 
第十七王朝	Seventeenth Dynasty 
张保仔_(2015年电视剧)	Zhang Baozi_ (2015 TV series) 
棉兰老岛	Mindanao 
武宁_(琉球国王)	Wuning_(King of Ryukyu) 
路德维希一世_(黑森大公)	Ludwig I_ (Grand Duke of Hessen) 
阿根廷迪罗联邦竞技俱乐部	Argentina Diro Federation Athletic Club 
张连珍	Zhang Lianzhen 
向河原站	To Kawara Station 
中央社会主义学院	Central Institute of Socialism 
联合国大会	United Nations General Assembly 
杜文翔	Du Wenxiang 
王天琦	Wang Tianqi 
约西亚斯·菲利普·霍夫曼	Josias Philip Hoffman 
鲁伊佛科修道院	Ruifok Monastery 
穆特萨二世	Mutesa II 
法国内政部	French Ministry of the Interior 
.ac	.ac 
东南亚足球协会	Southeast Asian Football Association 
布里亚特共和国国歌	National Anthem of the Republic of Buryatia 
以色列托托杯	Israel Toto Cup 
法兰克-赫兹实验	Frank-Hertz experiment 
中华人民共和国国防科学技术工业委员会	National Defense Science, Technology and Industry Commission of the People's Republic of China 
名誉勋位	Honorary Order 
技术金属	Technical metal 
安道尔大公	Grand Duke of Andorra 
嫁给百万富翁	Marry a millionaire 
苗瑶语系	Miao-Yao language family 
匈牙利国王	King of Hungary 
科英布拉球场	Coimbra Stadium 
卡塔尔亲王杯	Prince of Qatar Cup 
朝鲜字	Korean characters 
创价学会	Soka Gakkai 
标致汽车	Peugeot 
节奏口技	Rhythmic ventriloquist 
上海嘉定体育场	Shanghai Jiading Stadium 
穆萨阿里山	Moussa Ali 
日进站_(埼玉县)	Nissin Station_ (Saitama Prefecture) 
夏目公一朗	Koichiro Natsume 
曼尼托巴大学	University of Manitoba 
hh-60松鸭鹰	hh-60 loose duck eagle 
富智康集团	Fortune Group 
瑞典皇家科学院	Royal Swedish Academy of Sciences 
国有独资公司	Wholly state-owned company 
比佛利拜金女	Beverly Gold Worship 
埃瓦尔体育协会	Ebar Sports Association 
芝加哥罗耀拉大学	Loyola University of Chicago 
华夏航空	China Airlines 
乌尔巴诺·卡尔戴拉球场	Urbano Caldera Stadium 
阿苏-埃科托	Aso-Ekoto 
陈昭安	Chen Zhaoan 
圣米迦勒学院	St. Michael's College 
东京dogs	Tokyo dogs 
罗伦斯威尔中学	Lawrenceville Middle School 
碳纳米管	Carbon nanotube 
周永晖	Zhou Yonghui 
嘻哈灵魂	Hip hop soul 
美国第五集团军	U.S. Fifth Army 
陆军总司令部_(德国国防军)	Army Headquarters_ (German Wehrmacht) 
黄真	Huang Zhen 
新达里	Shintari 
坎伯兰大学	Cumberland University 
空中战争	Air war 
csi犯罪现场：迈阿密	csi crime scene: Miami 
卡美哈梅哈家族	Kamehameha 
维马高	Vimarco 
江苏省第六次人口普查结果概况	Overview of the Results of the Sixth Census of Jiangsu Province 
莫斯科州州长	Governor of Moscow Region 
英美法系	Common Law 
火龙球场	Fire Dragon Stadium 
丰田公园	Toyota Park 
中国人民解放军总政治部歌舞团	Song and Dance Ensemble of the General Political Department of the Chinese People's Liberation Army 
大连顺发足球俱乐部	Dalian Shunfa Football Club 
荷属安的列斯盾	Netherlands Antilles Shield 
珀斯足球俱乐部	Perth Football Club 
维克托·霍普，第二代林利思戈侯爵	Victor Hope, the second Marquis of Linlithgow 
凯恩斯区政府	Cairns District Government 
镰仓时代	Kamakura period 
菊地光将	Kosuke Kikuchi 
权真秀	Quan Zhenxiu 
广播电台	radio station 
华视教育文化台	Huashi Education and Culture Channel 
第三届工作内阁	The third working cabinet 
义大利18岁以下国家足球队	Italy Under-18 National Football Team 
康斯坦丝_(诺曼底)	Constance_ (Normandy) 
大陆哲学	Continental philosophy 
重庆交通规划勘测设计院	Chongqing Transportation Planning Survey and Design Institute 
新党友爱	New party friendship 
阿尔华达足球俱乐部	Al Wahda Football Club 
排湾语群	Paiwan Group 
塞纳塞纳河畔	Seine-sur-Seine 
皮尔_(南达科他州)	Peel_ (South Dakota) 
诺门罕战役	Battle of Normanham 
南奥塞提亚独立日	South Ossetia Independence Day 
独立者与农民国家中间党	Independents and Peasants National Center Party 
定点清除	Spot clearing 
马德里体育会b队	Madrid Athletic Club b team 
utc-9	utc-9 
aim-120先进中程空对空飞弹	aim-120 advanced medium-range air-to-air missile 
顺苓里	Shunlingli 
lisca	leaves 
吴福源	Wu Fuyuan 
克罗地亚独立日	Croatia Independence Day 
前399年	399 years ago 
守礼门	Shurei Gate 
奥斯卡最佳原创剧本奖	Oscar for Best Original Screenplay 
费欧图	Feutu 
伦敦街道	London street 
埃里克十二世	Eric XII 
武装炼金	Armed Alchemy 
中川雅治	Masaharu Nakagawa 
摩尔多瓦行政区划	Administrative divisions of Moldova 
第一代约克公爵什鲁斯伯里的理查	Richard of Shrewsbury, 1st Duke of York 
按人口排列的英格兰地区	England by population 
第四代亨廷顿及北安普顿伯爵圣利兹的西蒙二世	Simon II of St. Leeds, 4th Earl of Huntington and Northampton 
并行计算	Parallel Computing 
爆漫王。	Bakuman. 
爱因斯坦-希尔伯特作用量	Einstein-Hilbert action 
荷兰教育、文化及科学部	Ministry of Education, Culture and Science 
blender基金会	blender foundation 
自由邦球场	Free State Stadium 
英格兰的单一管理区	Single management area in England 
阿卜杜拉国王体育城体育场	King Abdullah Sports City Stadium 
德国马克	Deutsche Mark 
大十字阿道夫拿骚勋章	Grand Cross Adolphe Nassau 
杰瑞·迈特帕里	Jerry Metppali 
哥伦比亚足球协会	Colombian Football Association 
葛量洪教育学院	Grantham College of Education 
阿帕契ah_mk1直升机	Apache ah_mk1 helicopter 
北京市八宝山革命公墓	Beijing Babaoshan Revolutionary Cemetery 
清水圭介	Keisuke Shimizu 
赤羽一嘉	Kazuyoshi Akaba 
土屋举直	Tsuchiya Juzhi 
巴尔干半岛	Balkans 
刘碧丽	Liu Bili 
天合联盟	SkyTeam 
小叶杜鹃	Rhododendron 
唐宫美人天下	Tang Palace Beauty World 
内穆尔公爵	Duke of Nemours 
菩提树下大街	Avenue under the Linden Tree 
阿比让非洲体育会	Abidjan African Sports Association 
增田有华	Masuda Yuka 
罗伯特·纳皮尔，第一代抹大拉的纳皮尔男爵	Robert Napier, the first Baron Napier of Magdalene 
海田町	Kaita Town 
奈须蘑菇	Nasu Mushroom 
匈牙利国家银行	National Bank of Hungary 
申成在	Shen Chengzai 
简化汉字	Simplify Chinese characters 
宝贝对不起	Baby I'm sorry 
海洋男孩足球俱乐部	Ocean Boys Football Club 
罗马尼亚国王	King of Romania 
笑笑大搞作	Make a big laugh 
秦祥林	Qin Xianglin 
韩国sm娱乐有限公司	Korea sm Entertainment Co., Ltd. 
翁索内戈罗	Onsonegoro 
袁宝慧	Yuan Baohui 
新步步惊心	New step by step startling 
山姆·桑兹，第一代桑兹男爵	Sam Sands, the first Baron Sands 
张越_(女子足球运动员)	Zhang Yue_ (female football player) 
亚美尼亚使徒教会	Armenian Apostolic Church 
影音俱乐部	Video club 
奥尔巴尼公爵	Duke of Albany 
史笃城足球俱乐部	Stoke City Football Club 
陈宪宗	Chen Xianzong 
端悯固伦公主	Pity princess gurun 
联合国总部	United Nations Headquarters 
尚源道	Shang Yuan Dao 
叡山菫	Eiyama Kaoru 
海口美兰国际机场	Haikou Meilan International Airport 
爱尔兰标准时间	Irish Standard Time 
王政义	Wang Zhengyi 
巫山长江大桥	Wushan Yangtze River Bridge 
打狗棒法	Beating 
存在主义	Existentialism 
第六凯旋军团	Sixth Triumph Army 
ubuntu软体中心	ubuntu software center 
华沙大学	University of Warsaw 
西乍得语支	West Chadian 
大畠章宏	Akihiro Ohata 
劳斯莱斯股份有限公司	Rolls royce co., ltd. 
古越语	Ancient Vietnamese 
天主教大叻教区	Catholic Diocese of Dalat 
查尔斯·格雷，第二代格雷伯爵	Charles Gray, the second Earl of Gray 
寰亚唱片	Media Asia Records 
重庆电视台	Chongqing Television 
印尼足球协会	Indonesian Football Association 
半音节文字	Semisyllable text 
美咲町	Misaki Town 
苏梅克－列维9号彗星	Comet Shoemaker-Levy 9 
第二版土耳其里拉	Second Edition Turkish Lira 
奥格斯希姆足球俱乐部	Augssim Football Club 
窃听风云	Overheard 
耶侯达	Yehouda 
奥斯纳布吕克大学	University of Osnabrück 
伊朗科学研究与技术部	Iranian Ministry of Scientific Research and Technology 
jp:御匣殿	jp: Imperial Box Hall 
东京急行电铁	Tokyo Kyuko Electric Railway 
saraorci	saraorci 
磐隈皇女	Princess Iwakuma 
古希美·芬拿	Guthime Finner 
宫泽洋一	Yoichi Miyazawa 
美国海军研究实验室	U.S. Naval Research Laboratory 
菲律宾中央银行	Central Bank of the Philippines 
民主国家救国阵线	National Salvation Front for Democracies 
香港华纳唱片	Warner Music Hong Kong 
查干·奥云达里	Chagan Owendari 
死亡旋律金属	Death melody metal 
教育及技能大臣	Minister of Education and Skills 
.de	.of 
伊拉克共和国电话区号	Republic of Iraq Telephone Code 
ビクターエンタテインメント株式会社	Victor Entertainment Co., Ltd. 
古典女子蓝调	Classical Women's Blues 
岛本町	Shimamoto Town 
1_e+9_m³	1_e + 9_m³ 
英格兰联邦	Commonwealth of England 
长荣航太科技	Evergreen Aerospace Technology 
丹麦摇滚	Danish Rock 
拉蒙·桑切斯·皮斯胡安球场	Ramon Sanchez Pizjuan Stadium 
比鲁尼	Biruni 
小额贷款	Small loan 
保加利亚保守党	Bulgarian Conservative Party 
获得性遗传	Acquired inheritance 
南京圣母无染原罪主教座堂	Nanjing Cathedral of the Immaculate Conception 
守贞亲王	Prince Shouzhen 
真心请按两次铃	Please ring the bell twice 
大北方战争	Great Northern War 
莱切足球俱乐部	Lecce Football Club 
西法兰克王国	West Franck Kingdom 
袁剑伟	Yuan Jianwei 
约旦王储	Crown Prince of Jordan 
宏池会_(谷垣派)	Hongchihui_(Tanigaki School) 
智利新国	New country of chile 
巴勒斯坦民族权力机构主席	President of the Palestinian National Authority 
胭脂水粉	Rouge gouache 
泰国王冠勋章	Thai Crown Medal 
北岭里	Beilingli 
阿梅德奥王子_(比利时)	Prince Amedeo_ (Belgium) 
2006年秘鲁大选	Peru election in 2006 
.im	.in the 
和硕悫靖公主	Princess Heshuo Chijing 
鸣海丈	Narumi Takeshi 
平壤战役_(1950年)	Battle of Pyongyang_ (1950) 
阿方索_(巴西帝国王子)	Alfonso_ (Prince of the Brazilian Empire) 
新闻new一下	News 
单镜头模式	Single lens mode 
中国人民解放军总参谋部	General Staff of the Chinese People's Liberation Army 
台北市立大理高级中学	Taipei Dali Senior High School 
图恩足球俱乐部	Thun Football Club 
齐藤太太	Mrs. Saito 
吉打苏丹王朝	Sultan of Kedah 
王中磊	Wang Zhonglei 
奥斯卡最佳男主角	Best Actor Oscar 
乌干达总统	President of Uganda 
奈史密斯学院年度最佳球员	Naismith Academy Player of the Year 
猪哥亮	Pig brother Liang 
乌兹别克国家足球队	Uzbek National Football Team 
《时代》封面人物列表_(1920年代)	"Time" cover list_(1920s) 
原始印欧人	Primitive Indo-European 
中原彰吾	Akago Nakahara 
华语剧台	Chinese Theatre 
古典时代晚期	Late Classical Age 
海南各市县地区生产总值列表	List of regional GDP of each city and county in Hainan 
绍兴市体育中心	Shaoxing Sports Center 
高速铁路	High-speed railway 
合作里	In cooperation 
美洲金杯	America's Gold Cup 
梅赛德斯车队	Mercedes Team 
神机妙算刘伯温	Liu Bowen 
中国高速铁路	China High Speed Railway 
草刈滉一	Koichi Kusakari 
邓素娟	Deng Sujuan 
文昶现	Wen Changxian 
美国西北部	Northwestern United States 
.bs	.bs 
最终用户许可协议	End User License Agreement 
诺曼底战役	Battle of Normandy 
意大利司法部长	Italian Minister of Justice 
越南总理	Prime Minister of Vietnam 
惧怕她	Fear her 
大众传播	mass media 
永久同盟	Perpetual alliance 
现在开始我爱你	I love you now 
乔丹车队	Jordan Team 
村田和哉	Kazuya Murata 
新罕布什尔大学	University of New Hampshire 
松田源治	Genji Matsuda 
小川辉晃	Ogawa Teruaki 
台南市市长	Mayor of Tainan City 
中国统一	Unification of China 
翡翠台电视剧集列表_(2008年)	Jade TV series list_(2008) 
拉丁礼教会	Latin Church 
哈比无人机	Hubi drone 
朝鲜文宗	Korean Wenzong 
mallaig	mallaig 
党委书记	Party Secretary 
王宪魁	Wang Xiankui 
混合法系	Mixed legal system 
崔东根	Choi Donggen 
伯灵顿_(马萨诸塞州)	Burlington_ (Massachusetts) 
刘旻	Liu Min 
大岛郡_(鹿儿岛县)	Oshima County_(Kagoshima Prefecture) 
村松大辅	Taisuke Muramatsu 
都柏林圣三一学院	Trinity College Dublin 
束怀德	Shu Huaide 
国际研究型大学联盟	International Research University Alliance 
事件驱动	Event driven 
日本锁国	Japan Sakoku 
黄衫女子	Yellow shirt woman 
商丘南站	Shangqiu South Railway Station 
阿斯图里亚斯亲王	Prince of Asturias 
日叻务	Zilebu 
希腊国会	Greek Parliament 
爱德华五世	Edward V 
绝对零度	Absolute zero 
乌拉尔联邦管区	Ural Federal District 
印度国防部	Indian Ministry of Defense 
帕莱斯蒂诺体育俱乐部	Palestino Sports Club 
同窗会～love_again症候群	Classmates ~ love_again syndrome 
库尔德人	Kurds 
希腊摄政	Greek Regency 
美国维珍尼亚州检察总长	Attorney General of Virginia 
松平康元	Matsudaira Yasumoto 
弗吉尼亚理工学院暨州立大学	Virginia Polytechnic Institute and State University 
许远东	Xu Yuandong 
东神奈川车站	Higashi Kanagawa Station 
巴哈马君主	Bahamas monarch 
常州站	Changzhou Railway Station 
张乾文	Zhang Qianwen 
勒星顿_(维吉尼亚州)	Lexington_(Virginia) 
尊胤入道亲王	Prince of respect 
曾田博久	Hirohisa Soda 
汉弥尔顿·古尔德-亚当斯	Hamilton Gould-Adams 
波苏战争	Polish-Soviet War 
小野猫	Little wild cat 
肯现场发行公司	Ken Field Distribution Company 
斯卡斯代尔子爵	Viscount Scarsdale 
千里达及托巴哥国家足球队	Trinidad and Tobago National Football Team 
广东有线	Guangdong Cable 
石破二朗	Jiro Ishiba 
印度独立运动	Indian Independence Movement 
张勋杰	Zhang Xunjie 
爱就宅一起	Love and stay together 
印度政务次官	Undersecretary of Government of India 
袁克华	Yuan Kehua 
罗伯特·里奇韦	Robert Ridgeway 
香港市民支援爱国民主运动联合会	Hong Kong Citizens Support Patriotic and Democratic Movement Federation 
芬兰-彼尔姆语支	Finnish-Perm Language Branch 
圣胡安县_(犹他州)	San Juan County_ (Utah) 
机器人动画	Robot animation 
阿卜杜拉·阿尔·费萨尔王子体育场	Prince Abdullah Al Faisal Stadium 
比尔·布莱尔_(篮球教练)	Bill Blair_ (basketball coach) 
nba总冠军	nba championship 
伊斯兰教法	Islamic law 
南原区政府	Namwon District Government 
自由爵士	Free jazz 
.sm	.cm 
大众汽车竞技场	Volkswagen Arena 
君士坦提乌斯二世	Constantius II 
战略管理	Strategic management 
布列塔尼公爵科南四世	Conan IV, Duke of Brittany 
未来都市no.6	Future City no.6 
刑事侦缉档案iv	Criminal Investigation File iv 
肖震_(足球运动员)	Xiao Zhen_ (Football Player) 
加拿大东部	Eastern Canada 
吕西安‧高德曼	Lucien Goldman 
蓟县话	Jixian Dialect 
u15_(加拿大大学)	u15_(Canada University) 
塔夫斯大学	Tufts University 
水原世界杯竞技场	Suwon World Cup Stadium 
奥克拉荷马大学	University of Oklahoma 
精简指令集	Reduced instruction set 
.yu	.versus 
苏联解体	Disintegration of the Soviet Union 
约翰·马歇尔·哈伦二世	John Marshall Harlan II 
波士顿大学	Boston University 
欧洲直升机公司as-365n2海豚	Eurocopter as-365n2 Dolphin 
藤原嫄子	Fujiwara 
金哲明_(足球运动员)	Jin Zheming_ (football player) 
西雷丁_(英国国会选区)	West Reading_ (British Parliamentary District) 
雅盖隆王朝	Jagiellonian 
南台湾	South Taiwan 
中西康晴	Nakanishi Kangqing 
赤山里_(仁武区)	Chishanli_(Renwu District) 
印度尼西亚民族协会	Indonesian National Association 
法律哲学	Legal philosophy 
西班牙足球丙级联赛	Spanish Football League C 
华盛顿州立大学	Washington State University 
波兰民主联盟	Polish Democratic Union 
瑞宝大绶章	Ruibao Great Ribbon Chapter 
墨尔本皇家理工大学	Royal Melbourne Institute of Technology 
尚佩恩县_(伊利诺伊州)	Champaign County_ (Illinois) 
奥本山宫殿球场	Palace of Auburn Hills 
诺贝尔化学奖	Nobel Prize in Chemistry 
前贵之	Former expensive 
试播集_(穹顶之下)	Pilot episode_ (under the dome) 
光州尚武不死鸟	Gwangju Sangmu Phoenix 
亚特兰大老鹰	Atlanta Hawks 
欧文斯伯勒	Owensboro 
最终幻想xiii	Final Fantasy xiii 
新疆各地州市地区生产总值列表	List of Gross Domestic Product of Xinjiang 
西园寺禧子	Xiyuan Temple Xizi 
中央集团军	Central Army 
滨海绍森德区议会	Southend-on-Sea District Council 
米兰加积斯	Milan Gaius 
蒙古国国旗	Mongolia flag 
桂林话	Guilin dialect 
帕特里克·皮尤特施密特	Patrick Pietschmidt 
正黄旗	Yellow flag 
阿斯科利足球俱乐部	Ascoli Football Club 
我那霸文章	My Naha article 
圣保罗州足球协会	Sao Paulo State Football Association 
德国足协杯	German Football Association Cup 
潜行狙击	Sneak sniper 
廉政行动2007	Integrity Action 2007 
亨内平县_(明尼苏达州)	Hennepin County_(Minnesota) 
彼得罗扎沃茨克	Petrozavodsk 
俄国君主列表	List of Russian monarchs 
新传媒	New media 
青年路易	Young Louis 
徐常在	Xu resident 
科学哲学	Philosophy of science 
殷都	Yindu 
徳重健太	Kenta Tokushige 
宜昌百合	Yichang Lily 
佩西塔拉北雅加达足球俱乐部	Persitara North Jakarta Football Club 
中国标准时间	China Standard Time 
合肥师范学院	Hefei Teachers College 
新加坡报业控股传讯	Singapore Press Holdings Communications 
党指挥枪	Party Command Gun 
弘化	Koka 
中山恭子	Nakayama Kyoko 
东部马来-玻里尼西亚语族	Eastern Malay-Polynesian 
孟买高等法院	Mumbai High Court 
五华体育场	Wuhua Stadium 
石礼谦	Shi Liqian 
国际贸易	international trade 
谭汶琳	Tan Wenlin 
美国第3骑兵团	US 3rd Cavalry Regiment 
幸运☆星	Lucky Star 
阿布哈兹战争_(1992年-1993年)	The Abkhazian War (1992-1993) 
中国文化大学	Chinese Culture University 
澳大利亚环境保护、遗产与文化部长	Minister of Environmental Protection, Heritage and Culture of Australia 
小米手机青春版	Xiaomi Mobile Youth Edition 
罗德西亚与尼亚萨兰联邦	Federation of Rhodesia and Nyasaland 
埃及现代君主列表	List of modern monarchs of Egypt 
吕正清	Lu Zhengqing 
杭州湾跨海大桥	Hangzhou Bay Bridge 
马达加斯加总理	Prime Minister of Madagascar 
曽田博久	Hirohisa Soda 
沙特国王杯	Saudi King's Cup 
美国本土	United States 
进击的巨人	Attacking Giant 
埃及第十七王朝	Seventeenth Dynasty of Egypt 
韦尔瓦足球俱乐部	Huelva Football Club 
侯赛因·塔赫里	Hussein Taheri 
织田信秀_(信长之子)	Oda Nobuhide_ (son of Nobunaga) 
台湾地区	Taiwan area 
韦里瓦_(澳大利亚国会选区)	Weriwa_ (Australian Parliamentary Constituency) 
冼淑梅	Xian Shumei 
创意总监	Creative Director 
肇庆体育中心	Zhaoqing Sports Center 
航天飞机轨道器	Space Shuttle Orbiter 
喀拉拉高等法院	Kerala High Court 
法罗克朗	Faro Krona 
范荣笙	Fan Rongsheng 
坂口望二香	Sakaguchi Nojika 
新干线e2系电力动车组	Shinkansen e2 series electric train set 
真航空	Jin Air 
彼得·纽文	Peter Newven 
股份有限公司	Company limited by shares 
格拉斯哥玛丽丘和斯普林伯恩_(苏格兰议会选区)	Glasgow Mary Hill and Springburn_ (Scottish Parliament constituency) 
诺贝尔和平奖	Nobel Peace Prize 
三星galaxy系列	Samsung galaxy series 
四殉道堂	Four Martyrs Church 
马场好弘	Yoshihiro Maiba 
天津汇森女子足球俱乐部	Tianjin Huisen Women's Football Club 
加速度感应器	Acceleration sensor 
海南话拼音方案	Hainanese Pinyin Plan 
qb64	Qibt 4 
建宫敬仁亲王	Prince Jingren 
孝恭章皇后	Queen Xiao Gongzhang 
南风原町	Haebaru Town 
李明	Li Ming 
弗赖堡足球俱乐部	Freiburg Football Club 
中央全面深化改革领导小组	Central Leading Group for Comprehensively Deepening Reform 
国务院台湾事务办公室	Taiwan Affairs Office of the State Council 
中华民国国歌	National Anthem of the Republic of China 
制度经济学	Institutional Economics 
仙恭皇后	Queen Xian Gong 
香港特别行政区政府	The Government of the Hong Kong Special Administrative Region 
孟买郊区县	Mumbai Suburban County 
保卫共和大会	Defense of the Republic 
竹南里	Zhunanli 
任天堂3ds系统软件	Nintendo 3ds system software 
国民解放军	National Liberation Army 
阿方索_(安茹及加的斯公爵)	Alfonso_ (Duke of Anjou and Cadiz) 
蒙古汗国君主列表	List of monarchs of the Mongolian Khanate 
帕迪尤卡_(肯塔基州)	Paducah_ (Kentucky) 
伪满皇宫博物院	Puppet Palace Museum 
拜仁慕尼黑二队	Bayern Munich Second Team 
山内忠义	Yamauchi Tadao 
内华达州第二国会选区	Nevada Second Congressional District 
防御分析学会	Defense Analysis Society 
让-克洛德·范考文伯格	Jean-Claude Van Kaewenberg 
jp:渡辺なつみ	jp: Natsumi Watanabe 
帕拉山骑士足球俱乐部	Pala Mountain Knights Football Club 
荷兰归正会	Dutch Reformed Church 
starteam	starteam 
赠空大学	Donated university 
政治理论	Political theory 
红星勋章	Red Star Medal 
香港民主民生协进会	Hong Kong Association for Democracy and People's Livelihood 
锡耶纳圣徒	Saints of Siena 
中国人民政治协商会议全国委员会主席	Chairman of the National Committee of the Chinese People's Political Consultative Conference 
副队长	vice captain 
陈新侠	Chen Xinxia 
巴勒斯坦历史	Palestine history 
维也纳科技大学	Vienna University of Technology 
白俄罗斯摇滚	Belarusian Rock 
刘弘_(刘备之父)	Liu Hong_(Father of Liu Bei) 
内田达也	Tatsuya Uchida 
广东肇庆恒泰足球俱乐部	Guangdong Zhaoqing Hengtai Football Club 
阿倍橘娘	Abe Tangerine 
伊朗内政部	Iranian Ministry of Interior 
罗马执政官	Archon of Rome 
伍锦霖	Wu Jinlin 
米兰达	Miranda 
mozella	mozella 
wondelgem	wondelgem 
具代烨	Gu Dai Yeo 
地区生产总值过千亿元地级市列表	List of prefecture-level cities with a GDP exceeding 100 billion yuan 
见上森陵	See Shang Sen Ling 
山田显义	Yamada Kenyoshi 
北京鸟人艺术推广有限公司	Beijing Birdman Art Promotion Co., Ltd. 
金日成-金正日主义	Kim Il Sung-Kim Jong Il Doctrine 
越南人民军	Vietnamese People's Army 
利物浦市政厅	Liverpool Town Hall 
马赞德兰语	Mazandaran 
菲律宾国会	Philippine Congress 
罗凤𬞟	Luo Feng𬞟 
项兆伦	Xiang Zhaolun 
内吉梅丁·埃尔巴坎	Nejimedin Erbakan 
上海银行	Shanghai Bank 
中华民国总统府	Presidential Palace of the Republic of China 
波利尼亚克公爵	Duke of Polignac 
葛林芝火山	Ge Linzhi Volcano 
大分体育公园综合竞技场	Oita Sports Park Complex Arena 
前362年	362 years ago 
帕奥克足球俱乐部	Paok Football Club 
伊东杂音_(1999年出道)	Ito Noise_ (Debut in 1999) 
中央网络安全和信息化领导小组	Central Cyber Security and Informatization Leading Group 
威廉二世球场	William II Stadium 
中国共产党第十四次全国代表大会	The 14th National Congress of the Communist Party of China 
第一次意大利埃塞俄比亚战争	The First Italian-Ethiopian War 
东海旅客铁道	Tokai Railway 
波特拿	Porter 
中央研究院院士	Academician of Academia Sinica 
青埔机厂	Qingpu Machinery Factory 
中国思想史	History of Chinese Thought 
石破市造	Ichizo Ishiba 
陈武_(政治人物)	Chen Wu_(Politician) 
美国参议院民主党领袖	Democratic leader of the U.S. Senate 
约翰·彼得·古斯塔夫·勒热纳·狄利克雷	John Peter Gustave Lejeune Dirichlet 
柴谷英树	Hideki Shibatani 
天津市人民政府	Tianjin Municipal People's Government 
哥本哈根诠释	Copenhagen interpretation 
大开眼界!日本第一	Eye-opener! No. 1 in Japan 
波士尼亚与赫塞哥维纳政区	Districts of Bosnia and Herzegovina 
汪光焘	Wang Guangtao 
马歇尔县_(西维吉尼亚州)	Marshall County_ (West Virginia) 
克拉玛结他公司	Karama Guitar Company 
费米气体	Fermi Gas 
韩国造币与安全印刷合作公司	Korea Minting and Security Printing Cooperative Corporation 
新店站	Xindian Station 
牙买加，我们热爱的家园	Jamaica, our beloved home 
黑胶唱片	Vinyl Records 
高雄捷运	Kaohsiung MRT 
兰卡斯特的布兰奇	Blanche of Lancaster 
洛桑体育足球俱乐部	Lausanne Sports Football Club 
加拿大部队勋章	Canadian Forces Medal 
闽景宗	Minjingzong 
台北市立幸安国民小学	Taipei City Xing'an Elementary School 
威特曼·皮尔森，第一代考德雷子爵	Witman Pearson, the first Viscount Cowdray 
布拉甘蒂诺竞技俱乐部	Bragantino Athletic Club 
梅宫薰子内亲王	Prince of Umemiya Kaoriko 
巴啦啦小魔仙	Ba Lala little magic fairy 
户田信子	Toda Nobuko 
乔斯·维斯塔潘	Jose Verstappen 
大连湾前关足球俱乐部	Dalian Bay Qianguan Football Club 
北爱尔兰联赛杯	Northern Ireland League Cup 
资料控制语言	Data control language 
稻城市	Inagi 
小米手机4	Xiaomi mobile phone 4 
拜上帝会	Worship 
李海瓒	Li Haichan 
b.b.スタジオ	b.b. studio 
罗马尼亚足球总会	Romanian Football Association 
意大利足球卓越联赛	Italian Football Premier League 
若因维利竞技场	Joinville Arena 
桃园捷运公司	Taoyuan MRT Corporation 
groen!	green! 
亚伯达省议会	Alberta Parliament 
澳大利亚就业及劳资关系部	Australian Department of Employment and Labor Relations 
媒体播放器	media Player 
北京大学女生宿舍	Peking University Female Dormitory 
阿尔弗雷德亲王_(爱丁堡和萨克森-科堡-哥达)	Prince Alfred_ (Edinburgh and Saxony-Coburg-Gotha) 
科英布拉大学	University of Coimbra 
德国独立社会民主党	German Independent Social Democratic Party 
黄志成	Huang Zhicheng 
渣打集团	Standard Chartered Group 
.an	.an 
10美元纸币	10 dollar bills 
茶野隆行	Chano Takayuki 
广州昊昕	Guangzhou Haoxin 
帕斯卡_(消歧义)	Pascal_ (disambiguation) 
仲野顺也	Nakano Junya 
艾尔弗·斯隆基金	Alf Sloan Fund 
普罗旺斯的埃莉诺	Eleanor of Provence 
鲍渥共融	Bower Communion 
巴布亚新畿内亚君主	Monarch of Papua New Guinea 
科克市议会	Cork City Council 
史云斯足球俱乐部	Swans Football Club 
法比奥拉王后_(比利时)	Queen Fabiola_ (Belgium) 
日本柳杉	Japanese cedar 
自由民主党总务会	Liberal Democratic Party General Affairs Council 
温布利球场_(1923年)	Wembley Stadium_ (1923) 
太阳唱片公司	Sun Records 
桃花岛_(门派)	Peach Blossom Island_ (Martial Art) 
衍生拉丁字母	Derived Latin letters 
超级无敌奖门人_终极篇	Super Invincible Award Doorman_Ultimate 
葡萄牙17岁以下国家足球队	Portugal Under-17 National Football Team 
宇治田原町	Ujitawara Town 
室内设计师	interior designer 
espn2	espn2 
附庸国	Vassal state 
麻吉兄弟	Maji Brothers 
杨溥	Yang Pu 
罗马尼亚总统	President of Romania 
银鱼音乐有限公司	Whitebait Music Co., Ltd. 
陈百全	Chen Baiquan 
ac米兰足球俱乐部	ac Milan Football Club 
邓俊曦	Deng Junxi 
中央研究院物理研究所	Academia Sinica Institute of Physics 
利凯琳	Li Kailin 
城市体育馆	City Stadium 
黄承晖谢敏瑜逝世特辑	Special Collection of Huang Chenghui Xie Minyu's Death 
光格天皇	Emperor Kokaku 
近贺由香里	Yukari Kinga 
后座作用	Back seat 
噪音流行	Noise epidemic 
红色死亡左轮	Red death revolver 
链反应	Chain reaction 
埃及陆军	Egyptian Army 
泉中央站	Izumi Central Station 
汇编语言	Assembly language 
拉哈布拉_(加利福尼亚州)	La Habra_ (California) 
图皮语系	Tupi language family 
索非亚技术大学	Sofia Technical University 
福隆经纪公司	Fulong Brokerage Company 
镇西将军	General Zhenxi 
v-22鱼鹰式倾转旋翼机	v-22 Osprey Tilt Rotor 
田村稔	Tamura Minor 
法国高等科学研究所	French Institute of Advanced Sciences 
佛罗里达农工大学	Florida A&M University 
川口尚纪	Kawaguchi Naoki 
尤马蒂拉县_(俄勒冈州)	Umatilla County_ (Oregon) 
罗金荣	Luo Jinrong 
侬语支	Nong Branch 
福塔雷萨体育会	Fortaleza Sports Club 
命令与征服：叛逆者	Command and Conquer: The Rebel 
早阪良太	Ryota Hayasaka 
圣派翠克勋章	Saint Patrick's Medal 
id精英	id elite 
高木和彻	Takagi Kazutoru 
经济部长	Minister of Economy 
约阿尼纳	Ioannina 
九龙城区	Kowloon City District 
后印象派	Post-impressionism 
森元恒雄	Tsuneo Morimoto 
西斯笃一世	Sistus I 
希尔伯特计划	Hilbert Project 
阿方索_(巴西帝国皇子)	Alfonso_ (Prince of the Brazilian Empire) 
台北市立大同高级中学	Taipei City Datong Senior High School 
费扬古_(栋鄂氏)	Feiyanggu_ (Dong'e family) 
美国空军一级司令部列表	US Air Force Tier 1 Command List 
伟大文化	Great culture 
艺房紫北京文化传播有限公司	Yifangzi Beijing Culture Communication Co., Ltd. 
楚鲁巴斯科战役	Battle of Chulubasco 
卡拉比－丘流形	Calabi-Yau Manifold 
马来西亚青年及体育部	Ministry of Youth and Sports of Malaysia 
迪奥高维亚拿	Diogo Viana 
向风群岛	Windward Islands 
捷克斯洛伐克国家足球队	Czechoslovak National Football Team 
约翰·福赛思	John Forsyth 
ettelbruck	ettelbruck 
梅什科一世	Meszko I 
深圳风鹏足球俱乐部	Shenzhen Fengpeng Football Club 
法国国家u19国家足球队	French national u19 national football team 
丽都运河	Lido Canal 
动画影集	Animated album 
战斗车辆	Combat vehicle 
就业及年金大臣	Minister of Employment and Pensions 
comăneşti	Comanesti 
普世教会协会	Universal Church Association 
布颜特·乌卡哈体育宫	Bujant Ukaha Sports Palace 
伦齐青年会	Renzi Youth Club 
有地品之允	Have the permission 
韩国独立党	Korean Independence Party 
加兹温	Qazvin 
查尔斯·克里普斯，第一代帕穆尔男爵	Charles Cripps, the first Baron Pamur 
土耳其民主左翼党	Turkish Democratic Left Party 
刘赐贵	Liu Cigui 
苹果遥控器	Apple remote 
高丽与契丹之战	The battle between Korea and Khitan 
长町车站	Nagamachi Station 
科学普及	Common science 
1美元纸币	1 dollar bill 
瑞士20岁以下国家足球队	Switzerland Under-20 National Football Team 
耶鲁学院	Yale College 
侗台语族	Dong Taiwanese 
奥斯卡最佳男主角奖	Oscar for Best Actor 
wikt:郑州	wikt: Zhengzhou 
德黑兰石油足球俱乐部	Tehran Petroleum Football Club 
原来爱上贼	I fell in love with a thief 
捷克斯洛伐克总统	President of Czechoslovakia 
交流电	Alternating current 
亨利·格雷，第一代萨福克公爵	Henry Gray, the first Duke of Suffolk 
克洛德·阿德里安·爱尔维修	Claude Adrian Air Repair 
和泉史郎	Shiro Izumi 
tertons_f.c.	tertons_f.c. 
特等站_(中国大陆)	Special Station_(Mainland China) 
林子欣	Lin Zixin 
奥地利的唐胡安	Don Juan 
高山和真	Kazuma Takayama 
胡祖域	Hu Zuyu 
monomethylhydrazine	monomethylhydrazine 
第六届全国人民代表大会	Sixth National People's Congress 
utc+10	utc+10 
.se	.I know 
美国革命	American Revolution 
理论物理	Theoretical physics 
厄瓜多足球协会	Ecuador Football Association 
rpython	rpython 
贝鲁特国际机场	Beirut International Airport 
朝觉院	Asakakuin 
国立屏东大学民生校区	National Pingtung University Minsheng Campus 
四条畷市	Shijonawate City 
伦敦议会	London Parliament 
陈湘娟	Chen Xiangjuan 
万那杜储备银行	Reserve Bank of Vanuatu 
大谷尚辉	Otani Shanghui 
全日本公路赛	All Japan Road Race 
高速下行分组接入	High-speed downlink packet access 
依诺增爵八世	Innocent VIII 
新埔站_(新北市)	Xinpu Station_(New Taipei City) 
宇宙战舰大和号2199	Space Battleship Yamato 2199 
玛格丽特一世	Margaret I 
瑞文女子中学	Raven Girls' High School 
.ro	.RO 
冰岛足球协会	Iceland Football Association 
洪天照	Hong Tianzhao 
俄罗斯海外正教会	Russian Overseas Orthodox Church 
美国陆军部	U.S. Department of War 
香港高级组银牌	Hong Kong Senior Group Silver Medal 
旧瑞士邦联	Old Swiss Confederation 
高慧敏	Gao Huimin 
法国宪法	French Constitution 
南京复兴站	Nanjing Fuxing Station 
意大利王国_(拿破仑时代)	The Kingdom of Italy_ (Napoleonic era) 
校园4贱客	Campus 4 bitch 
越南机动车号牌	Vietnam Motor Vehicle Number Plate 
法罗群岛教会	Faroe Islands Church 
天涯侠医	End of the World Doctor 
湖城路站	Hucheng Road Station 
创世纪乐团	Genesis Orchestra 
克鲁斯-华格纳制片	Produced by Cruise Wagner 
波音商店	Boeing Store 
客户关系管理	Customer relationship management 
新界社团联会	New Territories Association of Societies 
包头南郊联社足球俱乐部	Baotou Southern Suburbs Association Football Club 
焦亚-德尔科莱	Gioia del Colle 
第八世哲布尊丹巴呼图克图	Eighth Jebzundamba Kutuktu 
山田元気	Genki Yamada 
1848年匈牙利革命	Hungarian Revolution of 1848 
阿尔·达沃萨里	Al Davosari 
匈牙利内政部长	Minister of the Interior of Hungary 
海德堡联足球俱乐部	Heidelberg United Football Club 
和硕联合科技	Pegatron United Technology 
彭亨州授勋及嘉奖制度	Pahang State Honors and Awards System 
东库希特语支	East Kushitian 
桑查·桑切斯_(潘普洛纳)	Sancha Sanchez (Pamplona) 
小杉保夫	Yasuo Kosugi 
首相私人秘书长	Prime Minister's Private Secretary 
潮州话拼音方案	Teochew Pinyin Plan 
苏美如	Su Meiru 
义大利摇滚	Italian Rock 
犹太语族	Jewish family 
香港圣玛加利女书院	St. Margaret's Girls' College, Hong Kong 
和硕和惠公主	Princess and princess 
西班牙众议院	Spanish House of Representatives 
国立雅典理工大学	National Technical University of Athens 
相模原麻沟公园竞技场	Sagamihara Magou Park Arena 
区域居民称谓词	Regional Resident Title 
卡泰真拿	Catalina 
凤凰卫视美洲台	Phoenix TV America 
石原典子	Noriko Ishihara 
四十九日·祭	Forty-nine days festival 
红色警戒：反戈一击	Red Alert: a counter-attack 
东京都知事	Governor of Tokyo 
file:square_logo.png	file:square_logo.png 
马哈奇卡拉安日足球俱乐部	Makhachkala Anri Football Club 
货物配送	Goods distribution 
sint-denijs-westrem	Sint-Denijs-Westrem 
知子女王	Chiko Queen 
罗马斗兽场	Colosseum 
柏达邦07体育会	Patabong 07 Sports Club 
信浓之国	Shinano country 
垃圾摇滚	Grunge 
托文拿	Torvena 
赵成夏	Zhao Chengxia 
杨姓	Yang Surname 
今川氏真	Imagawa Ujizane 
角川集团	Kadokawa Group 
麻醉风暴	Anesthesia Storm 
movieplex	Movieplex 
南岛民族	South Island People 
城崎温泉车站	Kinosaki Onsen Station 
阇耶跋摩二世	Jayavarman II 
刑事侦缉档案iii	Criminal Investigation File iii 
克莱孟七世	Clement VII 
中央军事委员会政治工作部	Political Work Department of the Central Military Commission 
存在哲学	Existential philosophy 
三姊妹_(韩国电视剧)	Three Sisters_ (Korean TV Drama) 
波兰乌克兰战争	Polish-Ukrainian War 
曹怀东	Cao Huaidong 
斯特拉托二世	Strato II 
和之味集团	Hezhiwei Group 
奢羯罗	Shekhara 
写歌者	Songwriter 
香港乙组联赛	Hong Kong League Two 
kylähullut	Village crazy 
柬埔寨瑞尔	Cambodian Riel 
洪昭子	Hong Zhaozi 
亚琛战役	Battle of Aachen 
德国第3装甲军团	German 3rd Armored Corps 
机动战士高达00	Mobile Suit Gundam 00 
佐贺县民歌	Saga Folk Songs 
山名あかね	Akane Yamana 
圣乔治教堂	St. George's Church 
王津_(足球裁判)	Wang Jin_ (Football Referee) 
星野桂	Katsura Hoshino 
嫁妆_(电视剧)	Dowry_ (TV series) 
天主教香港教区	Catholic Diocese of Hong Kong 
藤原诚子	Fujiwara Seiko 
冠军方程式是戒系列赛	Formula Champion is the quit series 
古惑狼系列	Crash Wolf Series 
韦育任	Wei Yuren 
库克群岛	Island 
前204年	204 years ago 
新加坡体育理事会	Singapore Sports Council 
警察总区	Police district 
古巨基	Gu Juji 
京王电铁	Keio Electric 
消费电子产品	Consumer Electronics 
约翰·霍普，第一代林利思戈侯爵	John Hope, the first Marquis of Linlithgow 
德尼·海内门天体物理奖	Denis Heinemen Astrophysical Award 
南闪米特语支	South Semitic 
凯德尔斯顿的寇松侯爵	The Marquis of Curzon of Kedleston 
玛丽亚·克里斯蒂娜·泰莱萨_(两西西里)	Maria Cristina Telesa_ (Two Sicily) 
孙景淼	Sun Jingmiao 
泰晤士河畔金斯顿	Kingston upon Thames 
明慈皇太妃	Emperor Ming Cihuang 
西北闪米特诸语	Northwest Semitic Languages 
阿什莫尔和卡捷群岛	Ashmore and Cartier Islands 
吉野弘幸	Hiroyuki Yoshino 
武装力量	Armed forces 
施公奇案ii	Shi Gongqi case ii 
科威特超级足球联赛	Kuwait Premier League 
奥柏林集团	Oberlin Group 
济州国际机场	Jeju International Airport 
萨拉热窝大学	Sarajevo University 
里斯迪罗球场	Risdiro Stadium 
樱花乍现	Cherry blossoms 
梦幻情侣	Dream couple 
隔世追凶	Chasing the murderer 
青岛农业大学	Qingdao Agricultural University 
实藤_友纪	Shito_Yuki 
萨尔布吕肯足球俱乐部	Saarbrücken Football Club 
陈宗艺	Chen Zongyi 
黄美珍_(邵逸夫夫人)	Huang Meizhen_ (Mrs. Run Run) 
那不勒斯国王	King of Naples 
大冢彻	Otsuka Toru 
你骑自行车_我坐火车回家	You ride a bicycle _ I take the train home 
莫斯科迪纳摩	Dynamo Moscow 
威塞克斯的艾吉芙	Ai Jieff of Wessex 
南非镑	South African Pound 
教宗恩狄	Pope Endi 
石勒苏益格-荷尔斯泰因-宗德堡-奥古斯腾堡王朝	Schleswig-Holstein-Zonderburg-Augustenberg Dynasty 
中华人民共和国第十二届运动会	The 12th Games of the People's Republic of China 
中国铁路机车车辆工业总公司	China Railway Rolling Stock Industry Corporation 
夏景宗	Xia Jingzong 
洛吉尔谷区政府	Logir Valley District Government 
那波尼德	Nabonid 
河北师范大学	Hebei Normal University 
巴西众议院	Brazilian House of Representatives 
西基电脑动画	Siki Computer Animation 
空知英秋	Hideaki Sorachi 
贝勒尼基四世	Beleniki IV 
努埃瓦加的斯足球会	Nueva Gadiz Football Club 
西伯利亚出兵	Siberia sends troops 
中国男子篮球职业联赛	China Men's Basketball Professional League 
城关区_(拉萨市)	Chengguan District_(Lhasa City) 
金鹰卡通	Golden Eagle Cartoon 
全玄载	Quan Hyun-jae 
中国足球甲级联赛	Chinese Football League 
姜在涉	Jiang Jae Sheep 
冈山郡	Okayama County 
宣懿王后	Queen Xuan Yi 
德国外交部	German Ministry of Foreign Affairs 
社会群岛	Society Islands 
日笠淳	Jun Hikasa 
绝顶集	Supreme set 
阿道夫·希特勒之死	The death of Adolf Hitler 
不丹时间	Bhutan Time 
澳大利亚八校联盟	Australia Eight Schools Alliance 
军事成就勋章	Military Achievement Medal 
芬兰大公后	Queen of Finland 
北叶门总统	President North Yemen 
香港警察徽章	Hong Kong Police Badge 
西伯利亚语组	Siberian group 
周公与桃花女_(叶青歌仔戏)	Zhou Gong and Peach Girl_ (Ye Qing Taiwanese Opera) 
加拿大皇家医科学院	Royal College of Medicine of Canada 
第七代亨廷顿和诺森布里亚伯爵圣利兹的西蒙三世	Simon III of St. Leeds, 7th Earl of Huntington and Northumbria 
渡边胜也	Katsuya Watanabe 
商业软件	commercial software 
新迷幻乐	New psychedelic music 
非洲统一组织	Organization of African Unity 
自治共和国	Autonomous republic 
远山敦子	Toyama Atsuko 
国家园林城市	National Garden City 
奥地利的安东大公	Archduke Anton of Austria 
法国军事史	French military history 
北非战场	North Africa Battlefield 
哥斯达黎加大学	University of Costa Rica 
刘繁蔚	Liu Fanwei 
天主教巴兰基亚总教区	Catholic Archdiocese of Barranquilla 
马斯友美党	Mas Youmei Party 
丰德丽控股	Fengdeli Holdings 
大乌斯河	Grand ous 
向德深	Xiang Deshen 
新帝国主义	New imperialism 
认知科学	Cognitive science 
尼泊尔摇滚	Nepal Rock 
铁道博物馆站	Railway Museum Station 
内布拉斯加大学	University of Nebraska 
王麟祥	Wang Linxiang 
广州白云国际机场_(1933－2004年)	Guangzhou Baiyun International Airport_(1933-2004) 
暴走法医	Runaway forensic 
智利比索	Chilean Peso 
台维斯杯	Davis Cup 
卡尔十三世	Karl XIII 
雍正王朝	Yongzheng Dynasty 
2010/11赛季欧洲冠军联赛	2010/11 season UEFA Champions League 
鱼骨头	fish bones 
教宗若望四世	Pope John IV 
孝成敬皇后	Empress Zhang 
美国参议院退伍军人事务委员会	U.S. Senate Committee on Veterans Affairs 
舞力全开3	Just Dance 3 
通讯设备	Communication equipment 
格芬唱片公司	Geffen Records 
天主教伊莫拉教区	Catholic Diocese of Imola 
迷宫恋曲	Labyrinth 
沃尔沃集团	Volvo Group 
绯贺由香理	Higa Yukari 
三原雅俊	Masatoshi Mihara 
清太宗继妃	Emperor Taizong of the Qing Dynasty 
缅因大学	University of Maine 
.tm	.tm 
小韦恩	Little Wayne 
布列塔尼女公爵康斯坦丝	Constance, Duchess of Brittany 
金亨溢	Jin Hengyi 
周正庆	Zhou Zhengqing 
博科尼大学	Bocconi University 
谢维和	Xie Weihe 
井波靖奈	Sena Inami 
南突厥语支	South Turkic 
电子游戏机历史_(第四世代)	History of electronic game consoles_ (fourth generation) 
郑州站	Zhengzhou Railway Station 
缅甸欧洲人	Burmese Europeans 
李锦鸿	Li Jinhong 
杉森考起	Shan Sen Koki 
阿波罗登月舱	Apollo Lunar Module 
威廉·吉布森_(澳大利亚政治家)	William Gibson_ (Australian politician) 
zlatitsa	zlatitsa 
ah-1z蝰蛇直升机	ah-1z Viper helicopter 
夏季奥林匹克运动会	Summer Olympic Games 
恶战_(我为喜剧狂)	Battle _ (I am a comedy mad) 
建构主义_(学习理论)	Constructivism_ (Learning Theory) 
五港总督	Governor of Five Ports 
王心慰	Wang Xinwei 
蒙吉萨战役	Battle of Mongissa 
陈绿平	Chen Luping 
塔兰潘特拉_(巴兹)	Tarampantla_ (Baz) 
ubuntu发行版列表	ubuntu release list 
恋爱冒险游戏	Love adventure game 
波兰陆军	Polish Army 
花泽香菜	Hanazawa Coriander 
布莱克本_(英国国会选区)	Blackburn_(British Parliamentary District) 
北京国会旧址	Beijing Congress Site 
皇民化运动	Emperor movement 
开丽娱乐经纪	Kaili Entertainment Broker 
缅甸军队	Burma Army 
佛兰德的朱迪丝	Judith of Flanders 
赎罪日	Yom Kippur 
西北印第安战争	Northwest Indian War 
一条实辉	A Shihui 
westmere微架构	westmere microarchitecture 
网络游戏	Online game 
何群娥	He Qun'e 
峇峇马来语	Baba Malay 
富安健洋	Fu An Jian Yang 
入侵巴拿马	Invade Panama 
联合国日内瓦办事处	United Nations Office at Geneva 
郑兆均	Zheng Zhaojun 
滋宫韶子内亲王	Prince of Zi Gong Shao Zi Nei 
澳门-macau	Macau-macau 
上里一将	The last one 
伦敦地上铁	London Overground Rail 
行政区_(纽约市)	Administrative District_ (New York City) 
file:《孝哲毅皇后朝服像》.jpg	file: "Portrait of Queen Xiaozheyi in court dress".jpg 
斯普利特足球俱乐部	Split Football Club 
冰岛外交部长	Minister of Foreign Affairs of Iceland 
水星唱片	Mercury Records 
霹雳小组系列	Thunder Team Series 
利物浦市议会	Liverpool City Council 
石家庄天工足球俱乐部	Shijiazhuang Tiangong Football Club 
古籍研究社系列	Ancient Books Research Society Series 
欧洲文化之都	European Capital of Culture 
老挝国会	Lao National Assembly 
富士见町	Fujimi Town 
afrobeat	afrobeat 
美丽人生_(梁静茹专辑)	Beautiful Life_(Leong Jingru Album) 
pdp-10	PDP-10 
玛丽亚·莫鲁兹-库扎	Maria Moruz-Kuza 
英国电影学院奖最佳男配角	British Film Academy Awards for Best Supporting Actor 
卡利体育球场	Cali Sports Stadium 
田口淳之介	Junnosuke Taguchi 
等等力陆上竞技场	Equal Force Land Arena 
布吉摇滚	Boogie rock 
上海嘉定城发	Shanghai Jiading City Development 
s:文化部组织法	s: Organic Law of the Ministry of Culture 
中国共产党福建省委员会	Fujian Provincial Committee of the Communist Party of China 
美国通用电气公司	General Electric Company 
天主教首尔教省	Catholic Province of Seoul 
罗浩楷	Luo Haokai 
美国排位名单	U.S. Qualifying List 
塞尔维亚足球协会	Serbian Football Association 
拉里萨足球俱乐部	Larissa Football Club 
尼日尔-刚果语系	Niger-Congo 
神奈川县第14区	District 14 of Kanagawa Prefecture 
三个代表	Three representatives 
理子女王	Queen Riko 
绍瓦蓬王太后	Queen Mother Sauvapong 
俄罗斯联邦国防部	Ministry of Defense of the Russian Federation 
尤卡坦半岛	Yucatan Peninsula 
多瑙斯特雷达	Donaustreda 
储存装置	Storage device 
好人，坏人和女皇	Good guys, bad guys and queens 
台视新闻台	TTV News Channel 
民主社会主义党	Democratic Socialist Party 
彼得保罗主教座堂	Peter and Paul Cathedral 
东尼·怀特佛得	Tony Whitefield 
救世传说	Salvation Legend 
长崎县民歌	Nagasaki Folk Songs 
中国共产党吉林省委员会	Jilin Provincial Committee of the Communist Party of China 
蒙彼利埃_(佛蒙特州)	Montpellier_(Vermont) 
作家杰克	Writer jack 
结城真一	Yuki Shinichi 
袁瀚轩	Yuan Hanxuan 
内阁府特命担当大臣	Minister in charge of the Cabinet Office 
波兰元帅	Marshal of Poland 
协和广场	Xiehe square 
特兰米尔流浪者足球俱乐部	Tranmere Rangers Football Club 
袁健生	Yuan Jiansheng 
中央军事委员会国际军事合作办公室	Central Military Commission International Military Cooperation Office 
尼加拉瓜科多巴	Cordoba, Nicaragua 
圣约翰_(新不伦瑞克)	St. John's (New Brunswick) 
几何战争	Geometric war 
布朗斯顿_(佛罗里达州)	Bronston_ (Florida) 
终极x宿舍	Ultimate x Hostel 
夏季奥林匹克运动会足球比赛	Summer Olympic Games football match 
pt-109摩托鱼雷艇	pt-109 Motor Torpedo Boat 
温布顿足球俱乐部	Wimbledon Football Club 
徐英伟	Xu Yingwei 
曾凤呜	Zeng Fengming 
电子游戏机历史_(第五世代)	History of electronic game consoles_ (fifth generation) 
劳迪丝三世	Laudice III 
南斯拉夫总统	President of Yugoslavia 
大韩民国陆军士官学校	Korean Army Non-commissioned Academy 
美味的想念	Delicious miss 
第十二届全国人民代表大会常务委员会	Standing Committee of the Twelfth National People's Congress 
阿德莱德大学	University of Adelaide 
荒川弘	Hiromu Arakawa 
中国科学院	Chinese Academy of Sciences 
中部公约组织	Central China Convention Organization 
维京金属	Viking Metal 
让-路易·韦迪耶	Jean-Louis Vidier 
宾夕法尼亚大学	University of Pennsylvania 
电影制作	Film Production 
雁来红	Yan Laihong 
挪威议会	Norwegian Parliament 
殉教者爱德华	Edward the Martyr 
希望号列车	Hope train 
开普殖民地首相	Prime Minister of Cape Colony 
慕尼黑奥林匹克体育场	Munich Olympic Stadium 
钢铁之心	Heart of Steel 
热奥弗鲁瓦基查尔球场	Geoffroy Kichal Stadium 
迷你专辑	Mini album 
福克斯通和海斯_(英国国会选区)	Folkestone and Hayes_ (UK Parliamentary District) 
丽江嘉云昊足球俱乐部	Lijiang Jiayunhao Football Club 
琉球神道	Ryukyu Shinto 
黄显荣_(中华民国空军)	Huang Xianrong_ (Republic of China Air Force) 
瑞典外交部	Swedish Ministry of Foreign Affairs 
中华人民共和国邮电部	Ministry of Posts and Telecommunications of the People's Republic of China 
医疗卫生	medical hygiene 
诸田敏	Toshi Zhutian 
祇园车站_(福冈县)	Gion Station_(Fukuoka Prefecture) 
伊朗外交部	Iranian Ministry of Foreign Affairs 
阿什杜德足球俱乐部	Ashdod Football Club 
加利福尼亚州州长	Governor of California 
澳门特别行政区区徽	Regional Emblem of Macao Special Administrative Region 
仁福里	Renfori 
亨利·尼斯，第一代尼斯男爵	Henry Nice, the first Baron of Nice 
皇仁书院	Queen's College 
eh邮区	eh postal area 
.mt	.mt 
邮政指数	Postal index 
有原刊菜	Arihara Kanna 
何雍坚	He Yongjian 
玉箫剑法	Yuxiao sword technique 
胡安娜三世	Juana III 
石原崇兆	Takazhao Ishihara 
美国陆军第97步兵师	U.S. Army 97th Infantry Division 
石渡淳治	Junji Ishiwatari 
拉丁维文	Latin Uyghur 
欧洲和北美洲世界遗产列表	List of World Heritage Sites in Europe and North America 
艾康尼斯品牌集团公司	Iconic Brand Group 
孟买市区县	Mumbai City and County 
宜兰县立顺安国民中学	Yilan County Shun'an National High School 
平野宏治	Koji Hirano 
巴黎-奥利机场	Paris-Orly Airport 
吴富彤	Wu Futong 
天主教乌特勒支总教区	Catholic Archdiocese of Utrecht 
原始闽语	Original Hokkien 
陆海军人民委员部	People's Committee of Army and Navy 
诚仁亲王	Prince Chengren 
f-106三角标枪战斗机	f-106 triangle javelin fighter 
国家测绘地理信息局	National Bureau of Surveying and Mapping 
同济大学	Tongji University 
德克萨斯基督教大学	Texas Christian University 
天外飞仙	Flying fairy 
罗马天主教会	Roman Catholic Church 
钱鼎	Qian Ding 
意大利统治者列表	List of rulers of Italy 
约翰·贝茨·克拉克奖	John Bates Clark Award 
高阳西五陵	Goyang West Five Tombs 
本扎耶体育场	Binzaye stadium 
中国一级行政区	China's first-level administrative region 
加拿大越洋航空	Canadian Transocean Airlines 
俄克拉何马州立大学静水校区	Oklahoma State University Stillwater Campus 
菲利普一世_(奥尔良公爵)	Philip I_ (Duke of Orleans) 
库尔恰克语支	Kurchak 
希腊地区单位	Greek regional unit 
触控屏幕	Touch screen 
许珮珊	Xu Peishan 
凤兴里	Fengxingli 
歪星撞地球	Crooked star hit the earth 
狄拉克奖	Dirac Award 
中华人民共和国国家发展和改革委员会	National Development and Reform Commission, People's Republic of China 
斯威士兰首相	Prime Minister of Swaziland 
中华人民共和国国务院_(第十一届)	State Council of the People's Republic of China_ (Eleventh) 
克迪斯美阿	Kdismea 
吉丸绚梓	Yoshimaru Ayazusa 
索姆河战役	Battle of the Somme 
公立常春藤	Public ivy 
卢森堡美军公墓和纪念馆	Luxembourg American Cemetery and Memorial 
只有你_(2005年电视剧)	Only you_ (2005 TV series) 
中央大学_(消歧义)	Central University_ (disambiguation) 
新千岁机场	New Chitose Airport 
市政厅_(消歧义)	City Hall_ (disambiguation) 
加利西亚君主列表	List of Galician monarchs 
朗芮区政府	Langrui District Government 
曹操高陵	Cao Cao Gaoling 
高桥美佳子	Mikako Takahashi 
林炳坤	Lin Bingkun 
巴勒斯坦立法委员会	Palestinian Legislative Council 
佐野英敏	Hidetoshi Sano 
光电效应	Photoelectric effect 
金牌制作股份有限公司	Gold Medal Production Co., Ltd. 
美洲太阳俱乐部	American Sun Club 
欧亚混血	Eurasian 
黎棨源	Li Diyuan 
远山清彦	Toyama Kiyohiko 
谷口悟朗	Goro Taniguchi 
东部印度-雅利安语	East Indo-Aryan 
安达赫治体育会	Unterhaching Sports Club 
鸟取沙丘	Tottori Sand Dunes 
与那国语	Yona Mandarin 
伊活公园球场	Yihuo Park Stadium 
大阪府旗	Osaka Prefecture Flag 
莫斯科中山大学	Moscow Sun Yat-sen University 
忠孝里_(冈山区)	Zhongxiaoli_(Gangshan District) 
三河国	Mikawa Province 
瓦卢瓦的玛丽·伊莉莎白	Mary Elizabeth of Valois 
英国行政区划	British administrative divisions 
志水龟	Chi Water Turtle 
新北市政府	New North Municipal Government 
中央吕宋	Central Luzon 
佩德罗波利斯大教堂	Pedropolis Cathedral 
建国纪念之日	National Foundation Day 
郭树清	Guo Shuqing 
阿信_(电视剧)	Ashin_ (TV series) 
中国佛教	Chinese Buddhism 
叶金凤	Ye Jinfeng 
洛圣都	Los Santos 
瓦戈纳县_(奥克拉荷马州)	Wagoner County_(Oklahoma) 
特工老爹	Agent Daddy 
pangs	pangs 
德川修子	Tokugawa Shuko 
我们的爱知	Our aichi 
舒明天皇	Emperor Jomei 
朝鲜半岛的地方	Places on the Korean Peninsula 
现场八方	All directions 
武昌起义	Wuchang Uprising 
粉红邦妮	Pink Bonnie 
印度尼西亚军事	Indonesian military 
高岛礼子	Reiko Takashima 
藤原稳子	Fujiwara Tomoko 
国家和世界经济大学	National and World Economic University 
蒙地卡罗体育会	Monte Carlo Sports Club 
太子町_(大阪府)	Taishi Town_ (Osaka) 
奥林匹克公园体育场	Olympic Park Stadium 
小林靖子	Kobayashi Yasuko 
汉诺威王朝	Hanover Dynasty 
坦尚尼亚先令	Tanzanian Shilling 
华特迪士尼动画工作室	Walt Disney Animation Studios 
鹤见区_(大阪市)	Tsurumi Ward_(Osaka City) 
尼德兰人的血脉	The blood of the Dutch 
广西广播电视大学	Guangxi Radio and Television University 
高雄捷运高运量电联车	Kaohsiung MRT High-capacity Electric Coupling 
吉野峻光	Yoshino Takamitsu 
车仁杓	Cha Renpyo 
w:de:deutsche_fußballnationalmannschaft_(u-20-männer)	w: de: german national football team _ (u-20 men) 
肇庆恒泰	Zhaoqing Hengtai 
船山贵之	Chuanshan Takayuki 
万里小路睦子	Wanlixiaoji Muko 
怀俄明州州长	Governor of Wyoming 
桌上型电脑	Desktop computer 
东北格拉斯哥_(英国国会选区)	Northeast Glasgow_(British Parliamentary Constituency) 
孔德贵	Kong Degui 
德川金子	Tokugawa Kaneko 
田坂祐介	Yusuke Tasaka 
就想赖著你	Just want to rely on you 
使命召唤系列	Call of Duty Series 
中国移动	China Mobile 
林一平	Lin Yiping 
教宗若望一世	Pope John I 
亨利王子勋章	Prince Henry Medal 
固定翼飞机	Fixed-wing aircraft 
牛津大学基督学院	Oxford University Christian College 
父女变变变	Father and daughter change 
克努特王子	Prince Knut 
秘密日记	Secret diary 
电子摇滚	Electronic rock 
林地高中	Woodland High School 
庄静固伦公主	Princess Zhuang Jing Gulun 
阿拉伯社会主义运动	Arab Socialist Movement 
荷属安的列斯总督	Governor of Netherlands Antilles 
约瑟芬·夏洛特公主_(比利时)	Princess Josephine Charlotte_(Belgium) 
卡利地亚足球俱乐部	Kallithea Football Club 
小杉健	Ken Kosugi 
武汉卓尔	Wuhan Zall 
嘻哈灵魂乐	Hip Hop Soul 
神田梦实	Yumemi Kanda 
天主教威斯敏斯特总教区	Catholic Archdiocese of Westminster 
电机工程学	Electrical engineering 
马特斯堡体育会	Mattersburg Sports Club 
源赖朝	Gen Yoshi 
石田良辅	Ishida Ryosuke 
捷克总统	President of the Czech Republic 
石姬皇女	Princesse Kura no Way 
2010年夏季青年奥林匹克运动会	2010 Summer Youth Olympic Games 
地中海运动会足球比赛	Mediterranean Games football match 
中国（上海）自由贸易试验区管理委员会	China (Shanghai) Pilot Free Trade Zone Management Committee 
游戏机历史_(第八世代)	Game console history_ (eighth generation) 
巴黎政治学院	Paris School of Political Sciences 
都柏林高级研究学院	Dublin Institute of Advanced Studies 
上海市曹杨第二中学	Shanghai Caoyang Second Middle School 
社会运动	Social movement 
原始乌拉尔语	Primitive Ural 
.ba	Put 
韩国第一夫人	First lady of korea 
小寺氏	Mr. Kodera 
李相浩	Lee Sangho 
张伯仁_(助理编导)	Zhang Boren_(Assistant Choreographer) 
荷兰角港	Cape Holland 
夏季青年奥林匹克运动会	Summer Youth Olympic Games 
合肥话	Hefei dialect 
耀中国际学校	Yew Chung International School 
明穆宗	Ming Mu Zong 
藤堂高虎	Todo Takatora 
中国人民解放军空军军衔	Air Force Rank of the Chinese People's Liberation Army 
侄滨车站	Nephew station 
卢学洙	Lu Xuezhu 
列宁格勒-大诺夫哥罗德攻势	Leningrad-Veliky Novgorod offensive 
帕罗奥多研究中心	Palo Alto Research Center 
潮汕地区	Chaoshan area 
尼泊尔三星足球会	Nepal Samsung Football Club 
雅德维加_(波兰国王)	Jadwiga_ (King of Poland) 
伊斯兰阿萨德大学	Islamic Assad University 
布加勒斯特经济研究学院	Bucharest Institute of Economic Studies 
共和-社会党	Republican-Socialist Party 
西班牙国家航空	Iberia 
路径积分表述	Path integral expression 
乌鲁木齐地窝堡国际机场	Urumqi Diwopu International Airport 
鸡形目	Galliformes 
中共中央党校继续教育学院	School of Continuing Education of the Central Party School of the Communist Party of China 
esp音乐学院	esp conservatory 
纽波特_(怀特岛)	Newport_ (Isle of Wight) 
尼罗河河口海战	Battle of the Nile Estuary 
android历史版本	android historical version 
海军司库	Navy treasurer 
zeuhl	count 
卯木浩二	Koji Unoki 
维合部队	Peacekeeping force 
野岛一成	Nojima Issei 
素可泰王国	Kingdom of Sukhothai 
英国驻马来亚高级专员	British High Commissioner in Malaya 
弗兰克·希尔兹_(俄勒冈州政治人物)	Frank Shields_ (Oregon political figure) 
约翰娜_(黑森-达姆施塔特)	Johanna_ (Hesse-Darmstadt) 
阿道夫_(卢森堡大公)	Adolphe_ (Grand Duke of Luxembourg) 
爱情上路	Love on the road 
国立台湾大学	National Taiwan University 
英士国际商学院	Ince International Business School 
周旭明	Zhou Xuming 
大久保择生	Toshio Okubo 
洪孟启	Hong Mengqi 
前191年	191 years ago 
八度空间_(电视台)	Octave Space_ (TV station) 
萨克森统治者列表	List of rulers of Saxony 
点阵图图像编辑器	Bitmap image editor 
联合统计区	Union Statistical Area 
萨福克公爵夫人约克的伊丽莎白	Elizabeth of York, Duchess of Suffolk 
香港国际机场	Hongkong International Airport 
里贾纳	Regina 
风捎来的信	Letter from the wind 
勋一等	Xun Yi Deng 
党卫队国家安全部	SS Ministry of National Security 
洪荣狄	Hong Rongdi 
寿常在	Resident 
一千日圆纸币	One Thousand Yen Notes 
明治维新	the Meiji Reform 
皇家工程院	Royal Academy of Engineering 
奥德萨的墨妲	Moda of Odessa 
攻击中场	Attack midfielder 
幸田町	Kota Town 
永隆通宝	Wing Lung Tong Bao 
胡安二世_(阿拉贡)	Juan II_ (Aragon) 
岛津量子	Shimadzu Quantum 
新世界_(电视剧)	New World_(TV series) 
柬埔寨国家银行	National Bank of Cambodia 
中华人民共和国铁路运输	People's Republic of China Railway Transport 
混合理论	Hybrid theory 
奥费赖塞尔省	Oferessel 
阿莉亚·宾特·侯赛因公主	Princess Alia Bent Hussein 
阿拉贡的珊莎	Sansa of Aragon 
大潭山郊野公园	Tai Tam Shan Country Park 
软件包管理系统	Package management system 
太平洋联盟	Pacific Alliance 
曼城狂热	Manchester City Fever 
达祖丁	Dazudin 
摩纳哥王位继承人	Heir to the Monaco Throne 
伊里奥特弗八世	Iliott VIII 
联邦党	Federal Party 
刘玉圣	Liu Yusheng 
冯嘉奇	Feng Jiaqi 
吴文楚	Wu Wenchu 
nhk交响乐团	nhk symphony orchestra 
惯性上层助推器	Inertial upper booster 
神乐_(银魂)	Kagura_ (Gintama) 
坎伯韦尔和佩卡姆_(英国国会选区)	Camberwell and Peckham (UK Parliamentary District) 
莱卡特_(澳大利亚国会选区)	Leichart_ (Australian Parliamentary Constituency) 
.uy	.uy 
西班牙足球地区联赛	Spanish Football Regional League 
印第安纳大学布卢明顿分校	Indiana University Bloomington 
万大溪	Wan Daxi 
张继钢	Zhang Jigang 
尚卢·高达	Shanlu Gundam 
柏萨士邦	Persas 
樱桃小丸子	Chibi Maruko 
schizoanalysis	schizoanalysis 
世界大学联系网	World University Network 
遍历理论	Ergodic theory 
王宪奎	Wang Xiankui 
大型多人在线角色扮演游戏	Massively multiplayer online role-playing game 
让-马里·洛维尔	Jean-Marie Lowell 
山谷球场	Valley Course 
杨受成	Yang Shoucheng 
查士丁尼二世	Justinian II 
北广岛町	Kitahiroshima 
青衣运动场	Tsing Yi Sports Ground 
加里巴尔迪-罗密欧·安科内塔尼体育场	Garibaldi-Romeo Anconnetani Stadium 
日本歌谣曲	Japanese Songs 
拉惹端姑赛布特拉	Raja Tuanku Saiputra 
.ni	.you 
太原市滨河体育中心	Taiyuan City Binhe Sports Center 
奥斯丁·温特里	Austin Wintry 
刘蕊瑄	Liu Ruixuan 
飓风竞技俱乐部	Hurricane Athletic Club 
后协里	Houxili 
主保圣人	Patron saint 
桥本拳人	Hashimoto Boxer 
廉威米特大学法学院	Lian Weimit University School of Law 
清华大学电机工程与应用电子技术系	Department of Electrical Engineering and Applied Electronic Technology, Tsinghua University 
哲学博士	philosophy doctor 
朴三求	Park Sangu 
朝鲜领导人列表	List of North Korean leaders 
大山里	Dashanli 
wwk竞技场	wwk arena 
李奥纳德·迪克	Leonard Dick 
冼少玲	Xian Shaoling 
醇亲王	Prince Alcohol 
阿哈罗诺夫－玻姆效应	Akharonov-Bohm effect 
范国平	Fan Guoping 
何南铨	He Nanquan 
矢田晃一	Koichi Yada 
水野昌盛	Mizuno Masamori 
维格纳-埃卡特定理	Wigner-Ekatheorem 
共主邦联	Confederacy 
荷兰省督	Dutch Governor 
王嘉慧	Wang Jiahui 
双语路标	Bilingual road signs 
波兰四月宪法	Polish April Constitution 
传令嘉奖	Commendation 
永田由纪	Nagata Yuki 
史大桢	Shi Dazhen 
我们一定行！	We must do it! 
宫城县旗	Flag of Miyagi Prefecture 
秦皇岛市奥体中心体育场	Qinhuangdao Olympic Sports Center Stadium 
伊朗航天局	Iranian Space Agency 
南京理工大学	Nanjing University of Science and Technology 
明十三陵	Ming Tombs 
神田站_(东京都)	Kanda Station_(Tokyo) 
轻摇滚	Light rock 
克里姆林宫红场墓园	Kremlin Red Square Cemetery 
本洲里	Honshuri 
塔里巴尔杜斯_(塔拉瓦)	Taribaldos_ (Tarava) 
加州州立大学	California State University 
菲律宾省份列表	List of provinces in the Philippines 
志贵皇子	Prince Zhigui 
李晋乐	Li Jinle 
utc-10	utc-10 
城市经理	City manager 
费扬果	Feyango 
赤皮青冈	Chipi Qinggang 
重成俊弥	Toshiya Shigenari 
模拟游戏	Simulation game 
西罗曼语言	West Roman Language 
好难得	very rare 
新墨西哥州第一国会选区	New Mexico's first congressional district 
菲律宾行政区划	Administrative divisions of the Philippines 
威尔斯顿区_(昆士兰州)	Wilston District_ (Queensland) 
维德角埃斯库多	Cape Verde Escudo 
基兰特语支	Kilante 
釜山航空	Air Busan 
军功勋章	Medal of Military Merit 
天津泰达投资控股	Tianjin TEDA Investment Holdings 
拉绍德封	La Chaux-de-Fonds 
氢燃料电池引擎	Hydrogen fuel cell engine 
马奥里奇·阿德里巴贝内	Maorić Adribabene 
荷兰总务部	Dutch Ministry of General Affairs 
特木科体育俱乐部	Temuco Sports Club 
南非边境战争	South African Border War 
u17世界杯足球赛	u17 World Cup 
车臣共和国国旗	Flag of the Chechen Republic 
拿破仑二世	Napoleon II 
.mz	.mz 
艾佛敦山区_(昆士兰州)	Everton Mountain_(Queensland) 
来自星星的你	You from the stars 
基尔岩球场	Kil Rock Stadium 
中天娱乐台	Zhongtian Entertainment Channel 
爱丁堡王家学会	The Royal Society of Edinburgh 
廖永来	Liao Yonglai 
吉塞拉_(女修道院院长)	Gisela_ (The Convent Dean) 
因戈尔施塔特足球俱乐部	Ingolstadt Football Club 
榎本达也	Tatsuya Enomoto 
狼队足球俱乐部	Wolves Football Club 
法国17岁以下国家足球队	France under-17 national football team 
最终幻想xiii-2	Final Fantasy xiii-2 
北非谍影	Bourne Africa 
美空云雀	Misora Skylark 
影视公司	Television Company 
美国空军部长	Secretary of the Air Force 
尼日利亚20岁以下国家足球队	Nigeria Under-20 National Football Team 
弗朗茨·斐迪南大公	Grand Duke Franz Ferdinand 
威廉·拜伦，第五代拜伦男爵	William Byron, the fifth Baron Byron 
一党专政	One-party dictatorship 
维克托·伊曼纽尔三世	Victor Emmanuel III 
剑桥大学校监	Supervisor of Cambridge University 
毁灭全人类	Destroy all mankind 
.np	.e.g 
佩德罗·德·阿尔坎塔拉王子（格劳-帕拉亲王）	Prince Pedro de Alcantara (Prince Grau-Para) 
巴贝多中央银行	Central Bank of Barbados 
沙姆阵线	Sham Front 
徐爵民	Xu Juemin 
流体动力学	Hydrodynamics 
斯洛伐克共和国_(1939-1945)	Slovak Republic_(1939-1945) 
谭穗铭	Tan Suiming 
北欧理事会	Nordic council 
先锋派音乐	Avant-garde music 
织田信吉	Oda Shinyoshi 
康边停战协定	Kang Bien Armistice Agreement 
葛芬唱片	Geffen Records 
糊涂查理	Confused Charlie 
让-弗朗索瓦·伊齐	Jean-Francois Itzi 
阿尔巴尼亚王国	Kingdom of Albania 
川野直辉	Naoki Kawano 
音乐下载	music download 
沙勒罗瓦球场	Charleroi Stadium 
日本筝	Japanese koto 
电影演员	Movie actor 
伊斯坦布尔赛车场	Istanbul Motor Speedway 
法西斯大议会	Fascist council 
攻击直升机	Attack helicopter 
拉姆拉和约	Ramla Treaty 
板垣退助	Itagaki Resuke 
财政政策	Fiscal policy 
阿克斯胡斯城堡	Akershus Castle 
观点主义	Opinionism 
乾隆帝次女	Second daughter of Emperor Qianlong 
朱诺_(罗马神话)	Juno_ (Roman Mythology) 
卡托拿	Catona 
科尔多瓦学院足球俱乐部	Cordoba Academy Football Club 
黄海南道	South Huanghai Road 
珠海站	Zhuhai Railway Station 
犹太-伊拉克阿拉伯语	Jewish-Iraqi Arabic 
斯坦尼斯瓦夫·波尼亚托夫斯基_(1676-1762)	Stanislaw Poniatowski (1676-1762) 
国防大学_(中华民国)	National Defense University_(Republic of China) 
卡斯提亚-拉曼查	Castilla-La Mancha 
华登舒特足球俱乐部	Walden Schutt Football Club 
匈牙利国民议会	Hungarian national assembly 
韩美洵	Han Meixun 
珠光宝气_(电视剧)	Jewelry_ (TV series) 
clavinet	clavinet 
比林语	Biling 
背式键盘	Back keyboard 
国立台湾师范大学附属高级中学	High School Affiliated to National Taiwan Normal University 
东风11g型柴油机车	Dongfeng 11g diesel locomotive 
k/o纸制品制片公司	k/o paper production company 
里奇兰镇区_(哈维县)	Richland Township_(Harvey County) 
欧洲俄罗斯	Europe Russia 
上网本	Netbook 
一条忠香	Ichijo Tadaka 
联合发射同盟	United Launch Alliance 
梁再冰	Liang Zaibing 
意大利议会	Italian Parliament 
全俄罗斯苏维埃代表大会	All-russian soviet congress 
墨西哥银行	Bank of Mexico 
自旋统计定理	Spin statistics theorem 
玛嘉烈公主_(斯诺登伯爵夫人)	Princess Margaret_ (Countess Snowdon) 
日本之铁道站	Japan Railway Station 
肯特迈克尔王妃殿下	Her Royal Highness Princess Michael of Kent 
霍斯特·威塞尔之歌	Song of Horst Wiesel 
约翰·安德生，第一代韦弗利子爵	John Anderson, the first Viscount Waverley 
人声盒子	Vocal box 
cbs互动	cbs interaction 
lormont	lormont 
柏林市长	Mayor of Berlin 
格式塔学派	Gestalt School 
东京放送	Tokyo Broadcasting 
魏恭帝	Wei Gongdi 
ea-18g咆哮者电子作战机	ea-18g Growler electronic combat aircraft 
安地卡及巴布达独立日	Antigua and Barbuda Independence Day 
玛丽·瓦莱里女大公	Grand Duchess Marie Valerie 
皇学研究所	Imperial Academy 
slac国家加速器实验室	slac National Accelerator Laboratory 
重装机兵4_月光的歌姬	Heavy Pilot 4_ Moonlight Diva 
宣皇后	Queen Xuan 
张庆黎	Zhang Qingli 
荷兰独立宣言	Dutch Declaration of Independence 
刘惠如	Liu Huiru 
extraphone	extraphone 
橘郡风云集数列表	List of Orange County Fengyun Episodes 
特步国际	Xtep International 
保加利亚足球乙级联赛	Bulgarian Football Second Division 
多明宫	Dominic Palace 
里士满_(维吉尼亚州)	Richmond_ (Virginia) 
呼和浩特体育局	Hohhot Sports Bureau 
开城特级市	Kaesong Super City 
保利耕辅	Kosuke Hori 
中立议员	Neutral Member 
赵永洪	Zhao Yonghong 
东姑安南	Tunku Annan 
阿莉亚·宾特·海珊公主	Princess Alia Bent Haysanne 
和硕和顺公主	Princess and princess 
莱佛士书院	Raffles Institution 
聂瑞平	Nie Ruiping 
北岛康介	Kitajima Kosuke 
国家能源局	National Energy Board 
姚引良	Yao Yinliang 
后金属	Post metal 
俞大维	Yu Dawei 
比科尔区	Bicol 
沙一博	Sha Yibo 
乌克兰国家安全局	National Security Service of Ukraine 
高木善朗	Takagi Yoshiro 
标致雪铁龙pf1平台	Peugeot Citroen pf1 platform 
坦克雷多·内维斯	Tancredo Neves 
阿尔汉格尔斯克教堂	Arkhangelsk church 
新加坡布政司	Chief Secretary of Singapore 
英联邦关系大臣	Secretary of State for Commonwealth Relations 
蒙古足球中心	Mongolia Football Center 
古典大学	Classical University 
日本民主党执行部	Executive Department of the Democratic Party of Japan 
库尔德斯坦社群团体	Kurdistan Community Group 
.ao	.Oh 
缅甸总理	Prime Minister of Myanmar 
耶律齐	Yeluzi 
爱德华·本廷克勋爵	Lord Edward Bentinck 
昭莫多之战	Battle of Zhaomodo 
拾点音乐	Pick up some music 
加藤清史郎	Seishiro Kato 
演化生物学	Evolutionary biology 
采昌国际多媒体	Caichang International Multimedia 
神探两个半又二分之一之学校有鬼	Detective two and a half and one half of the school has ghosts 
柬埔寨国家元首列表	List of Cambodian Heads of State 
查哥里	Chagori 
刘玉山	Liu Yushan 
贺军翔	He Junxiang 
后弗萨克文	Post-Fosak 
ammochostos	ammochostos 
变质岩	Metamorphic rock 
伊朗副总统	Vice President of Iran 
宪政革命	Constitutional revolution 
耶稣圣名主教座堂	Cathedral of the Holy Name of Jesus 
中谷诚一	Shoichi Nakatani 
兄弟姊妹	brothers and sisters 
东广岛市	Higashihiroshima City 
莫汤保	Mo Tangbao 
kandıra	trick 
阿萨巴斯卡-埃雅克语族	Athabasca-Eyak 
大韩民国第1步兵师	1st Infantry Division of the Republic of Korea 
文艺复兴绘画	Renaissance painting 
夏威夷元	Hawaiian Dollar 
废止核电	Abolish nuclear power 
底特律都会韦恩县机场	Detroit Metropolitan Wayne County Airport 
常熟话	Changshu 
俄罗斯足球甲级联赛	Russian Football League 
神奈川县旗	Flag of Kanagawa Prefecture 
商业经济学	Business economics 
喻虹渊	Yu Hongyuan 
石井启一	Ishii Keiichi 
财经部（柬埔寨）	Ministry of Finance (Cambodia) 
小泉朋英	Tomohide Koizumi 
住棚节	Sukkot 
变频器	Frequency converter 
普通潜鸟	Common loon 
贝托尔德_(巴登)	Berthold_ (Baden) 
韩明淑	Han Mingshu 
杉崎由绮琉	Sugisaki Yukiru 
李智雅	Li Zhiya 
谢尔盖·索科洛夫（元帅）	Sergei Sokolov (Marshal) 
伯克利县_(南卡罗来纳州)	Berkeley County_ (South Carolina) 
秘鲁足球乙级联赛	Peru Football League Two 
瓦尔登_(科罗拉多州)	Walden_ (Colorado) 
潘惠子	Pan Huizi 
中华人民共和国外交部发言人	Spokesperson of the Ministry of Foreign Affairs of the People's Republic of China 
贵州省新体育场	Guizhou New Stadium 
公民自由意志主义	Civil libertarianism 
伊拉克总理	Prime Minister of Iraq 
让-克里斯托福·布利恩	Jean-Christopher Brian 
河滨县_(加利福尼亚州)	Riverside County_ (California) 
杨加	Yang Jia 
叙利亚镑	Syrian Pound 
游戏配乐	Game soundtrack 
韦姓	Wei Surname 
九宝石勋章	Nine Jewels Medal 
仁和里_(仁武区)	Renheli_(Renwu District) 
北安普顿大学	University of Northampton 
校园摇滚	Campus rock 
西北高加索语系	Northwestern Caucasus 
美国演员工会奖最佳男主角	Screen Actors Guild Awards for Best Actor 
百年遗产	Centennial Legacy 
东孟-高棉语支	Dongmeng-Khmer branch 
瑞典副首相	Deputy Prime Minister of Sweden 
图尔的阿德莱德	Adelaide in Tours 
民族共产主义	National communism 
伦敦塔总管	Tower of London Explorer 
加奥拿斯	Gaonas 
中国大陆	China Mainland 
苏格兰中尉区	Lieutenant District of Scotland 
柏油脚跟	Tar Heel 
中视经典台	China Television Classic 
杜玉波	Du Yubo 
天天有乐町	Everyday Yurakucho 
徳川圀顺	Tokugawa Kuniyuki 
.si	.four 
哈夫纳夫约杜尔体操俱乐部	Hafnarfjordur Gymnastics Club 
英国皇家天文学会	Royal Astronomical Society 
基督工党	Christian Labor Party 
后朋克	Post-punk 
波兰王国总督列表	List of Governors of the Kingdom of Poland 
后乡里	Houxiangli 
河床竞技俱乐部	River Plate Athletics Club 
索末菲-柯色耳位移定律	Sommerfeld-Coseer Displacement Law 
firewind	firewind 
西奈半岛打撃武装分子行动	Operation Sinai against militants 
中非洲足球总会联会	Central African Football Association 
盐谷瞬	Shiotani 
西西里晚祷	Sicilian Vespers 
中国中央电视台世界地理频道	China Central Television World Geography Channel 
多人连线游戏	Multiplayer online game 
环境运输及区域大臣	Minister of Environment, Transport and Regions 
文学批评	Literary criticism 
爱德华王子_(威塞克斯伯爵)	Prince Edward_ (Earl of Wessex) 
王华麟	Wang Hualin 
国防科学技术大学	National University of Defense Technology 
葡萄牙总理列表	List of Prime Ministers of Portugal 
查理·德·瓦卢瓦昂古莱姆公爵	Duke Charlie de Valois Angoulême 
新传媒高清5频道	New Media HD Channel 5 
中国核工业集团公司	China National Nuclear Corporation 
弗雷德里克·巴斯夏	Frederick Bastiat 
阪口梦穗	Mizuho Sakaguchi 
艾贾徐体育会	Ai Jiaxu Sports Club 
旧金山湾区捷运系统	San Francisco Bay Area Rapid Transit System 
好莱坞唱片	Hollywood Records 
曼恩伯爵领	Earl of Mann 
苏沃洛夫勋章	Suvorov Medal 
造王者_(电视剧)	King Maker_ (TV series) 
巴斯克地区旗帜	Flag of the Basque Country 
最大似然估计	Maximum likelihood estimation 
石原里纱	Risa Ishihara 
克里语音节文字	Kerry syllable text 
伊萨卡_(纽约州)	Ithaca_ (New York State) 
澳大利亚反对党领袖列表	List of Australian opposition leaders 
游辉凯	You Huikai 
国际足联国家代码列表	List of FIFA country codes 
巴拉克宰王朝	Balakzai Dynasty 
斯洛伐克总理	Prime Minister of Slovakia 
世界气象组织	World Meteorological Organization 
湖南省人民体育中心	Hunan Provincial People's Sports Center 
石原慎一	Shinichi Ishihara 
波兰瑞典战争_(1620年-1622年)	Polish-Swedish War_ (1620-1622) 
河北精英足球俱乐部	Hebei Elite Football Club 
海南话白话字	Hainanese vernacular characters 
古林将太	Shota Kobayashi 
东方和非洲研究学院	School of Oriental and African Studies 
澳洲圣公会	Australian Anglican Church 
于再清	Yu Zaiqing 
印度联合会杯	Confederations Cup of India 
广州正一	Guangzhou Zhengyi 
奇迹时代	Age of miracles 
赤星政尚	Masanao Akahoshi 
元上都	Yuan Shangdu 
塞浦路斯足球协会	Cyprus Football Association 
姜-泰勒效应	Ginger-Taylor effect 
aerozine	aerozine 
咸海-里海语支	Aral-Caspian 
威廉二世足球俱乐部	William II Football Club 
查尔斯·康沃利斯，第二代康沃利斯侯爵	Charles Cornwallis, the second Marquis of Cornwallis 
三河岛站	Sanhedao Station 
王蒙徽	Wang Menghui 
马英九政府	Ma Ying-jeou government 
江户手球歌ⅱ	Edo Handball Song ⅱ 
中华人民共和国海关总署	General Administration of Customs of the People's Republic of China 
马来西亚宗教	Religion in Malaysia 
教宗杜努	Pope Dunou 
松井谦弥	Matsui Kenya 
德国国防部	German Ministry of Defense 
香港伤残人士体育协会	Hong Kong Sports Association for the Disabled 
义大利外交部长	Minister of Foreign Affairs of Italy 
宜妃_(康熙帝)	Concubine Yi_(Kangxi Emperor) 
美国远征军	American Expeditionary Force 
老挝建国阵线	Lao National Front 
马中骏	Ma Zhongjun 
上古日语	Ancient Japanese 
仓田英之	Hideyuki Kurata 
勒内·沙龙	Rene Sharon 
g5超级精英大学	g5 super elite university 
宗教保守主义	Religious conservatism 
河南建业	Henan Jianye 
费米国立加速器实验室	Fermi National Accelerator Laboratory 
终极动员令_(1995年游戏)	Ultimate Mobilization Order_ (1995 game) 
肥婆奶奶扭计媳	Fat grandmother 
圣若瑟英文中学	St. Joseph's English Secondary School 
美国航空中心球馆	American Airlines Center Arena 
默多克镇区_(巴特勒县)	Murdoch Township_(Butler County) 
岛屿唱片	Island record 
斯坦默的佩勒姆男爵	Baron Pelham of Steinmer 
臼井仁志	Hitoshi Usui 
美国海军陆战队司令	Commander of the U.S. Marine Corps 
罗海晴	Luo Haiqing 
南部国务卿	Southern Secretary of State 
成田国际机场	Narita International Airport 
midi键盘	midi keyboard 
德国元帅列表	List of German Marshals 
第32届香港电影金像奖	The 32nd Hong Kong Film Awards 
韦圣心	Wei Shengxin 
第1骑兵师	1st Cavalry Division 
希尔斯波罗县_(新罕布什尔州)	Hillsboro County_ (New Hampshire) 
\ufeff宋龙	\ufeff Song Long 
那珂川町_(福冈县)	Nakagawa Town_(Fukuoka Prefecture) 
多多马	Dodoma 
家庭主妇	housewife 
中国邮政储蓄银行	China Postal Savings Bank 
曾伟	Zeng Wei 
廖启智	Liao Qizhi 
七剑2	Seven Swords 2 
第二次波尔战争	Second Boer War 
葡萄牙足球丙级联赛	Portuguese Football League C 
中央军事委员会科学技术委员会	Science and Technology Committee of the Central Military Commission 
诺基亚高端技术	Nokia high-end technology 
白仓政司	Masashi Shirahiro 
mp4	mp4 
海伦芬体育俱乐部	Heerenveen Sports Club 
民主行动党秘书长	Secretary-General of the Democratic Action Party 
温布莱球场	Wembley Stadium 
庇护二世	Pius II 
l.j.p.m._(leon)_frissen	l.j.p.m._(leon)_frissen 
西安西关机场	Xi'an Xiguan Airport 
铃木大地	Suzuki Land 
卢津定理	Luzin's Theorem 
刘嘉壁	Liu Jiabi 
米契尔顿_(昆士兰州)	Mitchelton_ (Queensland) 
韶山冲毛泽东同志故居	Shaoshan Chong Former Residence of Comrade Mao Zedong 
牙买加总督	Governor of Jamaica 
阿拉伯解放运动	Arab liberation movement 
心星的泪光	Tears of Heart Star 
.fi	.be 
塞内帕河战争	Senepah War 
市郊铁路	Suburban railway 
苏联成立条约	Treaty of Formation of the Soviet Union 
新曼谷国际机场	New Bangkok International Airport 
德国u18足球代表队	Germany U18 National Football Team 
吠檀多	Vedanta 
潘杰_(篮球经理)	Pan Jie_(Basketball Manager) 
塞尔维亚历史	Serbian history 
梅登黑德_(英国国会选区)	Maidenhead_(British Parliamentary District) 
堤格雷竞技俱乐部	Tigre Athletic Club 
西班牙邮递区号	Spain postal code 
西班牙23岁以下国家足球队	Spain U23 National Football Team 
染矢一树	Someya Kazuki 
贾邱	Jia Qiu 
a1大奖赛	a1 Grand Prix 
第一次梵蒂冈大公会议	First Vatican Conference 
山田信道	Yamada Nobumichi 
巴雷罗斯球场	Barreiros Stadium 
摩西湖市_(华盛顿州)	Moses Lake City_ (Washington State) 
太空牛仔_(音乐家)	Space Cowboy_ (musician) 
市民银行球场	Citizens Bank Stadium 
亚特兰大勇士	Atlanta Warriors 
隅泽克之	Sumize Kezhi 
詹姆斯·弗格森爵士，第六代从男爵	Sir James Ferguson, sixth generation from Baron 
第25军_(日本陆军)	25th Corps_ (Japanese Army) 
阿盖尔公爵	Duke of Argyll 
武汉宏兴足球俱乐部	Wuhan Hongxing Football Club 
埃列娜公主_(罗马尼亚)	Princess Elena_ (Romania) 
沙地阿拉伯足球协会	Saudi Arabia Football Association 
张雷_(足球裁判)	Zhang Lei_ (Football Referee) 
津田琢磨	Tsuda Takuma 
日本七叶树	Horse chestnut 
非执行董事	Non-Executive Director 
裴梦蝶	Pei Mengdie 
环星娱乐	Huanxing Entertainment 
1931年西敏法令	Westminster Act 1931 
兰州西站	Lanzhou West Railway Station 
我孙子市	My grandson city 
西武铁道	Seibu Railway 
泰华拿	Thai Huana 
英式金属新浪潮	New Wave of British Metal 
松田弘	Hiroshi Matsuda 
路易斯·蒙巴顿，第一代缅甸的蒙巴顿伯爵	Louis Mountbatten, the first Earl of Mountbatten of Myanmar 
南美以美大学	South American University of America 
都督部	Governor's Department 
王睿_(台湾足球运动员)	Wang Rui_ (Taiwan Football Player) 
施浩然_(助理编导)	Shi Haoran_(Assistant Choreographer) 
布鲁内尔大学	Brunel University 
瓜地马拉银行	Bank of Guatemala 
加利福尼亚州州参议员	California State Senator 
法国足球丙级联赛	French Football League C 
铜锤手	Copper Hammer 
地理物理学	Geophysics 
武良布枝	Nunoe Mura 
赵孟𫖯	Zhao Meng𫖯 
凌伟光	Ling Weiguang 
陆大章	Lu Dazhang 
英国君主配偶列表	List of spouses of British monarchs 
它山堰	Tashanyan 
叶梨信行	Nobuyuki Kanonashi 
贺毅辉	He Yihui 
nba年度最佳新秀	NBA Rookie of the Year 
陈振川	Chen Zhenchuan 
放羊的星星	Sheep star 
峇吉里	Bhagiri 
捷克斯洛伐克第一军团	Czechoslovak First Army 
阿尔巴尼亚总理列表	List of Prime Ministers of Albania 
四川隆发足球俱乐部	Sichuan Longfa Football Club 
佛山高明第一中学	Foshan Gaoming First Middle School 
成田良悟	Ryogo Narita 
长沙金德	Changsha Jinde 
麦杜渥区_(昆士兰州)	McDowell District_ (Queensland) 
范登堡空军基地2号航天发射复合体	Vandenberg Air Force Base 2 Space Launch Complex 
嘶吼唱腔	Roar 
剑桥伯爵	Earl of Cambridge 
.in	.in 
bahçeköy	Bahçeköy 
西班牙16岁以下国家足球队	Spain Under-16 National Football Team 
相信音乐	Believe in music 
越智通雄	Michio Ochi 
最游记	Zuiyouji 
西班牙哈布斯堡王朝	Habsburgs of Spain 
西北工业大学	Northwestern Polytechnical University 
长征二号f运载火箭	Long March 2 f carrier rocket 
勒期人	Leche 
铃置洋孝	Suzuki Yotaka 
池田圭	Ikeda Kei 
火线猎杀2	Hunting 2 
全国人民代表大会常务委员会秘书长	Secretary General of the Standing Committee of the National People's Congress 
市场姬	Market Hime 
批判理论	Critical theory 
伊是名村	Yi Shi Ming Village 
克娄巴特拉·塞勒涅二世	Cleopatra Selene II 
哥斯大黎加大学	University of Costa Rica 
姆拉达-博莱斯拉夫	Mlada Boleslav 
维克多·奥宾拿	Victor Obina 
东海地方	East China Sea 
翡翠名曲汇	Jade Famous Songs 
新加坡外交部	Singapore Ministry of Foreign Affairs 
行星科学	Planetary science 
悲梦之歌/我俩…	Song of Sad Dreams/We... 
贝尔格大公国	Grand Duchy of Berg 
希拉克略_(君士坦斯二世之子)	Heraclius_ (son of Constantine II) 
飞鸟时代	Asuka Age 
郑雨盛	Zheng Yusheng 
波莫纳加州州立理工大学	California State Polytechnic University, Pomona 
古典时代	Classical age 
贝塔尔耶路撒冷足球俱乐部	Betar Jerusalem Football Club 
印度帝国勋章	Order of the Indian Empire 
德国联邦内政部	German Federal Ministry of the Interior 
我是歌手_(第一季)	I am a singer_ (season one) 
伊斯兰黄金时代	Islamic golden age 
中华里_(仁武区)	Zhonghuali_(Renwu District) 
冰岛航空	Icelandair 
ac-130空中炮艇	ac-130 aerial gunboat 
好汉两个半_(第七季)	Two and a half heroes_ (season 7) 
中国人民解放军陆军	Chinese People's Liberation Army Army 
暗黑血统ii	Darksiders II 
金丝手套	Gold gloves 
天津市耀华中学	Tianjin Yew Wah Middle School 
墨西哥独立战争	Mexican War of Independence 
国家语言文字工作委员会	National Language Working Committee 
台北市立石牌国民中学	Taipei Shipai National High School 
捷克独立日	Czech Independence Day 
南什列斯威选民联盟	South Shlesway Voters League 
中国共产党第十二届中央委员会	The 12th Central Committee of the Communist Party of China 
反修正主义	Anti-revisionism 
爱尔兰足球代表乙队	Irish Football Team B 
加纳20岁以下国家足球队	Ghana Under-20 National Football Team 
多多良敦斗	Tatara 
魁北克音乐	Quebec Music 
国民政府主席	Chairman of the National Government 
代代木神园町	Yoyogi Jinencho 
莱诺·丁尼生，第三代丁尼生男爵	Leno Tennyson, the third Baron Tennyson 
沈家门	Shenjiamen 
吴庆瑞	Wu Qingrui 
加鲁阿棉花运动足球俱乐部	Garua Cotton Sports Football Club 
dorsten	thirst 
诗丽吉王后	Queen Sirikit 
席哈克略王朝	Sehakli Dynasty 
欧洲保守派和改革主义者	European conservatives and reformists 
巴隆郡政府	Baron County Government 
弗罗西诺内	Frosinone 
高野光司	Koji Takano 
水川麻美	Mizukawa Asami 
milstar	milstar 
螺丝小姐要出嫁	Miss Screw is getting married 
简体中文	Simplified Chinese 
松平家治	Matsudaira Ieharu 
蒙特勒伊_(塞纳-圣但尼省)	Montreuil_ (Seine-Saint-Denis) 
徐庆钟	Xu Qingzhong 
阿布扎比酋长国酋长	Emirate of Abu Dhabi 
圣艾蒂安足球俱乐部	Saint Etienne Football Club 
skravena	shortened 
行政区政府主席	Chairman of the District Government 
胡丕福	Hu Pifu 
爱与兽	Love and beast 
猎人谷自治市	Hunter Valley Municipality 
罗清泉	Luo Qingquan 
列维达	Levida 
利奥波德二世_(比利时)	Leopold II_ (Belgium) 
凡尔赛足球俱乐部	Versailles Football Club 
悫惠皇贵妃	Royal Concubine Chi Hui 
伊斯兰恐怖主义	Islamic terrorism 
约阿希姆·绍尔	Joachim Sauer 
张美妮	Zhang Mini 
神庙遗址圣母堂	Church of Our Lady of the Temple Ruins 
北京师范大学珠海分校	Beijing Normal University, Zhuhai 
mit台湾志	mit Taiwan History 
魏孝静帝	Emperor Wei Xiaojing 
德国福音教派	German Evangelicals 
余绍祺	Yu Shaoqi 
编译语言	Compiled language 
科布伦茨足球俱乐部	Koblenz Football Club 
希腊大区	Greece 
法外风云	Extrajudicial Storm 
.lu	.road 
岩屋毅	Takeshi Iwaya 
叶子菁	Ye Ye Jing 
自然科学	Natural sciences 
超市夜未眠	Sleepless in the supermarket 
约翰·庞森比，第四代贝斯伯勒伯爵	John Ponsonby, 4th Earl of Besborough 
世界女子手球锦标赛	World Women's Handball Championship 
金后衍	Jin Houyan 
shock!	shock! 
魔法少女	Magical girl 
苏格兰地方政府	Scottish local government 
kbs月火迷你连续剧	kbs moonfire miniseries 
.ne	.born 
李公蕴	Li Gongyun 
玛理诺一世	Marino I 
噶尔丹策零	Galdan Tser 
从一位	From one 
汉诺瓦王朝	Hanoi Dynasty 
台湾统治者	Ruler of Taiwan 
步兵第13联队	13th Infantry Wing 
查塔姆_(肯特郡)	Chatham_(Kent) 
耶路撒冷围城战_(1244年)	Siege of Jerusalem_ (1244) 
宇多田照实	Teruzane Utada 
东三条院	Tosanjoin 
伊斯兰议会	Islamic Council 
长冈京	Nagaokakyo 
中国共产党中央书记处	Secretariat of the Communist Party of China 
联合航空制造公司	United Aviation Manufacturing Company 
八大第一台	Eight first 
木管乐器	Woodwind instrument 
秋山暮霭图	Autumn Mountain Evening Haze 
比利时行政区划	Administrative divisions of Belgium 
波士尼亚战争	Bosnian War 
法式浩室	Legal House 
北大年府	Pattani House 
王君正	Wang Junzheng 
曹活明	Cao Huoming 
非洲人国民大会妇女联盟	African National Congress Women's Union 
今川义元	Imagawa Yoshimoto 
中华民国海军	Republic of China Navy 
倪桂珍	Ni Guizhen 
英国驻德国大使	British Ambassador to Germany 
多玩	Play more 
玛丽亚·皮亚_(两西西里，1849－1882)	Maria Pia_ (Two Sicily, 1849-1882) 
变体假名	Variant pseudonym 
艾因阿拉伯	Al Ain Arab 
vydas_gedvilas	vydas gedvilas 
利比亚绿色革命	Libya Green Revolution 
亚洲电视	Asia Television 
bd邮区	bd postal area 
胶冷杉	Gum fir 
第三代剑桥伯爵科尼斯堡的理查	Richard of Königsberg, 3rd Earl of Cambridge 
中国共产党安徽省委员会	Anhui Provincial Committee of the Communist Party of China 
艾莉安娜_(荷兰公主)	Ariana_ (Dutch Princess) 
越南国家女子足球队	Vietnam National Women's Football Team 
中国人民政治协商会议第九届全国委员会委员名单	List of members of the Ninth National Committee of the Chinese People's Political Consultative Conference 
大多喜町	Otaki Town 
黄眉姬鹟	Yellow-browed Flycatcher 
海牙体育场	The Hague Stadium 
贝伦加尔一世	Belengar I 
连震东	Lian Zhendong 
米尔顿镇区_(马里昂县)	Milton Township_ (Marion County) 
捷克斯洛伐克军团	Czechoslovak Legion 
光盘单曲	CD single 
埃森博阿国际机场	Esenboga International Airport 
黄金海岸机场	Gold Coast Airport 
仁者侠医	Benevolent doctor 
斯洛文尼亚共产主义者联盟	Slovenian Communist League 
中野裕太	Yuta Nakano 
伊朗参议院	Iranian Senate 
莲花乐队	Lotus 
阿梅迪奥·茨沃尼米尔_(奥斯塔公爵)	Amedio Zvonimir_ (Duke of Aosta) 
特斯科科_(墨西哥州)	Tescoco_ (State of Mexico) 
穆罕默德·查希尔沙	Mohamed Zahirsha 
千叶道德	Chiba Morality 
苏格兰议会议员	Member of the Scottish Parliament 
福克兰群岛行政长官	Chief Executive of the Falkland Islands 
.py	.py 
滨田_水辉	Hamada_Shuihui 
朱里亚·克劳狄王朝	Julia Claudius 
经典电动力学	Classical electrodynamics 
红冠蕉鹃	Red Turaco 
宇野实彩子	Uno Mikako 
国际商管学院促进协会	International Business School Promotion Association 
瑛太	Eita 
御厨贵文	Royal Kitchen Guiwen 
吴慧潾	Wu Hyelin 
尚永王	King Shang Yong 
第18空降军	18th Airborne Corps 
查尔斯·沃森-文特沃斯	Charles Watson-Wentworth 
密西西比大学叛逆者	University of Mississippi Rebel 
涿郡	Zhuojun 
潭底里	In the bottom of the pond 
金泽慎	Kanazawa 
维多利亚女皇	Queen Victoria 
武田广	Takeda Hiroshi 
开源软件	Open source software 
宾夕法尼亚州议会	Pennsylvania State Assembly 
南斯拉夫统治者列表	List of rulers of Yugoslavia 
斯坦尼斯劳斯县_(加利福尼亚州)	Stanislaus County_ (California) 
托雷斯德韦雷连	Torres de Verelian 
村井仁	Jin Murai 
中华民国历史	History of the Republic of China 
瑞士法郎	Swiss franc 
尼尔·珀维斯和罗伯特·韦德	Neil Purvis and Robert Wade 
所意	Intended 
.pg	.pg 
小森美果	Mika Komori 
慈宫皇太后	Empress Dowager Ci Gong 
周子娱乐	Zhouzi Entertainment 
华盛顿州州长官邸	Governor's Residence of Washington State 
北格拉斯哥_(英国国会选区)	North Glasgow_(British Parliamentary District) 
自治领事务大臣	Minister of dominion affairs 
逻辑原子论	Logical atomism 
固伦恪靖公主	Princess Gulun Kejing 
河井阳介	Shosuke Kawai 
rheinenergiestadion	rheinenergiestadion 
自由战士	Freedom fighter 
阿卜杜尔·贾法尔·普林戈迪格多	Abdul Jafar Prigodigedo 
时代杂志封面人物列表	List of People on the Cover of Time Magazine 
中国电子科技集团	China Electronics Technology Group 
中储券	China Reserve Voucher 
转子莲	Rotor lotus 
大雄山线	Daxiongshan Line 
美国足球协会	United States Football Association 
唯及纳太阳	Only accept the sun 
亨廷顿伯爵	Earl of Huntington 
科特迪瓦足球甲级联赛	Cote d'Ivoire Football League 
高加索诸民族	Caucasus Nations 
内布拉斯加州第三国会选区	Nebraska Third Congressional District 
通识通通识	General knowledge 
朱镜褀	Zhu Jingzhen 
南占语支	Nanzhan 
staaienveld	standing field 
高木义成	Takagi Yoshiari 
嵯峨尚子	Naoko Saga 
李亨民	Li Hengmin 
鲍家街43号	43 Baojia Street 
家用游戏机	Home game console 
乔治亚独立日	Georgia Independence Day 
桃园天皇	Emperor Taoyuan 
前寛之	Hiroyuki Mae 
卡罗尔一世	Carol I 
生日快乐_(电视剧)	Happy Birthday_ (TV series) 
salacgriva	salacgriva 
豪华轿车	Luxury car 
前222年	222 years ago 
湾内里	Bay Uchiri 
姜异康	Jiang Yikang 
数码下载	Digital download 
萨迪·伊尔马克	Sadie Ilmark 
好赞回转寿司！	Great sushi conveyor belt! 
梅克伦堡-什未林-亚历山德琳娜	Mecklenburg-Schwerin-Alexandrina 
汤加潘加	Tongan Panga 
比利时国家铁路	Belgian National Railway 
刘湘屏	Liu Xiangping 
f*	f* 
刘芷恒	Liu Zhiheng 
何直轩	He Zhixuan 
战争机器	war machine 
中华人民共和国教育部直属高等学校列表	List of colleges and universities directly under the Ministry of Education of the People's Republic of China 
新北市私立金陵女子高级中学	New Taipei City Private Jinling Girls High School 
欧洲民族	European nations 
绒毛白蜡	Fluff white wax 
企业资源计划	Enterprise Resource Planning 
西班牙的共产党	Communist Party of Spain 
美国参议院司法委员会	U.S. Senate Judiciary Committee 
铃木政二	Suzuki Masuji 
坎特柏里之声	Canterbury Voice 
中华人民共和国名誉主席	Honorary Chairman of the People's Republic of China 
也门国徽	National Emblem of Yemen 
费迪南多·玛利亚_(两西西里)	Ferdinando Maria_ (Two Sicily) 
青年工党	Youth Labor Party 
仁礼景范	Nire Kagenori 
武冈优斗	Uto Wugang 
颜国梁	Yan Guoliang 
佩鲁贾足球俱乐部	Perugia Football Club 
伏尔加联邦管区	Volga Federal District 
卡佩伦_(比利时)	Capellen_(Belgium) 
美国家庭滑稽录像	American Family Funny Videos 
火影忍者动画集数列表	Naruto animation episode list 
南格拉斯哥_(英国国会选区)	South Glasgow_(British Parliamentary District) 
工学学士	Bachelor of Engineering 
相模女子大学	Sagami Women's University 
尚卡尔·达亚尔·夏尔马	Shankar Dayal Sharma 
爪哇海	Java Sea 
兄弟斗争	Brotherhood fight 
端顺固伦公主	Princess Duan Shun Gu Lun 
蔡赴朝	Cai Fuchao 
饶舌歌手	Rapper 
勃艮第的亨利	Henry of Burgundy 
失恋33天_(电视剧)	33 days of broken love _ (TV series) 
法国矿业团	French Mining Group 
蒙大拿州立大学	Montana State University 
山口区_(昆士兰州)	Yamaguchi District_(Queensland) 
美国住房及城市发展部	U.S. Department of Housing and Urban Development 
英雄日	Hero day 
刘智玲	Liu Zhiling 
蒲田车站	Kamata Station 
意大利社会党	Italian Socialist Party 
代代木上原站	Yoyogi Uehara Station 
波罗的语族	Baltic languages 
方素敏	Fang Sumin 
.fj	.fj 
s:中华民国宪法	s: Constitution of the Republic of China 
启蒙时期哲学家	Enlightenment philosopher 
湾里里	In the bay 
中国人民政治协商会议第七届全国委员会委员名单	List of members of the Seventh National Committee of the Chinese People's Political Consultative Conference 
中国共产党山东省委员会	Shandong Provincial Committee of the Communist Party of China 
马克西米利安一世_(神圣罗马帝国)	Maximilian I_ (Holy Roman Empire) 
日本国旗	Japanese flag 
工业噪音	Industrial noise 
胜利勋章	Victory Medal 
几何反照率	Geometric albedo 
弗吉尼亚大学法学院	University of Virginia School of Law 
日野业子	Hino Nariko 
金斯顿城足球俱乐部	Kingston City Football Club 
威廉·弗莱明_(澳大利亚政治家)	William Fleming_ (Australian politician) 
威廉五世_(奥兰治)	William V_ (Orange) 
伊野尾慧	Ino Oke 
摩尔多瓦议会	Moldova Parliament 
拉姆贝斯华伦球场	Lambeth Warren Stadium 
盖尔曼矩阵	Gellman matrix 
奥林匹克运动会	Olympic Games 
比利时19岁以下国家足球队	Belgium Under-19 National Football Team 
托勒密七世	Ptolemy VII 
小川谅也	Ryoya Ogawa 
同德女子高等学校	Dongdeok Girls' High School 
武田铁矢	Takeda Tetsuya 
塞纳河畔埃皮奈	Epigny-sur-seine 
四个女仔三个bar	Four girls and three bars 
爱尔兰国家足球乙队	Ireland National Football Team 
乔治·罗伯逊，埃伦港的罗伯逊男爵	George Robertson, Baron Robertson of Port Ellen 
歌曲创作者	Song creator 
仁青加	Renqingjia 
忆江南	Recalling Jiangnan 
织田信友	Oda Shinto 
冲佳苗	Chong Jiamiao 
.bw	.bw 
佟佳氏	Tong Jiashi 
李又兰	Li Youlan 
第1航空舰队_(德国空军)	1st Air Fleet_ (German Air Force) 
柏立基教育学院	Bailiji Education College 
军械总局局长	Director of the General Bureau of Ordnance 
徐琴一	Xu Qinyi 
清水邦广	Shimizu Banghiro 
能登有沙	Arisa Noto 
全国人民大会党	National People's Congress Party 
巴基斯坦卢比	Pakistani Rupee 
王菲最精彩的演唱会	Faye Wong's most exciting concert 
德国联邦副总理	Deputy Chancellor of the Federal Republic of Germany 
埃德蒙·都铎_(萨默塞特公爵)	Edmund Tudor (Duke of Somerset) 
陈愚忠	Chen Yuzhong 
苹果咬一口	Apple bite 
7人制（脑瘫）足球	7-a-side (cerebral palsy) football 
美国陆军部部长	Secretary of the Army 
朝阳区	Chaoyang District 
后樱町天皇	Empress Go-Sakura 
全国力量联盟	National Power Alliance 
芬兰人	Finn 
西村弘司	Koji Nishimura 
燕号列车	Yan Train 
互动娱乐	Interactive entertainment 
加藤顺大	Kato Juntai 
2014/15赛季欧洲冠军联赛	2014/15 UEFA Champions League 
法国农业部	French Ministry of Agriculture 
杰普逊公司	Jepson co. 
皮罗特劳动者足球俱乐部	Pirot Laborers Football Club 
中国国家足球二队	China National Football Team 
智头町	Chizucho 
格洛纳斯系统	GLONASS System 
新民主同盟	New Democratic League 
丹麦首相	Prime Minister of Denmark 
苏日边界冲突	Soviet-Japanese border conflict 
高姓	Gao Surname 
湖山游乐场	Hushan Playground 
无浪潮	No wave 
独家追辑	Exclusive Collection 
片桐顺一郎	Jin Katagiri 
武术指导	Martial arts coach 
利奇菲尔德_(英国国会选区)	Lichfield_(British Parliamentary District) 
联合国经济及社会理事会	United Nations Economic and Social Council 
唐宁街十号	Ten Downing Street 
梅里比亚体育俱乐部	Meribia Sports Club 
团结党_(拉脱维亚)	Solidarity Party_ (Latvia) 
第一届哈达内阁	The First Hatta Cabinet 
香港岛各界联合会	Hong Kong Island Federation of All Sectors 
野田明弘	Akihiro Noda 
伏见宫博明王	King Hiromi Fushimi 
穆阿威叶一世	Muawiyah I 
意大利人民党	Italian people's party 
罗马尼亚社会民主党	Romanian Social Democratic Party 
英国-阿散蒂战争	British-Ashanti War 
东长安街	East Chang'an Avenue 
梁崇勋	Liang Chongxun 
havok引擎	havok engine 
颜志行	Yan Zhixing 
约翰·弗伦奇，第一代伊普尔伯爵	John French, the first Earl of Ypres 
裴育文	Pei Yuwen 
义大利外交部	Italian Ministry of Foreign Affairs 
福冈软银鹰	Fukuoka SoftBank Hawk 
圣灵家族	Holy spirit family 
俄罗斯空天防卫军	Russian Air and Space Defense Force 
萨高域	Sagofield 
布莱顿穹顶宫_(英国国会选区)	Brighton Dome_(British Parliamentary District) 
邵逸夫奖	Shaw Prize 
最终幻想v	Final Fantasy v 
第二次中东战争	Second Middle East War 
电台广播	Radio broadcast 
nordvest_f.c.	nordvest_f.c. 
太阳娱乐文化	Sun Entertainment Culture 
郭民英	Guo Minying 
东斯拉夫人	Eastern Slavs 
尾身幸次	Koji Omi 
aikido	aikido 
狮子芯片	Lion chip 
乌捷保	Utebao 
国家税务总局	State Administration of Taxation 
新文艺复兴建筑	Neo-renaissance architecture 
迈阿密马林鱼	Miami marlins 
英国地方政府	British local government 
拉脱维亚甲组足球联赛	Latvia First Division Football League 
动态脚本	Dynamic script 
checkmate!	checkmate! 
澳大利亚移民局	Australian immigration 
薛仁贵传奇	The Legend of Xue Rengui 
联邦院副主席	Vice Chairman of the Federal Chamber 
艾力克斯·詹姆斯_(音乐家)	Alex James_ (musician) 
手持式装置	Handheld device 
英国电影	British Film 
秘鲁保护国	Protectorate of Peru 
面向对象	Object-oriented 
海底两万里	20,000 miles under the sea 
一级方程式赛车	Formula One 
青年民主者联盟	League of Young Democrats 
日本地理分区	Geographical Division of Japan 
庇护三世	Pius III 
梁美京	Liang Meijing 
荒川稔久	Naruhisa Arakawa 
软体公司	Software company 
贵格会	Quaker 
第3骑兵团第3中队	3rd Squadron, 3rd Cavalry Regiment 
嘉定体育场	Jiading Stadium 
成都谢菲联足球俱乐部	Chengdu Sheffield United Football Club 
章亚若	Chang Ya-juo 
国立东华大学	National Dong Hwa University 
随选视讯	Video on demand 
英国君主列表	List of British monarchs 
苏格兰足球丙级联赛	Scottish Football League C 
福岛宏之	Fukushima Hiroyuki 
梅克伦堡县_(北卡罗莱纳州)	Mecklenburg County_ (North Carolina) 
canal+	channel + 
中国共产党湖南省委员会	Hunan Provincial Committee of the Communist Party of China 
顿涅茨克国立大学	Donetsk State University 
则子女王	Queen Zeko 
柳下正明	Masaaki Yanagishita 
曼谷大学足球俱乐部	Bangkok University Football Club 
胜田夏子	Natsuko Hikita 
新明和工业	Xinminghe Industry 
世界棒垒球联盟	World Baseball and Softball League 
就是娜精选辑	Jina Collection 
中央精神文明建设指导委员会办公室	Office of the Central Spiritual Civilization Construction Steering Committee 
江田五月	Satsuki Eda 
胡塞武装组织	Houthi armed groups 
新·大雄的日本诞生	The birth of a new Nobita in Japan 
武汉话	Wuhan dialect 
纽约马拉松	New York Marathon 
尚比亚摇滚	Zambian Rock 
印第安纳州各县列表	List of counties in Indiana 
best★scandal	bestscandal 
朗之万方程	Langevin equation 
里奥阿维	Rio Avi 
品牌长	Brand leader 
冈山里	Okayama 
约翰·福尔摩斯_(英国外交家)	John Holmes_ (British diplomat) 
吕莳媛	Lu Shiyuan 
阿布哈兹人	Abkhazian 
拆局专家	Demolition expert 
行政中心	government centre 
前232年	232 years ago 
python软体基金会	python software foundation 
伊朗国会	Iranian Congress 
超弦理论	Superstring theory 
福村贵幸	Fukumura Takayuki 
中古波兰语	Middle Polish 
昭宪王后	Queen Zhaoxian 
顾依丽	Gu Yili 
法兰西学术院	French Academy 
斯洛文尼亚议会	Slovenian Parliament 
cω	cω 
河南街道_(延吉市)	Henan Street_(Yanji City) 
清朝内阁总理大臣	Prime Minister of the Qing Dynasty 
香港五元硬币	Hong Kong Five Dollar Coin 
星际异攻队	Interstellar Team 
让-巴蒂斯特·菲利贝尔·瓦扬	Jean-Baptiste Filibere Vayan 
圣约翰区_(安提瓜和巴布达)	St. John's District_ (Antigua and Barbuda) 
埃及法老列表	List of Egyptian Pharaohs 
森山真弓	Mayumi Moriyama 
台湾客家语	Taiwanese Hakka 
铁路运输	Rail transport 
章国明	Cheung Kuniaki 
分子生物学实验室	Molecular Biology Laboratory 
杜自持	Du Zizhi 
广益中学	Guangyi Middle School 
水青冈	Shuiqinggang 
莱瓦迪亚克斯足球俱乐部	Levadiax Football Club 
乌克兰希腊礼天主教会	Ukrainian Greek Catholic Church 
巴黎高师	Paris Normal University 
纽埃议会	Niue Assembly 
德岛县旗	Tokushima Prefecture Flag 
法恩扎	Faenza 
库图佐夫勋章	Order of Kutuzov 
五邑司徒浩中学	Wuyi Situ Hao Middle School 
卡塔尔国家足球队	Qatar National Football Team 
奥加布足球俱乐部	Ogabe Football Club 
湾流v型	Gulfstream V 
.lt	.lt 
中部海岸海员	Central Coast Seaman 
unicameral	unicameral 
护士助手	Nurse's assistant 
恋爱兵法	Love Art of War 
邓文成	Deng Wencheng 
英国单曲排行榜	UK Singles Chart 
马场隆博	Takahiro Maiba 
波莱尔－坎泰利引理	Boller-Cantelli Lemma 
中央印制厂	Central Printing Factory 
宝鼎勋章	Baoding Medal 
瑞穗银行	Mizuho Bank 
.pt	.pt 
吉野裕行	Hiroyuki Yoshino 
和硕敦恪公主	Princess Hesothon 
达德利·赖德，第一代哈罗比伯爵	Dudley Ryder, the first Earl of Harrowby 
莫斯塔尔大学	University of Mostar 
新英格兰爱国者	New England Patriots 
管理咨询	Management Consulting 
苏帕查加塞球场	Supacha Gasse Stadium 
国防部参谋本部	Department of Defense Staff Headquarters 
中华民国国旗	Flag of the Republic of China 
欧洲大学学院	European University College 
武藤水华	Mutoh bloom 
电容式感应	Capacitive sensing 
紫心勋章	Purple Heart 
联邦调查局学院	FBI Academy 
千叶大学	Chiba University 
华特迪斯尼动画工作室	Walt Disney Animation Studio 
中葡联合声明	Sino-Portuguese Joint Statement 
郝明莉	Hao Mingli 
印度总统列表	List of Presidents of India 
韩剧台	Korean Drama Channel 
普鲁士的卢维莎·乌尔里卡	Luvisa Ulrika of Prussia 
埃诺的菲利帕	Philippa of Hainaut 
吴沚默	Wu Yunmo 
白汉成	Bai Hancheng 
阿莱_(加尔省)	Alay_(Gar) 
沈晓明	Shen Xiaoming 
奥林匹克体育中心-运动场	Olympic Sports Center-Sports Ground 
杰西·卡麦可	Jesse Kamek 
拉里默尔县_(科罗拉多州)	Larimer County_(Colorado) 
禾列锡	Helex 
sbs特别剧	sbs special drama 
横路集团	Henglu Group 
丹斯里	Tan Sri 
第二次塞米诺尔战争	Second Seminole War 
后发座	Back seat 
副热带湿润气候	Humid subtropical climate 
库鲁拉航空	Kurula Airlines 
保坂一成	Kazunari Hosaka 
日本23岁以下足球代表队	Japan Under-23 Football Team 
周恭帝	Zhou Gongdi 
恩主教书院	En Bishop College 
白俄罗斯足球总会	Belarusian Football Association 
台视hd台	TTV hd 
高度都市化城市	Highly urbanized city 
喜悦dana	Joy dana 
南川体育中心	Nanchuan Sports Center 
英国内阁	British Cabinet 
一袋女王	Bag queen 
file:emperor_kangxi.png	file:emperor_康熙.PNG 
奥斯卡最佳原创音乐奖	Oscar for Best Original Music 
琴浦小姐	Miss Qinpu 
万叶假名	Manyo Kana 
乌里亚特-喀尔喀分支	Uryat-Kalkha branch 
误伤_(穹顶之下)	Injury_(under the dome) 
埃阿喀得斯王朝	Acadian Dynasty 
三星火灾海上保险	Samsung Fire & Marine Insurance 
罗马足球俱乐部	Roma Football Club 
根本由美	Simply Yumi 
李铭中	Li Mingzhong 
俄波战争_(1654年－1667年)	Russian-Polish War_ (1654-1667) 
钱宝网	Qianbao 
俄土战争	Russian-Turkish War 
古列斯坦皇宫	Gulistan Palace 
哈希姆王子	Prince Hashim 
利比亚国徽	Libya National Emblem 
灵山中学	Lingshan Middle School 
爱民顿	Edmonton 
伊豆之国市	Izunokuni City 
长春大众卓越女子足球俱乐部	Changchun Volkswagen Excellence Women's Football Club 
何塞·马蒂先锋组织	Jose Marti Pioneer Organization 
丛林流浪	Jungle wandering 
法维拉_(阿斯图里亚斯)	Favila (Asturias) 
斯特拉斯堡城市社区	Strasbourg City Community 
世界女排大奖赛	World Women's Volleyball Grand Prix 
斯里兰卡独立日	Sri Lanka Independence Day 
凤林里	Fenglinli 
日本佛教	Japanese Buddhism 
民主主义者联盟	Democrats League 
塔尼特选区	Taney District 
山岳日光节约时间	Mountain daylight saving time 
陈十三	Chen Shisan 
法国王后和皇后列表	List of queens and queens of France 
逆转经脉	Reverse meridian 
非常规战争	Unconventional war 
大洋洲语族	Oceanian Languages 
主人-奴隶道德说	Master-slave morality 
尤因塔县_(犹他州)	Uintah County_ (Utah) 
艾里西耶足球俱乐部	Alisiya Football Club 
tórsvøllur	tórsvøllur 
迷糊餐厅	Messy restaurant 
柬埔寨独立日	Cambodia Independence Day 
比奇特尔公司	Beechtel 
刘玉珠	Liu Yuzhu 
大学联合招生办法	University joint admissions method 
公民力量	Civic power 
柏好文	Bai Haowen 
胡志明少年先锋队	Ho Chi Minh Youth Pioneer 
生驹吉乃	Kitsuno Yoshino 
圣约翰大学	St. John's University 
俄罗斯联邦主体	Subject of the Russian Federation 
区法官	District Judge 
摩加迪沙之战	Battle of Mogadishu 
宇佐美贵史	Takashi Usami 
文学小说	Literary novel 
诺森比亚伯爵	Earl of Northumbria 
中国人民解放军海军航空兵	Chinese People's Liberation Army Naval Aviation 
詹姆士·盖斯科因-塞西尔，第四代索尔斯伯利侯爵	James Gascoyne-Cecile, 4th Marquis of Salisbury 
上智大学	Sophia University 
利涅亲王	Prince Ligne 
克里米亚国徽	National Emblem of Crimea 
徐濠萦	Xu Haoying 
虎斑☆恐龙王	Tabby☆Dinosaur King 
噶隆人	Karon 
加纳时男	Ghanaian 
胡志明思想	Ho Chi Minh Thought 
夏季残奥会田径比赛	Summer Paralympic Track and Field Competition 
卡波_(土莱达)	Capo_ (Tuleida) 
蓝调唱片	Blues Records 
中央国家安全委员会	Central National Security Council 
伊斯兰原教旨主义	Islamic Fundamentalism 
file:清_佚名_《清太祖天命皇帝朝服像》.jpg	file:Qing _ Anonymous_ "Portrait of Emperor Taizu's Royal Court Clothes".jpg 
矢立肇	Yatate Hajime 
静园_(北京大学)	Jingyuan_(Peking University) 
上海中优房地产集团	Shanghai Zhongyou Real Estate Group 
武吉帕弓	Bukit Pa Bow 
伊文思_(英国外交官)	Evans_ (British diplomat) 
御三卿	Yu Sanqing 
古川元久	Motohisa Furukawa 
卿云歌	Qing Yunge 
越南国会	Vietnam National Assembly 
德国19岁以下国家足球队	Germany under-19 national football team 
搜索引擎	search engine 
印度共和国宪法	Constitution of the Republic of India 
步兵第7联队	7th Infantry Wing 
伊斯兰革命信徒协会	Islamic Revolutionary Believers Association 
耶律大石	Yelu Dashi 
天主教洛杉矶总教区	Catholic Archdiocese of Los Angeles 
永阪勇人	Hayato Nagasaka 
