中华人民共和国	People's Republic of China 
中华民国	Republic of China 
现代标准汉语	Modern Standard Chinese 
伊丽莎白二世	Elizabeth II 
节奏布鲁斯	Rhythm and Blues 
朝鲜语	Korean 
另类摇滚	Alternative rock 
日本国家足球队	Japan National Football Team 
欧洲足球协会联盟	UEFA 
流行摇滚	Pop rock 
英格兰足球代表队	England National Football Team 
利物浦足球俱乐部	Liverpool Football Club 
曼彻斯特联足球俱乐部	Manchester United Football Club 
英格兰21岁以下足球代表队	England Under-21 Football Team 
哈佛大学	Harvard University 
电视广播有限公司	Television Broadcast Co., Ltd. 
皇家马德里足球俱乐部	Real Madrid Football Club 
切尔西足球俱乐部	Chelsea Football Club 
阿森纳足球俱乐部	Arsenal Football Club 
曼彻斯特城足球俱乐部	Manchester City Football Club 
荷兰国家足球队	Netherlands National Football Team 
西班牙国家足球队	Spain National Football Team 
中国共产党	Communist Party of China 
尤文图斯足球俱乐部	Juventus Football Club 
韩国国家男子足球队	South Korea National Men's Football Team 
硬式摇滚	Hard rock 
法国国家足球队	France National Football Team 
巴西国家足球队	Brazil National Football Team 
拜仁慕尼黑足球俱乐部	Bayern Munich Football Club 
广州恒大淘宝足球俱乐部	Guangzhou Evergrande Taobao Football Club 
国际米兰足球俱乐部	Inter Milan Football Club 
印欧语系	Indo-European 
巴塞罗那足球俱乐部	FC Barcelona 
丹麦国家足球队	Denmark National Football Team 
中国国家奥林匹克足球队	China National Olympic Football Team 
美国联邦最高法院大法官列表	List of U.S. Supreme Court Justices 
德国国家足球队	German National Football Team 
美国参议院	United States Senate 
sm娱乐	sm entertainment 
华盛顿哥伦比亚特区	Washington, D.C 
意大利国家足球队	Italy National Football Team 
俄罗斯帝国	Russian Empire 
苹果公司	Apple 
教皇国	Papal State 
丹麦21岁以下国家足球队	Denmark Under-21 National Football Team 
c++	c++ 
2015年中国足协杯	2015 Chinese Football Association Cup 
葡萄牙国家足球队	Portugal National Football Team 
托特纳姆热刺足球俱乐部	Tottenham Hotspur Football Club 
2013年中国足协杯	2013 Chinese Football Association Cup 
中国国家足球队	China National Football Team 
2014年中国足协杯	2014 Chinese Football Association Cup 
倖田来未	Koda Kumi 
英国首相	British Prime Minister 
索尼音乐娱乐	Sony Music Entertainment 
纽卡斯尔联足球俱乐部	Newcastle United Football Club 
西班牙21岁以下国家足球队	Spain Under-21 National Football Team 
剑桥大学	Cambridge University 
阿贾克斯足球俱乐部	Ajax Football Club 
普林斯顿大学	Princeton University 
澳洲国家足球队	Australia National Football Team 
瑞典国家足球队	Swedish national football team 
克罗地亚国家足球队	Croatia National Football Team 
上海绿地申花足球俱乐部	Shanghai Greenland Shenhua Football Club 
阿根廷国家足球队	Argentina National Football Team 
西汉姆联足球俱乐部	West Ham United Football Club 
南斯拉夫社会主义联邦共和国	Socialist Federal Republic of Yugoslavia 
马德里竞技俱乐部	Atletico Madrid 
2012年中国足协杯	2012 Chinese Football Association Cup 
美国陆军	U.S. Army 
爱尔兰共和国	Republic of Ireland 
香港足球代表队	Hong Kong National Football Team 
巴黎圣日耳曼足球俱乐部	Paris Saint-Germain Football Club 
重金属音乐	heavy metal music 
里斯本与本菲卡体育俱乐部	Lisbon and Benfica Sports Club 
捷克国家足球队	Czech National Football Team 
德国21岁以下国家足球队	Germany Under-21 National Football Team 
汉藏语系	Sino-Tibetan 
勒沃库森足球俱乐部	Leverkusen Football Club 
瑞士国家足球队	Swiss National Football Team 
华纳音乐集团	Warner Music Group 
斯图加特足球俱乐部	Stuttgart Football Club 
富勒姆足球俱乐部	Fulham Football Club 
埃弗顿足球俱乐部	Everton Football Club 
罗马体育俱乐部	Sports Club of Rome 
多特蒙德足球俱乐部	Dortmund Football Club 
华纳兄弟唱片公司	Warner Bros. Records 
苏联共产党	Communist Party of the Soviet Union 
哥伦比亚大学	Columbia University 
巴伦西亚足球俱乐部	Valencia Football Club 
加州大学柏克莱分校	University of California, Berkeley 
中华民国_(大陆时期)	Republic of China_(Mainland Period) 
亚洲足球联合会	Asian Football Federation 
摩纳哥体育会足球会	Monaco Athletic Club Football Club 
psv燕豪芬	psv Yanhaofen 
台湾话	Taiwanese 
山东鲁能泰山足球俱乐部	Shandong Luneng Taishan Football Club 
美国国家足球队	United States National Football Team 
沙尔克04足球俱乐部	Schalke 04 Football Club 
国家大学体育协会	National University Sports Association 
法国21岁以下国家足球队	France Under-21 National Football Team 
哥伦比亚国家足球队	Colombia National Football Team 
乔治五世	George V 
哥伦比亚唱片	Columbia Records 
比利时国家足球队	Belgium national football team 
尼日利亚国家足球队	Nigeria National Football Team 
日耳曼语族	Germanic 
英格兰足球超级联赛	English Premier League 
麻省理工学院	Massachusetts Institute of Technology 
维京唱片	Viking Records 
荷兰21岁以下国家足球队	Netherlands Under-21 National Football Team 
波尔图足球俱乐部	Porto Football Club 
萨克森-科堡-哥达王朝	Saxon-Coburg-Gotha Dynasty 
桑德兰足球俱乐部	Sunderland Football Club 
俄罗斯正教会	Russian Orthodox Church 
拉素体育会	Russell Sports Club 
2016年中国足协杯	2016 Chinese Football Association Cup 
习近平	Xi Jinping 
西班牙省份	Spanish provinces 
波斯尼亚和黑塞哥维那国家足球队	Bosnia and Herzegovina National Football Team 
2001–02年欧洲足协杯	2001-02 UEFA Cup 
意大利语族	Italian 
佛罗伦萨足球俱乐部	Florence football club 
俄罗斯苏维埃联邦社会主义共和国	Russian Soviet Federal Socialist Republic 
墨西哥国家足球队	Mexico National Football Team 
江苏苏宁足球俱乐部	Jiangsu Suning Football Club 
布莱克本流浪者足球俱乐部	Blackburn Rovers Football Club 
沃尔夫斯堡足球俱乐部	Wolfsburg Football Club 
日本内阁总理大臣	Prime Minister of Japan 
北京人和足球俱乐部	Beijing Renhe Football Club 
罗曼语族	Romance 
芝加哥大学	University of Chicago 
英属香港	British Hong Kong 
披头四乐队	The Beatles 
马赛奥林匹克	Marseille Olympics 
乌拉圭国家足球队	Uruguay National Football Team 
加拉塔沙雷体育会	Galatasaray Sports Club 
欧足联欧洲联赛	UEFA Europa League 
jive唱片公司	jive record company 
喀麦隆国家足球队	Cameroon National Football Team 
希腊国家足球队	Greece National Football Team 
凯尔特人足球俱乐部	Celtic Football Club 
那不勒斯足球俱乐部	Naples Football Club 
印度-伊朗语族	Indo-Iranian 
大英帝国勋章	Order of the British Empire 
义大利21岁以下国家足球队	Italy Under-21 National Football Team 
腓尼基字母	Phoenician 
耶鲁大学	Yale University 
罗曼诺夫王朝	Romanov Dynasty 
牛津大学	Oxford university 
南华足球队	South China Football Team 
南安普顿足球俱乐部	Southampton Football Club 
英格兰足球冠军联赛	English Football Champions League 
上海上港集团足球俱乐部	Shanghai SIPG Football Club 
美国财政部长	U.S. Secretary of the Treasury 
葡萄牙21岁以下国家足球队	Portugal Under-21 National Football Team 
汉堡体育俱乐部	Hamburg Sports Club 
俄罗斯人	Russian 
大连实德足球俱乐部	Dalian Shide Football Club 
2018年世界杯资格赛亚洲区第二轮	2018 FIFA World Cup Qualifiers Asian region second round 
瑞典21岁以下国家足球队	Sweden Under-21 National Football Team 
下议院领袖	Leader of the House of Commons 
中华台北男子足球代表队	Chinese Taipei Men's National Football Team 
乔治三世	George III 
中国国家青年足球队	China National Youth Football Team 
俄罗斯国家足球队	Russian national football team 
法国总理	Prime Minister of France 
欧洲人民党	European People's Party 
北京国安足球俱乐部	Beijing Guoan Football Club 
西布罗姆维奇足球俱乐部	West Bromwich Albion Football Club 
塞维利亚足球俱乐部	Sevilla Football Club 
塞尔维亚国家足球队	Serbia National Football Team 
印度各邦和中央直辖区	Indian states and central territories 
英格兰20岁以下足球代表队	England Under-20 Football Team 
门兴格拉德巴赫足球俱乐部	Monchengladbach Football Club 
前卫摇滚	Avant-garde rock 
杭州绿城足球俱乐部	Hangzhou Greentown Football Club 
大阪飞脚	Osaka Hikyaku 
苏格兰足球代表队	Scottish National Football Team 
科特迪瓦国家足球队	Ivory Coast National Football Team 
美国空军	United States Air Force 
奥地利国家足球队	Austrian National Football Team 
亚足联冠军联赛	AFC Champions League 
杰志体育会	Jiezhi Sports Club 
2007年亚足联冠军联赛	2007 AFC Champions League 
女王公园巡游者足球俱乐部	Queens Park Rangers Football Club 
斯洛文尼亚国家足球队	Slovenia National Football Team 
爱尔兰国家足球队	Ireland national football team 
意大利王国_(1861年–1946年)	Kingdom of Italy_ (1861-1946) 
柏林洪堡大学	Humboldt University of Berlin 
萨格勒布迪纳摩足球俱乐部	Dynamo Zagreb Football Club 
李克强	Li Keqiang 
比利亚雷亚尔足球俱乐部	Villarreal Football Club 
英格兰18岁以下足球代表队	England Under-18 Football Team 
爱尔兰21岁以下国家足球队	Ireland Under-21 National Football Team 
辽宁宏运足球俱乐部	Liaoning Hongyun Football Club 
英格兰足球甲级联赛	English Football League 
青岛中能足球俱乐部	Qingdao Zhongneng Football Club 
伊朗总理	Prime Minister of Iran 
圣彼得堡泽尼特足球俱乐部	Zenit St Petersburg Football Club 
美国国家航空航天局	National Aeronautics and Space Administration 
莱切斯特城足球俱乐部	Leicester City Football Club 
博尔顿足球俱乐部	Bolton Football Club 
迦纳国家足球队	Ghana National Football Team 
西里尔字母	Cyrillic 
柏林赫塔体育俱乐部	Hertha Sports Club Berlin 
香港流浪足球会	Hong Kong Wanderers Football Club 
法国君主列表	List of French monarchs 
巴塞尔足球俱乐部	Basel Football Club 
德国战车	German war vehicle 
斯托克城足球俱乐部	Stoke City Football Club 
广州富力足球俱乐部	Guangzhou R&F Football Club 
奥林匹克里昂	Olympic Lyon 
2004–05年欧洲足协杯	2004-05 UEFA Cup 
乔治六世	George VI 
2011年中国足协杯	2011 Chinese Football Association Cup 
大不列颠及爱尔兰联合王国	United Kingdom of Great Britain and Ireland 
伦敦政治经济学院	London School of Economics and Political Science 
保加利亚国家足球队	Bulgaria National Football Team 
斯洛伐克国家足球队	Slovak National Football Team 
深圳市足球俱乐部	Shenzhen Football Club 
云达不莱梅体育会	Werder Bremen Sports Association 
中国皇帝	Chinese emperor 
南北战争	American Civil War 
莫斯科迪纳摩足球俱乐部	Dynamo Moscow Football Club 
英国君主	British monarch 
费伦巴治体育会	Ferenbach Sports Club 
皇家标准列治	Royal Standard Rich 
匈牙利国家足球队	Hungary national football team 
行政院院长	President of the Executive Yuan 
史诗唱片	Epic Records 
英国奥林匹克足球队	British Olympic Football Team 
2012–13年欧洲联赛	2012-13 Europa League 
斯拉夫语族	Slavic 
瑞士21岁以下国家足球队	Switzerland Under-21 National Football Team 
大西洋唱片	Atlantic Records 
2008年至2009年西班牙国王杯	2008-2009 Copa del Rey 
爱德华七世	Edward VII 
蓝调摇滚	Blues rock 
克罗地亚21岁以下国家足球队	Croatian Under-21 National Football Team 
国王唱片	King Records 
索尼移动通信	Sony Mobile Communications 
任天堂ds	Nintendo ds 
新疆维吾尔自治区	Xinjiang Uygur Autonomous Region 
西班牙语言	Spanish 
威尔斯足球代表队	Wales National Football Team 
普鲁士王国	Kingdom of Prussia 
中华民国总统	President of the Republic of China 
大英国协大学协会	Association of Universities of Great Britain 
2015年至2016年德国足协杯	2015-2016 German Football Association Cup 
fifa系列	fifa series 
西班牙足球甲级联赛	Spanish Football League 
莫斯科火车头足球俱乐部	Lokomotiv Moscow Football Club 
法兰西第三共和国	Third French Republic 
中华台北奥运男子足球队	Chinese Taipei Olympic Men's Football Team 
天津泰达足球俱乐部	Tianjin TEDA Football Club 
全北现代汽车足球俱乐部	Jeonbuk Hyundai Motor Football Club 
中国足球协会超级联赛	China Football Association Super League 
哥本哈根足球会	Copenhagen Football Club 
育碧软件	Ubisoft 
csx运输	csx transport 
首尔足球俱乐部	Seoul Football Club 
热那亚板球与足球俱乐部	Genoa Cricket and Football Club 
芬兰国家足球队	Finland national football team 
皇家安德列治体育会	Royal Andrews Athletic Club 
巴斯勋章	Bath Medal 
蔚山现代足球俱乐部	Ulsan Hyundai Football Club 
雷丁足球俱乐部	Reading Football Club 
海湾战争	the Gulf War 
神户胜利船	Kobe Victory Ship 
波尔多足球俱乐部	Bordeaux Football Club 
大连一方足球俱乐部	Dalian Yifang Football Club 
法兰西王国	Kingdom of France 
英属印度	British India 
arm架构	arm architecture 
南美洲足球协会	South American Football Association 
罗马帝国	Roman Empire 
东京足球会	Tokyo Football Club 
法兰克福足球俱乐部	Frankfurt Football Club 
阿拉米字母	Aramaic 
沃特福德足球俱乐部	Watford Football Club 
米德尔斯堡足球俱乐部	Middlesbrough Football Club 
2014年亚足联冠军联赛	2014 AFC Champions League 
华纳兄弟	Warner Bros 
苏格兰21岁以下足球代表队	Scotland U21 National Football Team 
奥林匹亚科斯足球俱乐部	Olympiacos Football Club 
智利国家足球队	Chile National Football Team 
温莎王朝	Windsor Dynasty 
里尔奥林匹克体育会	Lille Olympic Games 
莫斯科斯巴达克足球俱乐部	Spartak Moscow Football Club 
让-雅克·卢梭	Jean-Jacques Rousseau 
少女时代	Girls Generation 
巴拉圭国家足球队	Paraguay National Football Team 
印度-雅利安语支	Indo-Aryan branch 
香港飞马足球会	Hong Kong Pegasus Football Club 
迷幻摇滚	Psychedelic rock 
江泽民	Jiang Zemin 
贝尔纳多特王朝	Bernadotte 
河南建业足球俱乐部	Henan Jianye Football Club 
挪威国家足球队	Norway national football team 
藏缅语族	Tibetan-Burman 
哥连泰斯保利斯塔体育会	Corrientes Paulista Sports Club 
德国足球甲级联赛	German Football League 
伊拉克战争	The Iraq War 
三星电子	Samsung Electronics 
朴茨茅斯足球俱乐部	Portsmouth Football Club 
英格兰17岁以下足球代表队	England Under-17 Football Team 
帕纳辛奈科斯足球俱乐部	Panathinaikos Football Club 
土耳其国家足球队	Turkey National Football Team 
浦和红钻	Urawa Red Diamonds 
乌迪内斯足球俱乐部	Udinese Football Club 
奥地利帝国	Austrian Empire 
诺里奇城足球俱乐部	Norwich City Football Club 
莫斯科中央陆军足球俱乐部	CSKA Moscow Football Club 
gnu通用公共许可证	gnu general public license 
斯旺西城足球俱乐部	Swansea City Football Club 
阿尔及利亚国家足球队	Algeria National Football Team 
大不列颠王国	Kingdom of Great Britain 
巴西总统	President of Brazil 
美国总统	America president 
意大利足球甲级联赛	Italian Football League 
波兰总理	Prime Minister of Poland 
汉诺威96足球俱乐部	Hannover 96 Football Club 
掌玺大臣	Minister of the Seal 
中华民国国语	Mandarin of the Republic of China 
慕尼黑大学	University of Munich 
独立摇滚	Indie rock 
磐田喜悦	Iwata Joy 
法国足球甲级联赛	French Football League 
哥斯达黎加国家足球队	Costa Rica National Football Team 
日本甲组职业足球联赛	Japan First Division Professional Football League 
英格兰足球乙级联赛	English Football League Two 
广西壮族自治区	Guangxi Zhuang Autonomous Region 
霍亨索伦王朝	Hohenzollern Dynasty 
2003–04年欧洲足协杯	2003-04 UEFA Cup 
让-保罗·萨特	Jean-Paul Sartre 
查尔顿竞技足球俱乐部	Charlton Athletic Football Club 
朝鲜民主主义人民共和国	Democratic People's Republic of Korea 
美国海军	U.S. Navy 
欧洲联盟	European Union 
苹果唱片	Apple Records 
rca唱片	rca record 
加州理工学院	California Institute of Technology 
南岛语系	Austronesian 
雷恩足球俱乐部	Rennes Football Club 
巴西足球甲级联赛	Brazilian Football League 
东日本旅客铁道	East Japan Railway 
圣米迦勒及圣乔治勋章	Order of St. Michael and St. George 
北京大学	Beijing University 
剑桥大学三一学院	Trinity College, Cambridge University 
广岛三箭	Sanfrecce Hiroshima 
中国足球协会甲级联赛	Chinese Football Association First Division 
日本20岁以下足球代表队	Japan Under-20 Football Team 
名古屋鲸鱼	Nagoya Whale 
小岛唱片	Island Records 
dc漫画	dc comics 
纳粹德国	Nazi Germany 
数码多功能影音光碟	Digital multi-function audio-visual disc 
比利时21岁以下国家足球队	Belgium Under-21 National Football Team 
生化危机系列	Resident Evil Series 
任天堂3ds	Nintendo 3ds 
巴黎大学	University of Paris 
美国职业足球大联盟	Major League Soccer 
美国副总统	Vice President of the United States 
西藏自治区	Tibet Autonomous Region 
鸿海科技集团	Hon Hai Technology Group 
赫尔城足球俱乐部	Hull City Football Club 
新传媒8频道	New Media Channel 8 
卡迪夫城足球俱乐部	Cardiff City Football Club 
决胜时刻系列	Decisive moment series 
2013–14年欧霸杯	2013-14 Europa Cup 
英国广播公司	BBC 
jyp娱乐	jyp entertainment 
卡纳维拉尔角空军基地	Cape Canaveral Air Force Base 
香港总督	Governor of Hong Kong 
香港奥运足球代表队	Hong Kong Olympic Football Team 
loen娱乐	loen entertainment 
流行朋克	Pop punk 
法国足球乙级联赛	French Football League 
荷兰足球甲级联赛	Dutch Football League 
1990–91年欧洲足协杯	1990–91 UEFA Cup 
英格兰足球联赛	English Football League 
就是在这里	Right here 
因戈尔施塔特04足球俱乐部	Ingolstadt 04 Football Club 
冰岛国家足球队	Iceland National Football Team 
2015年亚足联冠军联赛	2015 AFC Champions League 
阿拉伯联合酋长国	United Arab Emirates 
拖连奴足球会	Toulian Football Club 
威根竞技足球俱乐部	Wigan Athletic Football Club 
香港大学	Hong Kong university 
东方足球队	Oriental Football Team 
桑普多利亚足球俱乐部	Sampdoria Football Club 
德国十一月革命	German November Revolution 
水晶宫足球俱乐部	Crystal Palace Football Club 
布拉格斯巴达足球俱乐部	Sparta Prague Football Club 
中原官话	Central Plains Mandarin 
厄瓜多尔国家足球队	Ecuador national football team 
北爱尔兰足球代表队	Northern Ireland National Football Team 
西班牙足球乙级联赛	Spanish Football Second Division 
京都不死鸟f.c.	Kyoto Phoenix f.c. 
艺术摇滚	Art rock 
越南共产党	Communist Party of Vietnam 
浩室音乐	House music 
北爱尔兰21岁以下足球代表队	Northern Ireland Under-21 Football Team 
美因茨05足球俱乐部	Mainz 05 Football Club 
马拉加足球俱乐部	Malaga Football Club 
美国众议院	U.S. House of Representatives 
澳大利亚总理	Prime Minister of Australia 
天津权健足球俱乐部	Tianjin Quanjian Football Club 
诺贝尔物理学奖	Nobel Prize in Physics 
美国国务卿	U.S. Secretary of State 
日本乙组职业足球联赛	Japan Professional Football League 
重庆力帆足球俱乐部	Chongqing Lifan Football Club 
英国下议院	House of Commons 
水原三星蓝翼足球俱乐部	Suwon Samsung Blue Wings Football Club 
圣伊天体育会	Saint Yitian Sports Club 
以色列国家男子足球队	Israel National Men's Football Team 
欧登塞足球俱乐部	Odense Football Club 
c♯	c♯ 
摩洛哥国家足球队	Morocco National Football Team 
法国总统	President of France 
2011–12年欧洲冠军联赛	2011-12 UEFA Champions League 
英格兰足球代表乙队	England Football Team B 
全国人民代表大会	National People's Representative Meeting 
小保加体育会	Little Bulgarian Sports Association 
彭美拉斯体育会	Pamela Sports Club 
康奈尔大学	Cornell University 
长春亚泰足球俱乐部	Changchun Yatai Football Club 
阿尔巴尼亚国家足球队	Albania National Football Team 
基辅迪纳摩足球俱乐部	Dynamo Kyiv Football Club 
中古汉语	Middle Chinese 
印度北部	Northern india 
宏达国际电子	Hongda International Electronics 
高士路体育会	Cosway Sports Club 
俄罗斯总理	Prime Minister of Russia 
罗马尼亚国家足球队	Romania National Football Team 
温布利球场	Wembley Stadium 
圣保罗足球会	Sao Paulo Football Club 
桑托斯足球俱乐部	Santos Football Club 
鹿岛鹿角	Kashima Antlers 
密歇根大学	University of Michigan 
台湾日治时期	Taiwan during the Japanese Occupation 
皇家西班牙人体育俱乐部	Royal Espanyol Sports Club 
特温特足球俱乐部	Twente Football Club 
香港立法会	Hong Kong Legislative Council 
徐子珊	Xu Zishan 
悉尼足球俱乐部	Sydney Football Club 
谢菲尔德联足球俱乐部	Sheffield United Football Club 
虚幻引擎	Unreal Engine 
德国总理	German Chancellor 
清水心跳	Shimizu Heartbeat 
赵紫阳	Zhao Ziyang 
谢周三足球俱乐部	Sheffield Football Club 
windows商店	windows store 
工业金属	Industrial Metal 
诺丁汉森林足球俱乐部	Nottingham Forest Football Club 
皇家贝蒂斯足球俱乐部	Real Betis Football Club 
帕尔玛足球俱乐部	Parma Football Club 
河北华夏幸福足球俱乐部	Hebei China Fortune Football Club 
莫斯科国立大学	Moscow State University 
溏心风暴	Storm of Hearts 
阿富汗战争_(2001年)	Afghanistan War_ (2001) 
哈希姆家族	Hashim family 
洛杉矶湖人	Los Angeles Lakers 
葡萄牙足球超级联赛	Portuguese Premier League 
浙江毅腾足球俱乐部	Zhejiang Yiteng Football Club 
萨尔斯堡红牛足球俱乐部	Salzburg Red Bull Football Club 
硬核朋克	Hardcore punk 
漫威漫画	Marvel Comics 
阿尔伯特配亲王	Prince Albert 
俄国内战	Russian Civil War 
延边富德足球俱乐部	Yanbian Fude Football Club 
1999–00年欧洲冠军联赛	1999–00 UEFA Champions League 
英格兰足总杯	FA Cup 
非都市郡	Non-urban county 
英格兰王国	Kingdom of England 
拜占庭帝国	Byzantine Empire 
石家庄永昌足球俱乐部	Shijiazhuang Yongchang Football Club 
喀山红宝石足球俱乐部	Kazan Ruby Football Club 
溏心风暴之家好月圆	Heart of Heart Storm House, Good Moon 
贝西克塔斯体操俱乐部	Besiktas Gymnastics Club 
甘美奥阿雷格里港足球会	Cameo Porto Alegre Football Club 
东京电视台	Tokyo Television Station 
德国社会民主党	German Social Democratic Party 
繁体中文	traditional Chinese 
波兰君主列表	List of Polish monarchs 
法拉利车队	Ferrari Team 
乡村音乐	country music 
星空联盟	Star Alliance 
东京绿茵	Tokyo Verdant 
1983–84年欧洲足协杯	1983–84 UEFA Cup 
拉科鲁尼亚体育俱乐部	A Coruna Sports Club 
乔治四世	George IV 
穆罕默德-礼萨·巴列维	Muhammad-Reza Pahlavi 
夏伟林	Xia Weilin 
考文垂足球俱乐部	Coventry Football Club 
极品飞车系列	Need for Speed Series 
敲击金属	Percussion metal 
叙利亚字母	Syriac alphabet 
名媛望族	Celebrities 
弗拉基米尔·弗拉基米罗维奇·普京	Vladimir Vladimirovich Putin 
横滨水手	Yokohama Mariner 
城南足球俱乐部	Seongnam Football Club 
加州大学洛杉矶分校	UCLA 
上海申鑫足球俱乐部	Shanghai Shenxin Football Club 
微软lumia	Microsoft lumia 
大太监	Eunuch 
武汉卓尔职业足球俱乐部	Wuhan Zall Professional Football Club 
伊普斯维奇城足球俱乐部	Ipswich City Football Club 
拿破仑三世	Napoleon III 
塞尔维亚-克罗地亚语	Serbo-Croatian 
西班牙君主列表	List of Spanish monarchs 
萨德体育俱乐部	THAAD Sports Club 
巴塞隆拿足球会b队	FC Barcelona B team 
波兰国家足球队	Poland National Football Team 
皇家马略卡体育会	Royal Mallorca Sports Club 
paok足球俱乐部	paok football club 
德意志邦联	German Confederation 
英国上议院	House of Lords 
上议院领袖	Leader of the House of Lords 
微软工作室	Microsoft Studio 
乔治·寇松，第一代凯德尔斯顿的寇松侯爵	George Curzon, the Marquis of Curzon, the first generation of Kedleston 
2012－13年度香港甲组足球联赛	2012-13 Hong Kong First Division Football League 
洛杉矶银河	Los Angeles Galaxy 
海伦芬体育会	Helenveen Sports Club 
伦敦国王学院	King's College London 
新北市	New Taipei City 
朝鲜国家足球队	North Korea National Football Team 
英国国会	British Parliament 
生死格斗系列	Life and death fighting series 
皇家萨拉戈萨	Real Zaragoza 
西悉尼流浪者足球俱乐部	Western Sydney Wanderers Football Club 
藏-喜马拉雅语群	Tibetan-Himalayan group 
哈布斯堡王朝	Habsburg Dynasty 
晨曦体育会	Dawn Sports Club 
中华人民共和国国务院副总理	Vice Premier of the State Council of the People's Republic of China 
西班牙工人社会党	Spanish Workers' Socialist Party 
美国海军陆战队	United States Marine Corps 
川崎前锋	Kawasaki Frontale 
乌克兰国家足球队	Ukraine National Football Team 
印度尼西亚华人	Indonesian Chinese 
2010年至2011年英格兰足球冠军联赛	2010-2011 English Football Champions League 
若望·保禄二世	John Paul II 
新艺宝唱片	Xinyibao Records 
卡尔十六世·古斯塔夫	Karl XVI Gustaf 
软式摇滚	Soft rock 
马国明	Ma Guoming 
国际足球联合会	International Football Federation 
女警爱作战	Policewoman loves to fight 
大阪樱花	Osaka cherry blossom 
南特足球俱乐部	Nantes Football Club 
法属印度支那	French Indochina 
河床体育会	River Plate Sports Club 
朝鲜日治时期	Korea during the Japanese Occupation 
皇家亨克体育会	Royal Genk Sports Club 
车库摇滚	Garage rock 
新传媒私人有限公司	New Media Pte Ltd 
俄罗斯足球超级联赛	Russian Premier League 
伊朗国家男子足球队	Iran National Men's Football Team 
秘鲁国家足球队	Peru National Football Team 
朱镕基	Zhu Rongji 
法证先锋iii	Forensic Pioneer iii 
江户幕府	Edo Shogunate 
波拿巴皇朝	Bonaparte 
塞尔维亚21岁以下国家足球队	Serbia Under-21 National Football Team 
情越海岸线	Love coastline 
阿拉伯字母	Arabic letters 
福斯广播公司	Fox Broadcasting Company 
李克强政府	Li Keqiang Government 
拜仁慕尼黑足球俱乐部二队	Bayern Munich Football Club Second Team 
德国基督教民主联盟	German Christian Democratic Union 
华特迪士尼公司	Walt Disney Company 
浦项制铁足球俱乐部	Pohang Steelers Football Club 
贺芬咸1899体育会	Howard Johnson 1899 Sports Club 
刺客任务系列	Assassin Mission Series 
苏黎世足球俱乐部	Zurich Football Club 
喷气推进实验室	Jet Propulsion Laboratory 
美国司法部长	U.S. Attorney General 
马哈奇卡拉安郅足球俱乐部	Makhachkala Anzhi Football Club 
李氏朝鲜	Lee Chosun 
第三代波特兰公爵威廉·卡文迪许-本廷克	William Cavendish-Bentink, 3rd Duke of Portland 
托马斯·阿奎那	Thomas Aquinas 
2013–14年香港足总杯	2013-14 Hong Kong FA Cup 
三立都会台	Sanli Metropolis 
胡定欣	Hu Dingxin 
马其顿国家足球队	Macedonia National Football Team 
耀舞长安	Yao Wu Chang'an 
国际体育会	International Sports Association 
布莱顿足球俱乐部	Brighton Football Club 
2010年至2011年德国足球甲级联赛	2010-2011 German Football League 
拿破仑一世	Napoleon I 
2012–13年香港足总杯	2012-13 Hong Kong FA Cup 
金牌大风	Gold Medal Gale 
高卢罗曼语支	Gaul Romance 
莱顿大学	Leiden University 
伍尔弗汉普顿流浪足球俱乐部	Wolverhampton Wanderers Football Club 
施志安	Shi Zhian 
2011年至2012年英格兰足球甲级联赛	2011-2012 English Football League 
模拟城市系列	Simulated City Series 
威尔斯21岁以下足球代表队	Wales Under-21 Football Team 
回到三国	Return to the Three Kingdoms 
维罗纳足球俱乐部	Verona Football Club 
爱尔兰岛	Ireland 
洛杉矶快船	Los Angeles Clippers 
德国语言	German language 
联合航空	United Airlines 
妮裳神话-精选+新曲	The Myth of Nishang-Best Selection + New Song 
2012–13赛季英格兰超级联赛	2012-13 season English Premier League 
2010至2011年英格兰联赛杯	2010-2011 England League Cup 
阮朝	Nguyen Dynasty 
纽约尼克斯	New York Knicks 
低地苏格兰语	Lowland Scots 
胡安·卡洛斯一世	Juan Carlos I 
日本皇室	Japanese imperial family 
2009至2010年英格兰联赛杯	2009-2010 England League Cup 
意大利-西罗曼语支	Italian-Siroman branch 
2010–11赛季英格兰超级联赛	2010-11 season English Premier League 
澳大利亚职业足球联赛	Australian Professional Football League 
大药坊	Big pharmacy 
皇后乐队	Queen 
新杰克摇摆	New Jack Swing 
前卫金属	Avant-garde metal 
同盟国军事占领德国	Allied military occupation of Germany 
委内瑞拉国家足球队	Venezuela National Football Team 
美国参议院临时议长	President pro tempore of the U.S. Senate 
2012–13年香港高级组银牌	2012-13 Hong Kong Senior Group Silver Medal 
力量金属	Power metal 
2011年至2012年英格兰足球冠军联赛	2011-2012 English Football Champions League 
梅斯足球俱乐部	Metz Football Club 
雅典奥林匹克体育场	Athens Olympic Stadium 
纽约红牛	New York Red Bull 
戊辰战争	Boshin War 
南斯拉夫语支	Yugoslavian 
新世界党	New World Party 
best～second_session～	best~second session~ 
鲍里斯·尼古拉耶维奇·叶利钦	Boris Nikolaevich Yeltsin 
2011年至2012年德国足球甲级联赛	2011-2012 German Football League 
最终幻想系列	Final Fantasy Series 
大宫松鼠	Omiya Squirrel 
阿德莱德联足球俱乐部	Adelaide United Football Club 
伊朗空军	Iranian Air Force 
庆熙大学	Kyung Hee University 
罗马共和国	Roman republic 
澳大利亚自由党	Australian Liberal Party 
皇家苏斯达	Royal Sousda 
groove音乐	groove music 
克里米亚战争	Crimean War 
纽伦堡足球俱乐部	Nuremberg Football Club 
英皇娱乐	Emperor Entertainment 
北极大学	Arctic University 
苏丹端姑阿都哈林	Sultan Tuanku Abdul Harim 
图卢兹足球俱乐部	Toulouse Football Club 
极速快感：玩命山道	Speed Pleasure: Fate Mountain Road 
欧洲左派党	European Left Party 
花样少年少女_(2012年电视剧)	Boys Over Flowers_ (2012 TV series) 
美人啊	Beauty 
妮裳十年-冠军全纪录	Nishang Ten Years-All Championship Record 
笈多文	Gupta 
阿拉伯联合大公国国家足球队	United Arab Emirates National Football Team 
张高丽	Zhang Gaoli 
台湾南岛语言	Taiwan South Island Language 
釜山广域市	Busan Metropolitan City 
后硬核	Post hard core 
游击队足球俱乐部	Partizan Football Club 
华丽摇滚	Gorgeous rock 
中国国家少年足球队	China National Youth Football Team 
耶鲁法学院	Yale Law School 
英格兰足球总会	England Football Association 
马来西亚华人	Malaysian Chinese 
飓风古斯塔夫_(2008年)	Hurricane Gustav_ (2008) 
西南官话	Southwest Mandarin 
莱万特体育联盟	Levante Sports League 
奥萨苏纳竞技俱乐部	Osasuna Athletic Club 
游锡堃	You Xikun 
怒火街头2	Fury Street 2 
南非联邦	South Africa 
南加州大学	University of Southern California 
东京事变	Tokyo Incident 
1997–98年欧洲冠军联赛	1997-98 UEFA Champions League 
爱沙尼亚国家足球队	Estonia National Football Team 
蓝十字	Blue cross 
古墓丽影系列	Tomb Raider Series 
巴西足球乙级联赛	Brazilian Football League Two 
让-克洛德·容克	Jean-Claude Juncker 
哈佛法学院	Harvard Law School 
毛治国	Mao Zhiguo 
圣乔治礼拜堂_(温莎城堡)	St. George's Chapel_ (Windsor Castle) 
爱丁堡公爵菲利普亲王	Prince Philip, Duke of Edinburgh 
梦想骏其足球会	Dream Junqi Football Club 
南美解放者杯	Copa Libertadores 
天佑女王	God Bless the Queen 
2012年至2013年德国足球甲级联赛	2012-2013 German Football League 
特拉维夫马卡比足球会	Maccabi Tel Aviv Football Club 
侠盗猎车手：圣安地列斯	Grand Theft Auto: San Andreas 
波兰第二共和国	Second Polish Republic 
时代华纳	Time Warner 
艾恩足球俱乐部	Al Ain Football Club 
佛得角国家足球队	Cape Verde National Football Team 
加利福尼亚大学	University of California 
根宝足球基地	Genbao Football Base 
罗马奥林匹克体育场	Rome Olympic Stadium 
印度东部	East india 
切沃维罗纳足球俱乐部	Chievo Verona Football Club 
第三代索尔斯伯利侯爵罗伯特·盖斯科因-塞西尔	Robert Gascoyne-Cecile, 3rd Marquis of Salisbury 
希腊足球超级联赛	Greek Premier League 
伊蒂哈德足球俱乐部	Etihad Football Club 
新西兰总理	Prime Minister of New Zealand 
情逆三世缘	Always and Ever 
岁月风云_(电视剧)	Years and Storms_ (TV series) 
第一代威灵顿公爵阿瑟·韦尔斯利	Arthur Wellesley, Duke of Wellington 
印度西部	West India 
美国英语	American English 
维也纳迅速体育会	Vienna Rapid Sports 
宝丽多唱片	Polaroid Records 
集英社	Shueisha 
初五启市录	Market Records of the Fifth Day 
匈牙利王国	Kingdom of Hungary 
沈海高速公路	Shenhai Expressway 
釜山ipark足球俱乐部	Busan ipark Football Club 
nbc环球	nbc Universal 
东京都区部	Tokyo Metropolitan Area 
伊朗语支	Iranian branch 
波斯尼亚和黑塞哥维那	Bosnia and Herzegovina 
巴不得妈妈...	Wish mom... 
亨利王子_(格洛斯特公爵)	Prince Henry_ (Duke of Gloucester) 
阿瑟王子_(康诺特和斯特拉森公爵)	Prince Arthur_ (Duke of Connaught and Strathson) 
费利佩六世	Felipe VI 
1991–92年欧洲足协杯	1991-92 UEFA Cup 
俄罗斯21岁以下国家足球队	Russia Under-21 National Football Team 
亚非语系	Asian and African Languages 
墨西哥足球超级联赛	Mexican Premier League 
哈佛学院	Harvard College 
毕尔巴鄂竞技	Athletic Bilbao 
伯恩茅斯足球俱乐部	Bournemouth Football Club 
欧洲联合左派/北欧绿色左派	European Union Left/Nordic Green Left 
冲呀！瘦薪兵团	Go! Lean corps 
哈德斯菲尔德足球俱乐部	Huddersfield Football Club 
内阁官房长官	Chief Cabinet Secretary 
人民运动联盟	People's Movement League 
约翰·霍普金斯大学	Johns Hopkins University 
加拿大总督	Governor of Canada 
威尔斯亲王查尔斯	Charles, Prince of Wales 
洛矶山脉	Rocky Mountains 
米尔沃尔足球俱乐部	Millwall Football Club 
尼利_(足球员)	Neely_ (football player) 
山县有朋	Yamagata Aritomo 
希伯来字母	Hebrew alphabet 
使徒行者	Apostle walker 
油渍摇滚	Grunge 
同盟国_(第二次世界大战)	Allied Powers_ (Second World War) 
泉漳片	Quanzhang tablets 
法证先锋ii	Forensic Pioneer II 
红星大奖	Red Star Award 
布拉迪斯拉发	Bratislava 
1996–97年欧洲杯赛冠军杯	1996–97 European Cup Championship 
皇家真特体育会	Royal Zhente Sports Club 
古斯塔夫·福楼拜	Gustave Flaubert 
猫屎妈妈	Mother cat shit 
比利时足球甲级联赛	Belgian Football League 
伯恩利足球俱乐部	Burnley Football Club 
守业者	Keeper 
大冢爱	Ai Otsuka 
汉阳大学	Hanyang University 
十大联盟	Top Ten Leagues 
可汗学院	Khan Academy 
皇家巴利亚多利德足球俱乐部	Real Valladolid Football Club 
舌剑上的公堂	The Court on the Tongue Sword 
单恋双城	Outbound Love 
亚特兰大足球俱乐部	Atlanta Football Club 
中日德兰足球俱乐部	China Jylland Football Club 
奥地利维也纳足球会	Austria Vienna Football Club 
布里斯班狮吼足球俱乐部	Brisbane Roar Football Club 
舒特方言	Shute dialect 
忠奸人_(电视剧)	Loyalist_ (TV series) 
挪威足球超级联赛	Norwegian Premier League 
2012年中国足球超级联赛	2012 Chinese Football Super League 
万凰之王	King of the Phoenix 
斯特拉斯堡大学	University of Strasbourg 
巴西帝国	Brazilian Empire 
蒙古人民共和国	Mongolian People's Republic 
刺客教条系列	Assassin's Creed Series 
阿方索十三世	Alfonso XIII 
朱德	Zhu De 
任天堂64	Nintendo 64 
经典k联赛	Classic K League 
berryz工房	berryz workshop 
战地风云系列	Battlefield Series 
瑞典帝国	Swedish Empire 
renderware引擎	renderware engine 
中国人民解放军	Chinese People's Liberation Army 
印度南部	South India 
柏柏尔语族	Berber 
伯班克_(加利福尼亚州)	Burbank_ (California) 
连拿度·达·告鲁斯·奥利华拉	Leonardo da Gurus Oliveira 
新英格兰学校和学院协会	New England Association of Schools and Colleges 
阿尔贝二世_(比利时)	Albert II_(Belgium) 
莫卧儿帝国	Mughal Empire 
金属乐队	Metal band 
速度金属	Speed metal 
李显龙	Lee Hsien Loong 
特克的玛丽	Mary of Turk 
圣路易斯_(密苏里州)	St. Louis (Missouri) 
希腊字母	Greek alphabet 
寒山潜龙	Hanshan Qianlong 
中央戏剧学院	The Central Academy Of Drama 
微软电影与电视	Microsoft Movies and TV 
德国联邦总统	Federal President of Germany 
科隆足球俱乐部	Cologne Football Club 
dsp媒体	dsp media 
anvil引擎	anvil engine 
达拉斯小牛	Dallas Mavericks 
海岛凯尔特语支	Island Celtic 
皆大欢喜_(古装电视剧)	Everyone is Happy_ (Costume TV Series) 
顿涅茨克矿工足球俱乐部	Shakhtar Donetsk Football Club 
天梯_(无线电视剧)	Ladder_(wireless TV series) 
弗赖堡体育俱乐部	Freiburg Sports Club 
巴伐利亚王国	Kingdom of Bavaria 
菲尼克斯太阳	Phoenix Suns 
大埔足球会	Tai Po Football Club 
天津京铁火车头足球俱乐部	Tianjin Beijing Railway Locomotive Football Club 
荷属东印度	Dutch East Indies 
葡萄牙足球甲级联赛	Portuguese Football League 
质量效应系列	Mass Effect Series 
珀斯光荣足球俱乐部	Perth Glory Football Club 
冈田克也	Katsuya Okada 
老特拉福德球场	Old Trafford Stadium 
罗马尼亚王国	Kingdom of Romania 
民主建港协进联盟	Democratic Alliance for the Advancement of Hong Kong 
香港大球场	Hong Kong Stadium 
英国广播公司第一台	BBC First 
博洛尼亚足球俱乐部	Bologna Football Club 
九江十二坊	Jiujiang Twelve Square 
多伦多大学	University of Toronto 
仁心解码	Benevolent decoding 
穆罕默德二世_(奥斯曼帝国)	Mohammed II_ (Ottoman Empire) 
1992–93年欧洲足协杯	1992-93 UEFA Cup 
嘉德勋章	Order of the Guardian 
大无限乐团	Big Infinity Orchestra 
札幌冈萨多	Consadole Sapporo 
纽约大学	New York University 
布拉格斯拉维亚体育俱乐部	Slavia Sports Club Prague 
枝野幸男	Yukio Edano 
华丽金属	Gorgeous metal 
苏格兰足球超级联赛	Scottish Premier League 
李源潮	Li Yuanchao 
艾奇逊，托皮卡和圣塔菲铁路	Atchison, Topeka and Santa Fe Railroad 
俄亥俄州立大学	Ohio State University 
路易十六	Louis XVI 
叛逃_(电视剧)	Defection_ (TV series) 
卡内基梅隆大学	Carnegie Mellon University 
老表，你好嘢！_(电视剧)	Old watch, hello! _(TV series) 
中国国民党	Kuomintang 
超级机器人大战系列	Super Robot War Series 
郑容和	Zheng Ronghe 
寰宇一家	Oneworld 
皇家布鲁日足球会	Royal Bruges Football Club 
师父·明白了	Master understand 
赫塔费足球俱乐部	Getafe Football Club 
蒙古帝国	Mongolian Empire 
瓦萨王朝	Vaasa Dynasty 
鲁营球场	Luying Stadium 
捷克足球甲级联赛	Czech Football League 
墨尔本胜利足球俱乐部	Melbourne Victory Football Club 
刘兆玄	Liu Zhaoxuan 
丹麦的亚历山德拉	Alexandra of Denmark 
新金属	New metal 
诺贝尔经济学奖	Nobel Prize in Economics 
盛世仁杰	Sheng Shi Renjie 
福音音乐	Gospel music 
卡通频道	Cartoon Channel 
食为奴	Food is a slave 
香港超级联赛	Hong Kong Premier League 
中华人民共和国主席	President of the People's Republic of China 
低地德语	Low German 
best～first_things～	best～first_things～ 
美国首席大法官	Chief Justice of the United States 
香港特别行政区政务司司长	Chief Secretary for Administration of the Hong Kong Special Administrative Region 
贵州恒丰智诚足球俱乐部	Guizhou Hengfeng Zhicheng Football Club 
好心作怪	Good intentions 
侠盗猎车手iii	Grand Theft Auto III 
林吉祥	Lin Jixiang 
密苏里州各县列表	List of counties in Missouri 
阿卜杜勒-阿齐兹·本·阿卜杜拉赫曼·本·费萨尔·阿勒沙特	Abdul Aziz bin Abdullahman bin Faisal Al Shat 
阿卜杜拉二世	Abdullah II 
再战明天	Fight tomorrow 
海德堡大学	Heidelberg University 
纽约都会区	New York Metropolitan Area 
巴西17岁以下国家足球队	Brazil Under-17 National Football Team 
e·f·l·伍德，第一代哈利法克斯伯爵	e·f·l·Wood, the first Earl of Halifax 
法兰西第一帝国	First French Empire 
第三代巴麦尊子爵亨利·坦普尔	Henry Temple, 3rd Viscount Palmer 
克里夫兰骑士	Cleveland Cavaliers 
京畿道	Gyeonggi Province 
波兰会议王国	Kingdom of Poland Conference 
皇家维戈塞尔塔俱乐部	Royal Vigo Celta Club 
雷霆扫毒	Thunder Anti-drug 
全南天龙足球俱乐部	Jeonnam Tianlong Football Club 
爱丁堡大学	University of Edinburgh 
皇家维多利亚勋章	Royal Victorian Medal 
中国足球协会乙级联赛	Chinese Football Association Second Division 
万代南梦宫娱乐	Bandai Namco Entertainment 
北京控股足球俱乐部	Beijing Enterprises Football Club 
荣誉勋章系列	Medal of Honor Series 
美国第一夫人	American First Lady 
印度东北部	Northeast India 
卢卡斯影业	Lucasfilm 
小威廉·皮特	William Pitt Jr. 
沙特希拉尔足球俱乐部	Saudi Hillar Football Club 
每日放送	Daily delivery 
邵美琪	Shao Meiqi 
詹姆斯·盖斯科因-塞西尔，第四代梳士巴利侯爵	James Gascoyne-Cecile, 4th Marquis of Salisbury 
暗黑破坏神系列	Diablo series 
华沙莱吉亚足球俱乐部	Warsaw Legia Football Club 
天主教民主党	Catholic Democratic Party 
莫里斯·梅洛-庞蒂	Maurice Merleau-Ponty 
圣但尼圣殿	Basilica of Saint Denis 
奥格斯堡足球俱乐部	Augsburg Football Club 
朝鲜汉字	Korean Kanji 
彭淮南	Peng Huainan 
土耳其足球超级联赛	Turkish Premier League 
1984–85年欧洲杯赛冠军杯	1984–85 European Cup Championship 
恋爱季节	Love season 
法兰西体育场	Stade de France 
乔治华盛顿大学	George Washington University 
侠盗猎车手iv	Grand Theft Auto IV 
李施嬅	Li Shiyu 
拿斯·积及臣	Nath Jagchen 
威廉三世_(尼德兰)	William III_ (Netherlands) 
中国国际航空	China International Airlines 
蒙古字母	Mongolian alphabet 
黑莓世界	Blackberry World 
粟特字母	Sogdian 
环球影业	Universal Pictures 
第一代缅甸的蒙巴顿伯爵路易斯·蒙巴顿	Louis Mountbatten, the first Burmese Earl of Mountbatten 
奥地利21岁以下国家足球队	Austrian Under-21 National Football Team 
蒙古征战	Mongolia campaign 
我的如意狼君	My wishful wolf lord 
乃木坂46	Nogizaka46 
大日本帝国海军	Imperial Japanese Navy 
第二代墨尔本子爵威廉·兰姆	William Lamb, Second Viscount of Melbourne 
马里国家足球队	Mali National Football Team 
奥斯曼帝国苏丹列表	List of Ottoman Sultans 
英国陆军	British Army 
我为喜剧狂_(第1季)	I'm Crazy for Comedy_ (Season 1) 
埃及国家足球队	Egypt national football team 
奥兰多魔术	Orlando Magic 
道格拉斯飞行器公司	Douglas Aircraft Company 
大隈重信	Shigenobu Okuma 
大连实德四五队	Dalian Shide Team Four and Five 
高丽大学	Korea University 
金枝欲孽贰	Golden Branch Desire II 
帕肯球场	Parken Stadium 
丹麦足球超级联赛	Danish Premier League 
女人俱乐部	Women's Club 
中华人民共和国国务院总理	Premier of the State Council of the People's Republic of China 
高卢-义大利语	Gaul-Italian 
赫特福德郡	Hertfordshire 
新加坡共和国空军部队	Republic of Singapore Air Force 
j唱片公司	j record company 
芝加哥公牛	Chicago Bulls 
蒙特内哥罗国家足球队	Montenegro National Football Team 
萨克森-科堡-哥达	Saxony-Coburg-Gotha 
工业摇滚	Industrial rock 
洛夫文内阁	Lovwen Cabinet 
印度总督	Governor of India 
杜克大学	Duke University 
本杰明·迪斯雷利	Benjamin Disraeli 
德比郡足球俱乐部	Derby County Football Club 
1998–99年欧洲杯赛冠军杯	1998–99 European Cup Champions League 
希洪体育	Gijon Sports 
马其顿共和国	Republic of Macedonia 
伦巴第-威尼西亚王国	Kingdom of Lombardy-Venesia 
中国共产党中央政治局	Political Bureau of the Communist Party of China 
波兰人民共和国	People's Republic of Poland 
骇客入侵系列	Hacker Invasion Series 
江淮官话	JAC Mandarin 
圣西路球场	San Siro Stadium 
朱丽安娜女王	Queen Juliana 
恩斯特·哈佩尔球场	Ernst Happel Stadium 
雅克·沙邦-戴尔马	Jacques Chaban-Delma 
魂之系列	Soul series 
岑丽香	Cen Lixiang 
桃花小妹_(电视剧)	Peach Blossom Little Sister_ (TV Series) 
北德意志邦联	North German Confederation 
休斯敦火箭	Houston Rockets 
大韩民国国务总理	Prime Minister of the Republic of Korea 
爱上巧克力	Fall in love with chocolate 
八卦神探	Gossip detective 
人民行动党	People's Action Party 
爱·回家_(电视剧)	Love Home_(TV series) 
胡春华	Hu Chunhua 
梅州五华足球俱乐部	Meizhou Wuhua Football Club 
香港甲组足球联赛	Hong Kong Football League 
翻滚吧！蛋炒饭	Roll over! Egg Fried Rice 
黑森-达姆施塔特	Hesse-Darmstadt 
终极一家	The ultimate family 
王国之心系列	Kingdom Hearts Series 
火线猎杀系列	FireWire Hunting Series 
金雀花王朝	Gorse Dynasty 
2009–10赛季英格兰超级联赛	2009-10 season English Premier League 
刺客教条iv：黑旗	Assassin's Creed IV: Black Flag 
哥本哈根大学	University of Copenhagen 
蒙特利尔冲击	Montreal Shock 
哥连·卡森-李察士	Colin Carson-Richards 
麦吉尔大学	McGill University 
维托里奥·埃马努埃莱三世	Vittorio Emanuele III 
哈萨克斯坦国家足球队	Kazakhstan National Football Team 
波士顿凯尔特人	Boston Celtics 
前卫电子音乐	Avant-garde electronic music 
墨尔本城足球俱乐部	Melbourne City Football Club 
米哈伊一世	Mihai I 
阿契美尼德王朝	Achaemenid Dynasty 
英国皇家空军	Royal Air Force 
aik足球会	aik football club 
哥伦比亚足球甲级联赛	Colombian Football League 
加那利群岛	Canary Islands 
法兰西第二帝国	Second French Empire 
统一俄罗斯	Unify Russia 
朱咪咪	Zhu Mimi 
荃加福禄寿探案	Detective Case of Tsuen Jia Fu Lu Shou 
法属突尼斯	French Tunisia 
弗雷德里克·永贝里	Frederick Ljungberg 
侠盗猎车手v	Grand Theft Auto V 
伊斯坦布尔大学	Istanbul University 
慈安太后	Empress Cian 
湾岸系列	Wangan Series 
东西宫略	East and West Palace 
妙手仁心	Good hand 
后摇滚	Post rock 
英国广播公司新闻频道	BBC News Channel 
女人唔易做	Women are not easy to do 
哈茨足球俱乐部	Hartz Football Club 
马里迪莫体育会	Maritimo Sports Club 
篮球火	Basketball fire 
黛比·史戴比拿	Debbie Stabila 
香港日占时期	Hong Kong during the Japanese Occupation 
弗朗茨二世_(神圣罗马帝国)	Franz II_ (Holy Roman Empire) 
路易-菲利普一世	Louis-Philippe I 
美国航空	American airlines 
布拉加体育会	Braga Sports Club 
南非国家足球队	South Africa National Football Team 
夏尔十世	Charles X 
高棉语	Cambodian 
cw电视网	cw television network 
2013–14赛季英格兰超级联赛	2013-14 season English Premier League 
印度国民大会党	National Congress of India 
国民阵线	National Front 
中共中央党校	Central Party School 
亚美尼亚国家足球队	Armenia National Football Team 
孝庄文皇后	Empress Xiaozhuangwen 
恶作剧2吻	Prank 2 kiss 
都铎王朝	The Tudors 
东名高速公路	Tomei Expressway 
安妮长公主	Princess Anne 
新潟天鹅	Niigata Swan 
萨丁尼亚王国	Kingdom of Sardinia 
香港中文大学	Chinese University of Hong Kong 
苏格兰王国	Kingdom of Scotland 
普林斯顿高等研究院	Princeton Institute for Advanced Study 
哥登堡体育会	Fort Gordon Sports Club 
丹佛掘金	Denver Nuggets 
梅州市梅县区客家足球俱乐部	Meixian District Hakka Football Club 
载得有情人	Carry a lover 
保地花高足球竞赛会	Bao Ji Hua Gao Football Competition 
第二代格雷伯爵查尔斯·格雷	Charles Gray, the second Earl of Gray 
波音民用飞机集团	Boeing Civil Aircraft Group 
越南民主共和国	Democratic Republic of Vietnam 
武媚娘传奇	The Legend of Wu Mei Niang 
费利拿柏高斯足球会	Fellina Pergauss Football Club 
格鲁吉亚国家足球队	Georgia National Football Team 
贡榜王朝	Gongbang Dynasty 
咸普顿公园球场	Hampton Park Stadium 
心路gps	Heart gps 
德川家康	Tokugawa Ieyasu 
爱我请留言	Love me please leave a message 
蒙古国总统	President of Mongolia 
极速快感：进化世代	Speed Pleasure: Evolutionary Generation 
孝慎成皇后	Xiaoshen becomes queen 
黄菊	Huang Ju 
乌克兰苏维埃社会主义共和国	Ukrainian Soviet Socialist Republic 
全国人民代表大会常务委员会委员长	Chairman of the Standing Committee of the National People's Congress 
阿方索，阿斯图里亚斯亲王_(1907–1938)	Alfonso, Prince of Asturias_(1907–1938) 
库萨的尼古拉	Nikolai of Cusa 
凯尔特语族	Celtic 
中国人民解放军空军	Chinese People's Liberation Army Air Force 
大韩民国总统	President of the Republic of Korea 
新南威尔士州	New South Wales 
哥伦布机员足球俱乐部	Columbus Crew Football Club 
祁淦礼	Qi Ganli 
玫瑰碗_(体育场)	Rose Bowl_(Stadium) 
第一代戈德里奇子爵弗雷德里克·约翰·罗宾逊	Frederick John Robinson, 1st Viscount Godric 
印度国家足球队	India national football team 
乌德勒支网络	Utrecht Network 
威廉·本廷克勋爵	Lord William Bentinck 
布里斯托尔城足球俱乐部	Bristol City Football Club 
沈阳东进足球俱乐部	Shenyang Dongjin Football Club 
却克里王朝	Chakri Dynasty 
开普殖民地	Cape Colony 
里奥·费迪南	Rio Ferdinand 
大岛理森	Oshima Risen 
芬兰大公国	Grand Duchy of Finland 
世嘉土星	Sega Saturn 
希波的奥古斯丁	Augustine of Hippo 
2013年至2014年德国足球甲级联赛	2013-2014 German Football League 
沙特阿拉伯国家男子足球队	Saudi Arabia National Men's Football Team 
任天堂明星大乱斗系列	Super Smash Bros. series 
台视主频	TTV main frequency 
瑞典首相	Prime Minister of Sweden 
陆定一	Lu Dingyi 
linux内核	linux kernel 
同盟国军事占领日本	Allied military occupation of Japan 
第一代格伦维尔男爵威廉·格伦维尔	William Glenville, the first Baron of Glenville 
鸟栖砂岩	Tosu Sandstone 
阿曼国家足球队	Oman National Football Team 
埃及王国	Kingdom of Egypt 
巴尔的摩与俄亥俄铁路	Baltimore and Ohio Railroad 
超级任天堂	Super Nintendo 
西北大学_(伊利诺伊州)	Northwestern University_ (Illinois) 
巴里体育俱乐部	Bari Sports Club 
公主小妹_(电视剧)	Princess Little Sister_ (TV Series) 
寺内正毅	Masatake Terauchi 
赞比亚国家足球队	Zambia National Football Team 
郭政鸿	Guo Zhenghong 
阿特拉斯足球俱乐部	Atlas Football Club 
德意志国防军	German Wehrmacht 
丹·沙利文_(美国政治人物)	Dan Sullivan_ (American political figure) 
巴勒斯坦托管地	Palestine Trust 
阿礼嘎礼字母	Aligali alphabet 
山茶属	Camellia 
波兰统一工人党	Polish United Workers' Party 
桑坦德竞技	Racing Santander 
户田和幸	Kazuyuki Toda 
大连超越足球俱乐部	Dalian Beyond Football Club 
明尼苏达森林狼	Minnesota Timberwolves 
加蓬国家足球队	Gabon National Football Team 
南京奥林匹克体育中心	Nanjing Olympic Sports Center 
历基韦亚体育会	Liquiwea Sports Club 
第十四代德比伯爵爱德华·史密斯-斯坦利	Edward Smith-Stanley, 14th Earl of Derby 
中国共产党中央政治局常务委员会	Standing Committee of the Political Bureau of the Communist Party of China 
仙台维加泰	Sendai Vigate 
中华人民共和国副主席	Vice President of the People's Republic of China 
奥斯特拉瓦巴尼克足球俱乐部	Ostrava Barnik Football Club 
乔治王子_(肯特公爵)	Prince George_ (Duke of Kent) 
台北田径场	Taipei Track and Field 
本那比	Burnaby 
意大利足球乙级联赛	Italian Football League 
罗马尼亚正教会	Romanian Orthodox Church 
bbc国会台	bbc Congress Channel 
乔治城大学	Georgetown University 
西高止山脉	Western Ghats 
北京电影学院	Beijing Film Academy 
孝静成皇后	Xiaojing becomes queen 
拉普拉塔大学生	University of La Plata 
中国共产党中央委员会总书记	General Secretary of the Central Committee of the Communist Party of China 
越南共和国	Republic of Vietnam 
明尼苏达大学	University of Minnesota 
南荷兰省	South Holland Province 
英国副首相	British Deputy Prime Minister 
新西兰国家足球队	New Zealand National Football Team 
东山飘雨西关晴	Dongshan Piaoyu Xiguanqing 
赵乐际	Zhao Leji 
泰恩河畔纽卡斯尔	Newcastle upon Tyne 
红牛车队	Red Bull Racing 
萨伏依王朝	Savoy 
新的水晶故事_最终幻想	New Crystal Story_Final Fantasy 
苹果a5	Apple a5 
生活大爆炸	The Big Bang Theory 
沈阳中泽足球俱乐部	Shenyang Zhongze Football Club 
伊藤博文	Ito Hirobumi 
阿姆斯特丹球场	Amsterdam Stadium 
普雷斯顿足球俱乐部	Preston Football Club 
妙手仁心iii	Good Hands and Heart iii 
格拉斯哥大学	University of Glasgow 
孝全成皇后	Empress Xiao Quancheng 
ml语言	ml language 
罗伯特·塞西尔，第一代切尔伍德的塞西尔子爵	Robert Cecil, the first Viscount Cecil of Chelwood 
流行禁区	Popular exclusion zone 
挪威21岁以下国家足球队	Norway Under-21 National Football Team 
英格兰足球议会全国联赛	English Football Council National League 
民族足球俱乐部	National Football Club 
华裔加拿大人	Chinese Canadian 
勇者斗恶龙系列	Dragon Quest Series 
卢顿足球俱乐部	Luton Football Club 
布伦特福德足球俱乐部	Brentford Football Club 
湖南湘涛足球俱乐部	Hunan Xiangtao Football Club 
心战_(电视剧)	Heart Fight_ (TV Series) 
新奥尔良鹈鹕	New Orleans Pelicans 
夏威夷王国	Kingdom of Hawaii 
花样少年少女_(2006年电视剧)	Boys Over Flowers_ (2006 TV series) 
塑胶小野乐队	Plastic Ono 
新抱喜相逢	Xin Baoxi meet 
华盛顿奇才	Washington Wizards 
洪武三十二	Hongwu thirty-two 
叙利亚武装力量	Syrian armed forces 
红星体育场	Red Star Stadium 
欧塞尔青年会	Auxerre YMCA 
瑞典议会	Swedish Parliament 
希腊王国	Kingdom of Greece 
iw引擎	iw engine 
加拉法体育俱乐部	Galafa Sports Club 
1990–91年欧洲杯赛冠军杯	1990–91 European Cup Champions League 
玛丽亚·亚历山德罗芙娜_(黑森-莱茵的郡主)	Maria Alexandrovna _ (the lord of Hesse-Rhine) 
亨利八世	Henry VIII 
曼彻斯特大学	University of Manchester 
传统蒙古文	Traditional Mongolian 
英国广播公司第二台	BBC Radio 2 
上海外国语大学	Shanghai International Studies University 
威廉·霍华德·塔夫脱	William Howard Taft 
希腊议会	Greek Parliament 
中国铁路总公司	China Railway 
仁川联足球俱乐部	Incheon United Football Club 
多伦多猛龙	Toronto Raptors 
幸运之星	Lucky Star 
中国电视公司	China Television Corporation 
南区足球会	Southern District Football Club 
基斯·高文_(足球员)	Keith Gawain_ (Football Player) 
瑞典的路易丝公主	Princess Louise of Sweden 
米内罗竞技俱乐部	Atletico Mineiro 
普鲁士君主列表	List of Prussian monarchs 
北京工人体育场	Beijing Workers Stadium 
匈牙利21岁以下国家足球队	Hungary Under-21 National Football Team 
土耳其21岁以下国家足球队	Turkey Under-21 National Football Team 
罗斯托夫足球俱乐部	Rostov Football Club 
西部学校和学院协会	Western Association of Schools and Colleges 
君士坦丁大帝	Constantine the Great 
奥克-罗曼语支	Occitan 
波兹南莱克足球俱乐部	Poznan Lake Football Club 
萨克森-迈宁根	Saxony-Meiningen 
mozilla基金会	mozilla foundation 
帕拉尼恩斯体育会	Paranion Sports Club 
迈阿密热火	Miami Heat 
第十二届全国人民代表大会	The 12th National People's Congress 
谷垣祯一	Tanigaki Sadakazu 
越南共产党中央委员会总书记	General Secretary of the Central Committee of the Communist Party of Vietnam 
暗黑破坏神iii	Diablo III 
伊利诺伊大学厄巴纳-香槟分校	University of Illinois at Urbana-Champaign 
美国入侵巴拿马	US invasion of Panama 
菲律宾国家足球队	Philippines national football team 
德克萨斯州大学奥斯汀分校	University of Texas at Austin 
坎特伯雷市_(新南威尔斯州)	Canterbury City_ (New South Wales) 
mnet媒体	mnet media 
开罗大学	Cairo University 
巴列卡诺闪电	Vallecano Lightning 
萨马拉苏维埃之翼足球俱乐部	Samara Soviet Wings Football Club 
1968–69年欧洲冠军杯	1968–69 European Champions Cup 
我的宝贝四千金	My baby four daughters 
青岛黄海足球俱乐部	Qingdao Yellow Sea Football Club 
谁家灶头无烟火	Whose stove has no fireworks 
派崔克·史坦普	Patrick Stamp 
阿尔弗雷德_(萨克森-科堡-哥达公爵)	Alfred_ (Duke of Saxony-Coburg-Gotha) 
纽约城足球俱乐部	New York City Football Club 
王子公园体育场	Prince Park Stadium 
波斯尼亚和黑塞哥维那21岁以下国家足球队	Bosnia and Herzegovina Under-21 National Football Team 
科普特字母	Coptic alphabet 
阿伯丁足球俱乐部	Aberdeen Football Club 
八大综合台	Eight comprehensive stations 
德黑兰独立足球俱乐部	Tehran Independent Football Club 
施云奴	Shi Yunnu 
里昂王族	Royal Family of Lyon 
倩女喜相逢	Beautiful girl meets 
望月重良	Mochizuki Shigeyoshi 
路易十四	Louis XIV 
明清战争	Ming and Qing wars 
蒙古人民党	Mongolian People's Party 
威廉二世足球会	William II Football Club 
关岛足球代表队	Guam National Football Team 
2014年中国足球超级联赛	2014 Chinese Football Super League 
老婆大人ii	Wife Master II 
孝恭仁皇后	Empress Xiao Gongren 
拉丁-法利希语支	Latin-Falihi branch 
埃斯比约联合足球俱乐部	Esbjerg United Football Club 
民族竞技	National sports 
卡塔尔星级足球联赛	Qatar Star Football League 
维多利亚体育会	Victorian Athletic Association 
美国芝华士	Chivas USA 
法国陆军	French Army 
保禄六世	Paul VI 
中华人民共和国铁道部	Ministry of Railways of the People's Republic of China 
科洛科洛竞技俱乐部	Kolo Kolo Athletic Club 
卡尔·爱德华_(萨克森-科堡-哥达公爵)	Carl Edward_ (Duke of Saxony-Coburg-Gotha) 
威廉与玛丽学院	College of William and Mary 
胜利娱乐	Victory Entertainment 
陈省身	Chern 
田蕊妮	Kristal Tin 
巴基斯坦总统	President of Pakistan 
孝诚仁皇后	Empress Xiaocheng 
李国章	Li Guozhang 
大韩民国国军	National Army of the Republic of Korea 
夏拉达文	Shalada 
安道尔国家足球队	Andorra National Football Team 
妙手仁心ii	Good Hands and Heart ii 
洛里昂足球俱乐部	Lorient Football Club 
西南战争	Southwest War 
纽华克_(新泽西州)	Newark_(New Jersey) 
威廉·亨利·哈里森_(怀俄明州众议员)	William Henry Harrison (Wyoming State Representative) 
萨勒曼·本·阿卜杜勒-阿齐兹·阿勒沙特	Salman bin Abdul-Aziz Al Shat 
阿尔及利亚总统	President of Algeria 
法证先锋	Forensic Heroes 
世界新闻	World news 
换换爱	Change love 
罗马尼亚社会主义共和国	Romanian Socialist Republic 
cube娱乐	cubeEntertainment 
孝圣宪皇后	Queen Xiao Shengxian 
中华民国副总统	Vice President of the Republic of China 
菲利普_(比利时国王)	Philip_(King of Belgium) 
查谟-克什米尔邦	Jammu and Kashmir 
曾永权	Zeng Yongquan 
纵横谍海：断罪	Spy Sea: Conviction 
最后一战系列	The last battle series 
齐格蒙特三世	Sigmund III 
细胞分裂：双重间谍	Cell Division: Double Agent 
1985–86年欧洲杯赛冠军杯	1985-86 European Cup Champions League 
萨克森-魏玛-艾森纳赫	Saxony-Weimar-Eisenach 
战地：强硬派系	Battlefield: Hardline faction 
埃塞俄比亚正教会	Ethiopian Orthodox Church 
悉尼大学	University of Sydney 
巴耶济德二世	Bayezid II 
苹果a7	Apple a7 
李司棋	Li Siqi 
拿破仑战争	Napoleonic Wars 
瓜达拉哈拉体育会	Guadalajara Sports Club 
香港特别行政区行政长官	Chief Executive of the Hong Kong Special Administrative Region 
亨巴利图·巴路基斯·泰西拿	Humbarito Baruchis Tessina 
俄国临时政府	Russian Provisional Government 
稻本润一	Inamoto Junichi 
九寸钉乐团	Nine Inch Nails 
悉昙文字	Xitan script 
米尔顿凯恩斯足球俱乐部	Milton Keynes Football Club 
侠盗猎车手系列	Grand Theft Auto Series 
梅含理	Mei Hanli 
唯一继承者	Sole successor 
酒泉卫星发射中心	Jiuquan Satellite Launch Center 
巴列维王朝	Pahlavi Dynasty 
加拿大湾市	Canada bay city 
伯尔尼年轻人体育俱乐部	Bern Youth Sports Club 
玻利维亚国家足球队	Bolivia National Football Team 
孝康章皇后	Empress Xiaokang 
蔡细历	Cai Xili 
宇垣一成	Kazushige Ugaki 
庇护九世	Pius IX 
律政新人王ii	New Lawyer King ii 
2011年中国足球超级联赛	2011 Chinese Football Super League 
花花世界花家姐	Hua Hua World Hua Jia Sister 
纵横谍海：混沌理论	Spy Sea: Chaos Theory 
神奇王国	Magic kingdom 
他加禄语	Tagalog 
英格兰足球议会联赛	English Football Parliament League 
伊特鲁里亚王国	Etruscan Kingdom 
金州勇士	Golden State Warriors 
三星galaxy_note系列	Samsung galaxy_note series 
福冈黄蜂	Fukuoka Hornets 
加利福尼亚大学圣地牙哥分校	University of California San Diego 
朗斯竞赛会	Lens Competition 
星际大战外传：侠盗一号	Star Wars Story: Rogue One 
黎刹纪念体育场	Rizal Memorial Stadium 
行政院副院长	Vice President of the Executive Yuan 
中国共产党中央委员会主席	Chairman of the Central Committee of the Communist Party of China 
波希米亚和摩拉维亚保护国	Protectorate of Bohemia and Moravia 
布鲁克林篮网	Brooklyn Nets 
高木琢也	Takuya Takagi 
野蛮奶奶大战戈师奶	Barbarian grandma vs. Ge 
特拉布宗体育	Trabzonspor Sports 
企鹅出版集团	Penguin Publishing Group 
雅典大学	University of Athens 
科里蒂巴足球俱乐部	Coritiba Football Club 
马来民族统一机构	Malay National Unity Agency 
四川话	Sichuan dialect 
马来西亚首相	Prime Minister of Malaysia 
2011–12赛季英格兰超级联赛	2011-12 season English Premier League 
西班牙空军	Spanish Air Force 
关西杰尼斯8	Kansai Genesis 8 
安土桃山时代	Azuchi-Momoyama period 
夏洛特王后	Queen Charlotte 
国民革命军	National Revolutionary Army 
穆罕默德-阿里·福鲁吉	Muhammad Ali Frugi 
请取悦我	Please please me 
老挝人民革命党	Lao People's Revolutionary Party 
拉玛八世	Rama VIII 
注音符号	phonetic notation 
回鹘字母	Uighur alphabet 
马来西亚国家足球队	Malaysia National Football Team 
中华台北女子足球代表队	Chinese Taipei Women's Football Team 
布里斯托尔大学	University of Bristol 
近卫师团	Guards Division 
艾查捷拉体育和文化俱乐部	Echatela Sports and Culture Club 
朝鲜劳动党	Korean labor party 
索肖足球俱乐部	Sochaux Football Club 
中原大战	Central Plains War 
日本投降	Japanese surrender 
天天天晴	Sunny every day 
我爱摇滚乐	I love rock music 
白川方明	Masaaki Shirakawa 
2015年中国足球超级联赛	2015 Chinese Football Super League 
苏格兰盖尔语	Scottish Gaelic 
维克多·卡文迪许，第九代德文郡公爵	Victor Cavendish, 9th Duke of Devonshire 
中国中央电视台中文国际频道	China Central Television Chinese International Channel 
美国驻华大使列表	List of U.S. Ambassadors to China 
中爪哇省	Central Java 
堪萨斯城体育会	Kansas City Athletic Association 
詹姆斯·特罗伊西	James Troisi 
印度尼西亚国家足球队	Indonesia National Football Team 
苹果a6	Apple a6 
布朗大学	Brown University 
巽他族	Sundanese 
韩培德	Han Peide 
中华民国国防部	Ministry of National Defense of the Republic of China 
2013年中国足球超级联赛	2013 Chinese Football Super League 
囧探查过界	囧Explore the boundary 
镜之边缘	Mirror's Edge 
自由民主人民党	Liberal democratic people's party 
哥德摇滚	Gothic Rock 
马来西亚国会	Malaysian Parliament 
迪迪埃·索高拿	Didier Sokner 
印度地理	Geography of India 
波兰21岁以下国家足球队	Poland Under-21 National Football Team 
杨过	Yang Guo 
第一代纽卡斯尔公爵托马斯·佩勒姆-霍利斯	Thomas Pelham-Hollis, the first Duke of Newcastle 
荷兰共和国	Dutch Republic 
哇！陈怡君	Wow! Chen Yijun 
拜伦勋爵	Lord Byron 
擎天神5号运载火箭	Skyshen 5 carrier rocket 
中华人民共和国公安部	Ministry of Public Security of the People's Republic of China 
rpm套件管理员	rpm package manager 
美洲原住民	Native American 
费城76人	Philadelphia 76ers 
陈锦鸿	Chen Jinhong 
月刊comic电击大王	Monthly Comic Dengeki 
路思·伊瑞葛来	Luth Iriglia 
保加利亚足球甲级联赛	Bulgarian Football League 
西班牙内战	Spanish Civil War 
西雅图海湾者足球会	Seattle Bayers Football Club 
我的世界	my world 
澳大利亚勋章	Medal of Australia 
特兰西瓦尼亚大学	University of Transylvania 
河大成	He Dacheng 
欧洲研究型大学联盟	European Research University Alliance 
古英语	Old English 
拉斯帕尔马斯体育联盟	Las Palmas Sports League 
黄色潜水艇	Yellow submarine 
越南人民军空军	Vietnam People's Army Air Force 
贾庆林	Jia Qinglin 
帕萨迪纳_(加利福尼亚州)	Pasadena_ (California) 
时空之轮	Wheel of Time 
小资女孩向前冲	Petty bourgeois girl rushing forward 
沙特阿拉伯统一	Unity of Saudi Arabia 
周刊少年jump	Weekly Shonen Jump 
迪士尼频道	Disney channel 
香港20岁以下足球代表队	Hong Kong Under-20 Football Team 
第三代比特伯爵约翰·斯图尔特	John Stewart, the third Earl of Bit 
rage引擎	rage engine 
2013–14赛季西班牙足球甲级联赛	2013-14 season Spanish Football League 
淮海战役	Battle of Huaihai 
马来西亚最高元首	Supreme Head of State of Malaysia 
五十铃elf	Isuzu elf 
刺客教条iii：自由使命	Assassin's Creed III: Freedom Mission 
北雪梨议会	North Sydney Council 
同治帝	Emperor Tongzhi 
依家有喜	Yijia Youxi 
湘南比马	Shonan Pima 
皇家奥维耶多	Royal Oviedo 
肖恩·赖特-菲利浦斯	Sean Wright-Phillips 
莱顿东方足球俱乐部	Leiden Orient Football Club 
罗斯·麦哥马克	Ross McGormac 
刘宪华	Liu Xianhua 
泰文字	Thai script 
史克威尔艾尼克斯欧洲	Square Enix Europe 
开曼群岛	Cayman Islands 
曼纽尔·瓦尔斯	Manuel Vals 
腓特烈皇后	Queen Frederick 
王云龙_(足球运动员)	Wang Yunlong_ (football player) 
中华航空	China Airlines 
北京理工足球俱乐部	Beijing Institute of Technology Football Club 
尼斯奥林匹克体操会	Nice Olympic Gymnastics 
波希米亚王国	Kingdom of Bohemia 
达乌德·拉吉哈	Daoud Rajha 
拉法叶_(路易斯安那州)	Lafayette_(Louisiana) 
正义联盟	Justice League 
卢森堡大公	Grand Duke of Luxembourg 
万世沉沦	Fallen forever 
犬养毅	Inuyangyi 
澳洲航空	Qantas 
华特迪士尼工作室电影	Walt Disney Studios Movies 
阿拉维斯体育	Alaves Sports 
建国大学	Konkuk University 
ofk贝尔格莱德	ofk Belgrade 
韦俊安	Wei Junan 
喷火战机乐队	Spitfire 
布拉德福德城足球俱乐部	Bradford City Football Club 
葡萄牙君主列表	List of Portuguese monarchs 
联邦大总统	Federal President 
魔兽系列	Warcraft series 
爱丁堡公爵	Duke of Edinburgh 
科罗拉多大学波德分校	University of Colorado Boulder 
喜欢·一个人	like someone 
高广圻	Gao Guangqi 
东北新干线	Tohoku Shinkansen 
美国常驻联合国代表列表	List of Permanent Representatives of the United States to the United Nations 
美国国会	U.S. Congress 
卡尔一世_(奥匈帝国)	Karl I_ (Austro-Hungarian Empire) 
巴特那	Patna 
秀才遇著兵	Xiucai meets soldiers 
香港17岁以下足球代表队	Hong Kong Under-17 Football Team 
中岸水手足球会	Central Coast Mariners Football Club 
1997年飓风丹尼	1997 Hurricane Danny 
伯明翰大学	University of Birmingham 
胡宇威	Hu Yuwei 
宾士镇市	Brunswick 
空中铁匠	Sky blacksmith 
中古英语	Middle English 
奥胡斯体操协会俱乐部	Aarhus Gymnastics Association Club 
1981–82年欧洲冠军杯	1981–82 European Champions Cup 
2014年亚洲足协杯	2014 Asian Football Association Cup 
黯黑史诗	Dark Epic 
俄罗斯军事	Russian military 
王君馨	Wang Junxin 
生化危机0	Resident Evil 0 
西城男孩	West Side Boy 
安哥拉国家足球队	Angola National Football Team 
学警雄心	Police Ambition 
寒霜引擎	Frost Engine 
星辰实验室	Star Lab 
中国人民解放军海军	Chinese People's Liberation Army Navy 
印度尼西亚总理列表	List of Prime Ministers of Indonesia 
华特迪士尼乐园及度假区	Walt Disney Parks and Resorts 
额我略七世	Gregory VII 
空中客车a330	Airbus a330 
mozilla公司	mozilla 
大同盟战争	Great League War 
克罗地亚足球甲级联赛	Croatian Football League 
第一代罗素伯爵约翰·罗素	John Russell, the first Earl of Russell 
蔡佩璇	Cai Peixuan 
还我情真	Give me back 
贝尔内	Bernay 
英国驻华大使列表	List of British Ambassadors to China 
霍亨索伦-锡格马林根	Hohenzollern-Sigmaringen 
ch-47直升机	ch-47 helicopter 
安田理大	Michihiro Yasuda 
塞浦路斯甲组足球联赛	Cyprus First Division Football League 
沙地王朝	Sand Dynasty 
费伦斯华路士体育会	Ference Wallace Sports Club 
斐迪南一世_(罗马尼亚)	Ferdinand I_ (Romania) 
加拿大勋章	Order of Canada 
火线猎杀：先进战士	Fire Hunt: Advanced Warrior 
塞浦路斯国家足球队	Cyprus national football team 
f/a-18黄蜂式战斗攻击机	f/a-18 Wasp combat attack aircraft 
加拿大总理	Prime Minister of Canada 
柏普·干拿高	Pop Canalco 
黎诺懿	Lin Nuoyi 
奥维耶多	Oviedo 
玛丽亚·格佩特-梅耶	Maria Goppert-Meyer 
回旋镖_(电视频道)	Boomerang_ (TV Channel) 
戆夫成龙	Jackie Chan 
辰亦儒	Chen Yiru 
英国广播公司第四台	BBC Radio 4 
秀才爱上兵	Xiucai fell in love with soldiers 
威塞克斯伯爵爱德华王子	Prince Edward, Earl of Wessex 
马拉简拿运动场	Marajanna Stadium 
弗雷德里克八世	Frederick VIII 
不列颠哥伦比亚省省议会	British Columbia Provincial Assembly 
科隆日-贝勒里夫	Cologne-Bellerive 
日本放送协会	NHK 
中华人民共和国教育部	Ministry of Education of the People's Republic of China 
高棉文	Khmer 
第一代西德默斯子爵亨利·阿丁顿	Henry Addington, 1st Viscount of Sidmus 
威尼斯共和国	Republic of Venice 
比哈尔语	Bihar 
南非语	Afrikaans 
波兰足球甲级联赛	Polish Football League 
武藤信义	Muto Shinyi 
美国国防部	U.S. Department of Defense 
1967–68年欧洲杯赛冠军杯	1967–68 European Cup Championship 
康诺的玛嘉烈公主	Princess Margaret of Connaught 
玄叶光一郎	Koichiro Genka 
弗吉尼亚殖民地	Colony of Virginia 
齐柏林飞船_(乐团)	Zeppelin_(Orchestra) 
尤金四世	Eugene IV 
里弗赛德_(加利福尼亚州)	Riverside_ (California) 
孝穆成皇后	Xiaomucheng Queen 
反恐精英系列	Counter Strike Series 
俄属北美	Russian North America 
终极一班	Class A 
李吉勋	Li Jixun 
飓风戈登_(1994年)	Hurricane Gordon_ (1994) 
越南国家足球队	Vietnam National Football Team 
芝加哥火焰足球会	Chicago Fire Football Club 
姜嘉俊	Jiang Jiajun 
让-马克·埃罗	Jean-Marc Erot 
列卡度·哥利斯马	Lekadu Golisma 
昆士兰州	Queensland 
阿米尔·谢里夫丁	Amir Sharifuddin 
格里马尔迪王朝	Grimaldi Dynasty 
湖南卫视	Hunan Satellite TV 
林瑞麟	Lin Ruilin 
瑞典君主	Swedish monarch 
费利佩五世	Felipe V 
亚瑟王子_(康诺特)	Prince Arthur_ (Connaught) 
伏见宫贞爱亲王	Prince Fushimi Sadaai 
杀手：血钱	Killer: blood money 
刺客教条：阿泰尔编年史	Assassin's Creed: Chronicles of Altaïr 
夏洛特黄蜂	Charlotte Hornets 
塞西莉亚·佩恩-加波施金	Cecilia Payne-Gaboshikin 
德文郡	Devon 
李完九	Li Wanjiu 
让-皮埃尔·拉法兰	Jean-Pierre Raffarin 
沙加缅度_(加利福尼亚州)	Sacramento_ (California) 
2000年欧洲足球锦标赛	European Football Championship 2000 
刺客教条：兄弟会	Assassin's Creed: Brotherhood 
真格拿拜列治体育会	Richmond Sports Club 
阿尔及利亚战争	Algerian War 
苹果a4	Apple a4 
匈牙利总统	President of Hungary 
第三次十字军东征	Third Crusade 
卡森柏沙体育会	Carson Boss Sports Club 
大黑将志	Daikoku Shoghi 
夏尔·德·弗雷西内	Charles de Fressine 
嫌疑犯x的献身	The dedication of suspect x 
质量效应3	Mass Effect 3 
克拉斯诺达尔足球俱乐部	Krasnodar Football Club 
印度皇帝	Emperor of India 
蒙特雷足球俱乐部	Monterrey Football Club 
艾希特大学	Exeter University 
质量效应2	Mass Effect 2 
终极动员令系列	Ultimate Mobilization Order Series 
北荷兰省	North Holland Province 
约阿希姆·勒夫	Joachim Love 
瑞士足球超级联赛	Swiss Premier League 
太完美	Too perfect 
迪士尼xd	Disney xd 
耶路撒冷王国	Kingdom of Jerusalem 
纽约市立学院	City College of New York 
北卡罗来纳州立大学	North Carolina State University 
第1师团_(日本陆军)	1st Division_ (Japanese Army) 
泰坦4号运载火箭	Titan 4 launch vehicle 
最终解决德国问题条约	Treaty for the final settlement of the German problem 
蒙古语族	Mongolian 
米佐语	Mizo 
马拉雅拉姆文	Malayalam 
华纳兄弟电视公司	Warner Bros. Television 
卢布尔雅那大学	University of Ljubljana 
偷偷爱著你	Secretly loving you 
保加利亚共产党	Communist Party of Bulgaria 
首尔大学	University of Seoul 
娜经典	Na Classic 
黑木为桢	Black wood 
韦里耶	Veyrier 
朝鲜英祖	Korean Youngjo 
蒙彼利埃体育会	Montpellier Sports Club 
小奥利弗·沃尔科特	Oliver Walcott Jr. 
圣约翰勋章	Order of Saint John 
斯温登足球俱乐部	Swindon Football Club 
贝尔格莱德红星足球俱乐部	Belgrade Red Star Football Club 
中国中央电视台	China Central Television 
西雅图超音速	Seattle Supersonics 
安娜·帕夫洛芙娜_(荷兰王后)	Anna Pavlovna_ (Queen of Holland) 
荷兰国会第二院	Second House of the Dutch Parliament 
樱井和寿	Kazutoshi Hirai 
英国广播公司第三台	BBC Radio 3 
阮晋勇	Nguyen Tan Dong 
印度空军	Indian Air Force 
英国广播公司高清台	BBC HD 
火线猎杀：先进战士2	Fire Hunt: Advanced Warrior 2 
利物浦市_(新南威尔斯州)	Liverpool City_ (New South Wales) 
柱谷哲二	Tetsuji Hashiratani 
若望二十三世	John XXIII 
不丹国家足球队	Bhutan National Football Team 
法比奥·哥利亚列拿	Fabio Golialena 
德国联邦议院	German Bundestag 
索菲娅_(西班牙王后)	Sophia_(Queen of Spain) 
罗贝托一世_(帕尔马)	Roberto I_ (Parma) 
罗格斯大学	Rutgers University 
步步惊心_(电视剧)	Startling Every Step_ (TV Series) 
师奶madam	Madam 
芬兰-乌戈尔语族	Finnish-Ugric 
苹果a8	Apple a8 
崔炅焕	Cui Jionghuan 
布吉纳法索国家足球队	Burkina Faso National Football Team 
斯坎索普联足球俱乐部	Scanthorpe United Football Club 
astro华丽台	astro gorgeous station 
尼古拉·瓦西里耶维奇·果戈里	Nikolai Vasilyevich Gogol 
布尔萨体育	Bursa Sports 
派拉蒙电影	Paramount Film 
威廉二世_(尼德兰)	William II_ (Netherlands) 
艾夫斯堡体育会	Ivesburg Sports Club 
曼哈顿计划	Manhattan Project 
巴黎第二大学	University of Paris II 
新加坡国家足球队	Singapore National Football Team 
蒙特内哥罗	Montenegro 
费代丽卡·莫盖里尼	Federica Mogherini 
托斯卡纳大公国	Grand Duchy of Tuscany 
通用动力	General Dynamics 
安曼国际体育场	Amman International Stadium 
赖扬体育俱乐部	Lai Young Sports Club 
俄罗斯总统	President of Russia 
爱尔兰王国	Kingdom of Ireland 
邓迪联足球俱乐部	Dundee United Football Club 
威廉一世_(尼德兰)	William I_ (Netherlands) 
听见幸福	Hear happiness 
日本汉字	Kanji 
穆拉德二世	Murad II 
恶作剧之吻	Mischievous kiss 
未来轨迹	Future trajectory 
谭延闿	Tan Yankai 
维克多·布鲁斯，第九代额尔金伯爵	Victor Bruce, the 9th Earl of Erkin 
京沪高速铁路	Beijing-Shanghai High Speed Railway 
伊沙克帕夏	Ishak Pasha 
金崎梦生	Kinzaki Yumesheng 
光荣特库摩	Koei Tecmo 
廖了以	Liao Liyi 
奥地利足球超级联赛	Austrian Premier League 
圣但尼_(塞纳-圣但尼省)	Saint-Denis_ (Seine-Saint-Denis) 
昆汀·霍格，圣马里波恩的海尔什姆男爵	Quentin Hogg, Baron Helsham of Saint Marylebone 
利比亚全国过渡委员会	Libyan National Transitional Council 
费迪南多一世_(两西西里)	Ferdinand I_ (Two Sicily) 
江西联盛足球俱乐部	Jiangxi Liansheng Football Club 
路易十九	Louis XIX 
里耶卡足球俱乐部	Rijeka Football Club 
阿方索十二世	Alfonso XII 
亚历山德拉·费奥多罗芙娜皇后_(尼古拉一世)	Queen Alexandra Feodorovna (Nicholas I) 
千代田区	Chiyoda Ward 
野津道贯	Nozu Michitsura 
屯门体育会足球队	Tuen Mun Sports Association Football Team 
穆罕默德·哈米德·安萨里	Mohamed Hamid Ansari 
法赫德国王国际体育场	King Fahd International Stadium 
峇峇娘惹	Baba Nyonya 
伊维恩托农盖拉德足球俱乐部	Yvonne Thonongerard Football Club 
克雷芒十三世	Clement XIII 
温顿郡政府	Winton County Government 
2014年至2015年英格兰足球冠军联赛	2014-2015 English Football Champions League 
张宝春	Zhang Baochun 
虹口足球场	Hongkou Football Stadium 
司马贺	Sima He 
澳大利亚皇家空军	Royal Australian Air Force 
仙谷由人	Yoshito Sengoku 
亚美尼亚字母	Armenian alphabet 
周家蔚	Zhou Jiawei 
孝和睿皇后	Queen Xiaohe Rui 
蒙通联足球俱乐部	Mengtonglian Football Club 
重装机兵系列	Heavy equipment series 
秘鲁总统列表	List of Presidents of Peru 
中华民国陆军	Republic of China Army 
西班牙的玛丽-泰蕾兹	Mary Therese of Spain 
俄罗斯沙皇国	Tsarist State of Russia 
派崔克·基斯诺保	Patrick Kisnoble 
热情仲夏	Passionate Midsummer 
天河体育场	Tianhe Stadium 
华特迪士尼影业集团	Walt Disney Pictures Group 
李健和	Li Jianhe 
卡斯柏·舒米高	Kasper Schmidt 
延世大学	Yonsei University 
维多利亚体育俱乐部	Victoria Sports Club 
加拿大自由党	Canadian Liberal Party 
民主党_(义大利)	Democratic Party_ (Italy) 
皇家梅赫伦足球会	Royal Mechelen Football Club 
比利时的博杜安	Baudouin 
法布里西奥·多斯·桑托斯·梅西亚斯	Fabrizio dos Santos Mecias 
前原诚司	Seiji Maehara 
列卡度·哥斯达	Lekadu Costa 
舞力全开系列	Just Dance Series 
筒美京平	Kyohei Tsutsumi 
moon/blossom	moon/blossom 
战栗时空系列	Shocking Time Series 
卡纳维拉尔角空军基地41号航天发射复合体	Cape Canaveral Air Force Base 41 Space Launch Complex 
莫里斯·布尔热-莫努里	Maurice Bourget-Monuri 
洛斯阿拉莫斯国家实验室	Los Alamos National Laboratory 
克拉斯诺达尔库班足球俱乐部	Krasnodar Kuban Football Club 
皇家圣图尔登足球会	Royal St Tourdon Football Club 
艾云·希古拿	Aiyun Siguna 
吉达艾阿里体育会	Jeddah Al Ali Sports Club 
犹太-摩洛哥语	Jewish-Moroccan 
路易十五	Louis XV 
暴雪娱乐	Blizzard Entertainment 
爪哇字母	Javanese 
秃头查理	Bald Charlie 
阿鲁纳·丹达内	Aruna Dandane 
游戏音乐	Game music 
法国全国联赛	French National League 
第一代多尔切斯特男爵盖伊·卡尔顿	Guy Carlton, 1st Baron Dorchester 
哥伦比亚电影公司	Columbia Pictures 
奥尔德姆足球俱乐部	Oldham Football Club 
希腊君主列表	List of Greek monarchs 
夏舜霆	Xia Shunting 
美国国防部长	U.S. Secretary of Defense 
林子祥	Lin Zixiang 
谁人乐队	Who's Band 
休斯西部航空706号班机空难	Hughes West Air Flight 706 crash 
倭马亚王朝	Umayyad Dynasty 
具滋哲	Koo Ja-Che 
红嘴鸥	Red-headed gull 
安默斯特学院	Amherst College 
穆罕默德·本·纳伊夫·本·阿卜杜勒-阿齐兹·阿勒沙特	Mohamed bin Naif bin Abdul Aziz Al Shat 
法国共产党	Communist Party of France 
达新·钦那瓦	Darsin Shinawatra 
奥克兰_(加利福尼亚州)	Oakland_(California) 
我的亿万面包	My billions of bread 
路易十八	Louis XVIII 
梅赛德斯-宾士	Mercedes-Benz 
葡萄牙王国	Kingdom of Portugal 
新古典金属	Neoclassical metal 
马尼拉大都会	Metro Manila 
欧洲理事会主席	President of the European Council 
谢洛美·保定	Xie Luomei Baoding 
漫威娱乐	Marvel Entertainment 
陈自瑶	Chen Ziyao 
金南一	Jin Nanyi 
加拿大河	Canadian River 
愉园体育会	Happy Garden Sports Club 
涅槃乐队	Nirvana 
波音737新世代	Boeing 737 new generation 
白俄罗斯国家足球队	Belarus National Football Team 
蝙蝠侠	Batman 
阿姆斯特丹大学	University of Amsterdam 
生化危机_启示录2	Resident Evil_Revelation 2 
柳博米尔·米哈利克	Ljubomir Mihalik 
金在中	Kim Jae Jung 
维拉·薇契-斐柏嘉	Vera Weitch-Fiberger 
邓斯·司各脱	Duns Scott 
独立竞技俱乐部	Independent Athletic Club 
布里斯托尔流浪者足球俱乐部	Bristol Rangers Football Club 
乍得语族	Chadian 
台湾电视公司	Taiwan Television Company 
help!	help! 
1983–84年欧洲冠军杯	1983–84 European Champions Cup 
苏玉华	Su Yuhua 
皇家沙勒罗瓦体育俱乐部	Royal Charleroi Sports Club 
多哥国家足球队	Togo National Football Team 
魁北克法语	Quebec French 
檀国大学	Dankook University 
约克的伊丽莎白	Elizabeth of York 
阿尔斯特苏格兰语	Ulster Scots 
白川义则	Yoshinori Shirakawa 
托勒密八世	Ptolemy VIII 
卢克莱修	Lucretius 
结·分@谎情式	Knot · Points @ 假情式 
韦康比流浪者足球俱乐部	Wellcombe Rangers Football Club 
华特迪士尼影片	Walt Disney Movies 
帕丘卡足球俱乐部	Pachuca Football Club 
陈硕茂	Chen Shuomao 
堪萨斯城_(密苏里州)	Kansas City_(Missouri) 
孝敬宪皇后	Honor the queen 
唐禹哲	Tang Yuzhe 
辛伟廉	Xin Weilian 
纵横谍海：潘朵拉计划	Spy Sea: Pandora Project 
苏联部长会议主席	Chairman of the Soviet Council of Ministers 
林芳正	Lin Fangzheng 
恩万科沃·卡努	Nvankovo Kanu 
法兰西第一共和国	First French Republic 
波特诺山丘	Portno hills 
比伯军曹寂寞芳心俱乐部	Army Bieber Lonely Heart Club 
金属蕊	Metal core 
重装武力	Reloading force 
韩桑林	Han Sanglin 
气旋帕姆	Cyclone Palm 
mit许可证	mit license 
中共中央宣传部	Propaganda Department of the CPC Central Committee 
华东师范大学	East China Normal University 
朝鲜肃宗	Sukjong of Korea 
八大电视	Eight TV 
阿卜杜勒-阿齐兹·布特弗利卡	Abdul Aziz Bouteflika 
杀手乐队	Killer band 
乌克兰总理	Prime Minister of Ukraine 
塞姆斯丁·居纳尔塔伊	Samstin Gunartai 
马林_(足球运动员)	Marin_ (football player) 
高加索山脉	Caucasus Mountains 
中部日本放送	Chubu Nippon Broadcasting 
巴伊亚竞技俱乐部	Bahia Athletic Club 
雷鬼音乐	Reggae Music 
索永布文字	Soyongbu text 
美利坚联盟国	Confederate States of America 
教会斯拉夫语	Church Slavic 
美国陆军航空兵	U.S. Army Aviation 
联合公园	Union Park 
叙利亚总统	President of Syria 
三星集团	Samsung Group 
伊拉克王国	Kingdom of Iraq 
达芒语	Damang 
保加利亚王国	Kingdom of Bulgaria 
蒂凡那	Tiffany 
马里纳郡主_(根德公爵夫人)	Sheriff Marina_ (Duchess of Kent) 
积逊五人组	Jason Five 
谢讷布日里	Cheneburi 
瑞恩	Ryan 
内蒙古中优足球俱乐部	Inner Mongolia Zhongyou Football Club 
李智超	Li Zhichao 
北洋政府	Northern government 
韦洛德罗姆球场	Velodrome Stadium 
宇野宗佑	Sosuke Uno 
祖奥·彭利拿	Zuor Penlina 
ea加拿大	ea Canada 
金裕晋	Jin Yujin 
孝仪纯皇后	Xiaoyi Pure Queen 
让-阿兰·布姆松	Jean-Alain Boumsson 
达拉斯足球俱乐部	Dallas Football Club 
骇客入侵：人类革命	Hacking: Human Revolution 
尤金三世	Eugene III 
斯托克港足球俱乐部	Stoke Harbor Football Club 
帖木儿帝国	Timurid Empire 
红星大奖2004	Red Star Award 2004 
威廉·爱德华·史都瑞	William Edward Stori 
大邱足球俱乐部	Daegu Football Club 
太空摇滚	Space rock 
nhk环球广播网	nhk global broadcasting network 
神奇四侠	Fantastic Four 
法兰克王国	Frankish Kingdom 
刑事侦缉档案ii	Criminal Investigation File ii 
dischord唱片	dischord record 
路易十三	Louis the thirteenth 
苏黎世大学	University of Zurich 
曾至孝	Zeng Zhixiao 
都灵奥林匹克体育场	Torino Olympic Stadium 
红星大奖2005	Red Star Awards 2005 
令计划	Order plan 
奥斯卡二世	Oscar II 
s.k.i.n.	s.k.i.n. 
马雅人_(乐团)	Maya_ (Orchestra) 
盛装舞步爱作战	Dressage love battle 
王寿挺	Wang Shouting 
1975–76年欧洲冠军杯	1975–76 European Champions Cup 
弗拉迪米尔·魏斯_(1989年出生足球运动员)	Vladimir Weiss_ (born in 1989 football player) 
凤凰城_(亚利桑那州)	Phoenix_(Arizona) 
庄美楷	Zhuang Meikai 
英格公主	Princess Inge 
伊朗职业足球联赛	Iran Professional Football League 
美籍华人	Chinese American 
瑞士挑战联赛	Swiss Challenge League 
匈牙利人民共和国	People's Republic of Hungary 
英国皇家海军	Royal Navy 
少女时代-太蒂徐	Girls' Generation-Tai Ti Xu 
塞维鲁二世	Severus II 
北苏门答腊省	North Sumatra 
索菲亚列夫斯基足球俱乐部	Sofia Levsky Football Club 
国际电工委员会	International Electrotechnical Commission 
苹果a6x	Apple a6x 
巽他语	Sundanese 
情越双白线	Love double white line 
维多利亚公主_(黑森和莱茵)	Princess Victoria_ (Hesse and Rhine) 
永井谦佑	Kensuke Nagai 
友谊竞技场	Friendship Arena 
冀鲁官话	Jilu Mandarin 
商天娥	Shang Tian'e 
布赖恩·格里芬_(居家男人)	Brian Griffin_ (house man) 
奥兰多_(佛罗里达州)	Orlando_(Florida) 
柏保路·靴南迪斯	Bobolu Snandez 
太平洋十二校联盟	Pacific 12 Schools Alliance 
谈谈情，舞舞狮	Talk about love, lion dance 
富士宫市	Fujinomiya City 
伊比利亚罗曼语支	Iberian Romance 
特内里费体育会	Tenerife Sports Club 
羽生直刚	Naotake Hanyu 
第一代法罗顿的格雷子爵爱德华·格雷	Edward Gray, Viscount Gray of Farotton 
h.o.t.	h.o.t. 
最火搭档2	Hottest partner 2 
权俞利	Quan Yuli 
迪士尼乐园	Disneyland 
cfm56	cfm56 
托马斯·汤森，第一代悉尼子爵	Thomas Townsend, the first Viscount of Sydney 
fc游戏机	fc game console 
珍珠果酱乐队	Pearl Jam 
丹特_(足球运动员)	Dante_ (football player) 
宁夏回族自治区	Ningxia Hui Autonomous Region 
孝惠章皇后	Empress Xiao Hye Zhang 
郭少芸	Guo Shaoyun 
亚历山德拉·费奥多罗芙娜皇后_(尼古拉二世)	Queen Alexandra Feodorovna (Nicholas II) 
康士比郡	Kongsby County 
科英布拉大学足球会	University of Coimbra Football Club 
艾查殊体育会	Ai Chashu Sports Club 
新莱昂自治大学老虎足球俱乐部	Nuevo Leon Autonomous University Tiger Football Club 
拉玛七世	Rama VII 
v8_(javascript引擎)	v8_ (javascript engine) 
上川阳子	Yoko Kamikawa 
琉球国	Ryukyu Kingdom 
罗恩·詹森_(美国政治人物)	Ron Jensen_ (American political figure) 
玛丽亚·费奥多罗芙娜皇后_(亚历山大三世)	Empress Maria Feodorovna (Alexander III) 
海滩男孩	Beach boy 
苏州话	Suzhou dialect 
丹麦-挪威	Denmark-Norway 
马西米连诺一世	Massimiliano I 
常万全	Chang Wanquan 
迈凯伦车队	McLaren Team 
松井大辅	Matsui Daisuke 
无限偿还	Unlimited repayment 
犹他大学	University of Utah 
astro全佳hd	astro全佳 hd 
七月王朝	July Dynasty 
特克斯和凯科斯群岛	Turks and Caicos Islands 
日本－琉球语系	Japan-Ryukyu Language 
白朗宁m2重机枪	Browning m2 heavy machine gun 
郑俊弘	Zheng Junhong 
丹麦议会	Danish Parliament 
中加里曼丹省	Central Kalimantan 
加藤高明	Kato Takaaki 
高市早苗	Takaichi Sanae 
武装亲卫队	Armed guard 
以色列空军	Israeli Air Force 
伊东正义	Ito Masayoshi 
北部-加来海峡	North-Strait of Calais 
教宗帕斯卡二世	Pope Pascal II 
达苏莎女男爵法兰西丝·达苏莎	Frances Dasusa 
自由俱乐部	Free club 
柏林战役	Battle of Berlin 
新传媒u频道	New Media u Channel 
空中客车	Airbus 
爱上哥们	Fall in love with buddies 
菲利克斯·克莱因	Felix Klein 
西格纳伊度纳公园	Signa Iduna Park 
香港乙组足球联赛	Hong Kong Group B Football League 
中央军事委员会	Central Military Commission 
rpg制作大师	rpg maker 
甲骨文公司	Oracle Corporation 
tvbs欢乐台	tvbs happy station 
source引擎	source engine 
泰国皇家陆军	Royal Thai Army 
济南奥林匹克体育中心体育场	Jinan Olympic Sports Center Stadium 
戴克里先	Diocletian 
近代英语	Modern English 
西西里王国	Kingdom of Sicily 
拜占庭皇帝列表	List of Byzantine Emperors 
海军杰出服役勋章	Navy Distinguished Service Medal 
里夏德·冯·魏茨泽克	Richard von Weizzek 
生化奇兵	BioShock 
新疆天山雪豹足球俱乐部	Xinjiang Tianshan Snow Leopard Football Club 
周锡玮	Zhou Xiwei 
利兹大学	University of Leeds 
大韩民国陆军	Republic of Korea Army 
马利维议会	Maliwi Council 
高雄国际机场	Kaohsiung International Airport 
内阁办公室	Cabinet Office 
洪博培	Huntsman 
美国最高法院	U.S. Supreme Court 
小野伸二	Shinji Ono 
古意大利字母	Ancient Italian alphabet 
厦门话	Xiamen dialect 
芬兰21岁以下国家足球队	Finland Under-21 National Football Team 
柬埔寨人民党	Cambodian People's Party 
海江田万里	Banri Kaieda 
穆克林·本·阿卜杜勒-阿齐兹·阿勒沙特	Muklin Bin Abdul-Aziz Al Shat 
姜宁_(足球运动员)	Jiang Ning_ (football player) 
安菲尔德球场	Anfield Stadium 
自由沙姆人伊斯兰运动	Free sham islamic movement 
usa电视台	usa television 
波吉亚家族	Borgia family 
索尼影视娱乐	Sony Pictures Entertainment 
瑞士德语	Swiss German 
茂木敏充	Toshimitsu Motegi 
约拿芬·迪根斯文	Jonathan Dickensven 
路易-费迪南·塞利纳	Louis-Ferdinand Celina 
f-35闪电ii战斗机	f-35 Lightning II fighter 
姜敏赫	Kang Min-hyuk 
索迪里奥斯·卡治亚高斯	Sodi Rios Kagiagos 
法罗群岛	Faroe Islands 
利库德集团	Likud Group 
佉卢文	Lu Wen 
细田博之	Hiroyuki Hosoda 
北方萨米语	Northern Sami 
福州话	Fuzhou dialect 
剑桥大学基督学院	Cambridge University Christian College 
弗赖堡大学	University of Freiburg 
小矶国昭	Kuniaki Koiso 
萨米语	Sami 
天使的烙印	Angel's Brand 
明郑时期	Ming and Zheng period 
维拉公园球场	Villa Park Stadium 
apache许可证	apache license 
提雅斯多	Tiesto 
东加拿大因纽特语	Eastern Canadian Inuktitut 
2011–12赛季西班牙足球甲级联赛	2011-12 season Spanish Football League 
阿卜杜拉·本·阿卜杜勒-阿齐兹·阿勒沙特	Abdullah Bin Abdul-Aziz Al Shat 
加尔各答大学	University of Kolkata 
育碧巴黎	Ubisoft Paris 
拉脱维亚国家足球队	Latvia National Football Team 
李焕	Li Huan 
胖子查理	Fat Charlie 
皇家奥斯坦德足球会	Royal Ostend Football Club 
克林·波佩斯库-特里恰努	Klin Popescu-Tricianu 
恩斯特二世_(萨克森-科堡-哥达公爵)	Ernst II_ (Duke of Saxony-Coburg-Gotha) 
费尔曼·费尔曼-托马斯，第一代威灵东侯爵	Ferman Ferman-Thomas, the first Marquis of Wellingdon 
邦迪比达体育会	Bondi Bida Sports Club 
长荣航空	EVA Air 
瓜拉尼足球俱乐部	Guarani Football Club 
巴巴罗萨行动	Operation Barbarossa 
曲波_(足球运动员)	Qu Bo_ (football player) 
唐卡斯特流浪足球俱乐部	Doncaster Rangers Football Club 
突尼西亚国家足球队	Tunisia National Football Team 
杰克逊维尔_(佛罗里达州)	Jacksonville_ (Florida) 
卡森_(加利福尼亚州)	Carson_ (California) 
穆罕默德六世_(奥斯曼帝国)	Mohammed VI_ (Ottoman Empire) 
孝淑睿皇后	Queen Xiao Shurui 
近卫文麿	Konoe Fumina 
科尔切斯特联足球俱乐部	Colchester United Football Club 
威廉三世_(奥兰治)	William III_ (Orange) 
奥摩尼亚体育会	Omonia Sports 
阿斯特拉斯特里波利斯足球俱乐部	Astrastripolis Football Club 
1972–73年欧洲杯赛冠军杯	1972–73 European Cup Championship 
斯蒂凡·洛夫文	Stefan Lovewen 
庄伟建	Zhuang Weijian 
莉亚公主	Princess leia 
平定准噶尔	Ping down Junggar 
犹太-阿拉伯语	Jewish-Arabic 
他看她的第2眼	He looked at her second eye 
中华民国教育部	Ministry of Education of the Republic of China 
克里斯蒂娜女王	Queen Christina 
伍佰	Five hundred 
乌拉圭足球甲级联赛	Uruguay Football League 
乌古斯语支	Ugusic branch 
美丽的气味	Beautiful smell 
瞪鞋摇滚	Stare shoe rock 
马西米利亚诺·阿莱格里	Massimiliano Allegri 
神雕侠侣_(2006年电视剧)	Condor Heroes_ (2006 TV series) 
法国人的皇帝	Emperor of the French 
费迪南多·皮奥_(两西西里)	Ferdinando Pio_ (Two Sicily) 
以色列21岁以下国家足球队	Israel Under-21 National Football Team 
布加勒斯特星足球俱乐部	Bucharest Star Football Club 
南野拓实	Takumi Minamino 
赫伯特·基奇纳，第一代基奇纳伯爵	Herbert Kitchener, the first Earl of Kitchener 
英国皇家天文学会金质奖章	Gold Medal of the Royal Astronomical Society 
李安度·蒙迪拿·达施华	Li Andu Mondina Da Silva 
苏格兰教会	Scottish church 
维旺迪游戏	Vivendi Games 
我的自由年代	My free age 
火线猎杀：未来战士	Hunting in the Line of Fire: Future Soldiers 
槙野智章	Tomoaki Makino 
f-15e打击鹰式战斗轰炸机	f-15e strike eagle fighter bomber 
毕书尽	Bi Shu Jin 
李树烊	Li Shuyang 
小米科技	Millet Technology 
威灵顿凤凰足球俱乐部	Wellington Phoenix Football Club 
冯仁亮	Feng Renliang 
尼各老四世	Nicholas IV 
雪城大学	Syracuse University 
崔圭夏	Choi Gyuha 
第二代罗金汉侯爵查尔斯·沃森-文特沃斯	Charles Watson-Wentworth, the second Marquis of Rockingham 
卡利亚里足球俱乐部	Cagliari Football Club 
中国中央电视台综合频道	China Central Television Comprehensive Channel 
缅甸华人	Chinese in Myanmar 
莫非，这就是爱情	Could it be that this is love 
洛杉矶国际机场	Los Angeles International Airport 
飞利浦球场	Philips Stadium 
刺客教条：启示录	Assassin's Creed: Revelations 
柬埔寨君主列表	List of Cambodian monarchs 
林徽因	Lin Huiyin 
卡尔弗城_(加利福尼亚州)	Culver City_ (California) 
派崔克·艾伦	Patrick Allen 
我的野蛮奶奶	My savage grandma 
at-x	at-x 
天主教罗马教区	Roman Catholic Diocese 
爱尔兰英语	Irish English 
日本银行	Bank of Japan 
林肯镇区_(巴特勒县)	Lincoln Township_ (Butler County) 
萨尔达传说系列	The Legend of Zelda Series 
卡扎尔王朝	Qajar Dynasty 
国际标准化组织	International Organization for Standardization 
告别伤痕累累的日子	Say goodbye to the scarred days 
荷兰皇家空军	Royal Dutch Air Force 
阿根廷足球甲级联赛	Argentina Football League 
赵旭日	Zhao Xuri 
菲律宾总统	President of the Philippines 
卢均宜	Lu Junyi 
皇家穆尔西亚足球俱乐部	Real Murcia Football Club 
华裔英国人	Chinese British 
波兰空军	Polish Air Force 
金周荣	Jin Zhourong 
精灵宝可梦系列	Pokémon series 
古吉拉特文	Gujarati 
龚嘉欣	Gong Jiaxin 
世界田径锦标赛	World Athletics Championships 
阿卜杜勒-侯赛因·米尔扎·法尔曼法尔马	Abdul Hussein Mirza Farman Farma 
2008年热带风暴爱德华	2008 Tropical Storm Edward 
米仓恒贵	Yonekura Henggui 
香港特别行政区律政司司长	Secretary of Justice of the Hong Kong Special Administrative Region 
沙特弗里西语	Saudi Frisian 
越南足球甲级联赛	Vietnam Football League 
最美丽的第七天	The most beautiful seventh day 
阿斯特里德公主_(比利时)	Princess Astrid_(Belgium) 
玛丽亚·费奥多罗芙娜皇后_(保罗一世)	Empress Maria Feodorovna (Paul I) 
冰岛大学	University of Iceland 
猴岛的秘密	Secrets of Monkey Island 
匈牙利足球甲级联赛	Hungary Football League 
马瑟韦尔足球俱乐部	Motherwell Football Club 
勒哈费尔体育会	Le Hafer Sports Club 
生化危机2	Resident Evil 2 
奥林匹克国家综合体育场	Olympic National Stadium 
吴美珩	Wu Meiheng 
犹太祭司	Jewish priest 
沃特福德郡	Waterford County 
中华民国国军	National Army of the Republic of China 
阿奇博尔德·韦维尔，第一代韦维尔伯爵	Archibald Wavell, the first Earl of Wavell 
红星大奖2006	Red Star Award 2006 
呛辣红椒	Hot Chili Peppers 
瑞典社会民主工人党	Swedish social democratic workers' party 
早期西里尔字母	Early Cyrillic 
香港立法会主席	Chairman of the Hong Kong Legislative Council 
阿以冲突	Arab-Israeli conflict 
西低地德语	West Low German 
宋霭龄	Song Ailing 
我的特权	My privilege 
纵横谍海：黑名单	Spy Sea: Blacklist 
北白川宫能久亲王	Prince Nohisa Kitashirakawa 
ac/dc	ac/dc 
廖内群岛省	Riau Islands 
安达·马连拿	Anda Marina 
田中久一	Hisakazu Tanaka 
卡利体育会	Cali Sports Club 
蔡依林	Jolin Tsai 
苏格兰事务大臣	Secretary of State for Scotland 
中华人民共和国交通运输部	Ministry of Transport of the People's Republic of China 
擎天神系列运载火箭	Skyshen series launch vehicle 
尼科西亚希腊人竞技足球俱乐部	Nicosia Greek Athletic Football Club 
于汉超	Yu Hanchao 
广西平话	Guangxi Pinghua 
圣西门伯爵鲁弗鲁瓦的克劳德·亨利	Claude Henry of Roufroy, Count Saint-Simon 
第三次阿都拉内阁	Third Abdullah Cabinet 
红星大奖2007	Red Star Award 2007 
黄教安	Huang Jiaoan 
通俗拉丁语	Popular Latin 
曼彻斯特市球场	Manchester City Stadium 
粟特语	Sogdian 
圣伯多禄大殿	St. Peter's Basilica 
教宗亚历山大六世	Pope Alexander VI 
东英吉利亚大学	University of East Anglia 
贝尔法斯特女王大学	Queen's University of Belfast 
穆罕默德·阿里王朝	Muhammad Ali Dynasty 
美味关系_(台湾电视剧)	Delicious Relationship_ (Taiwan TV Series) 
玛利亚·玛塞迪斯公主	Princess Maria Mathedes 
智利甲组足球联赛	Chile First Division Football League 
柏度·比利	Berdo Billy 
永野修身	Nagano Slim 
军官·情人	Officer·Lover 
崔真理	Choi Zhenzhen 
纪念碑球场	Monument Stadium 
澳大利亚参议院	Australian Senate 
赫尔辛基大学	University of Helsinki 
谭兆伟	Tan Zhaowei 
节拍音乐	Beat music 
卡罗尔二世	Carol II 
何国泉	He Guoquan 
邱创焕	Qiu Chuanghuan 
胜诉的新宿舞娘	Shinjuku dancers who won the case 
潘代利·马伊科	Pandeli Majko 
梅里马克河	Merrimack River 
珍姐科幻大冒险	Sister Zhen Sci-Fi Adventure 
苏共中央主要负责人列表	List of main persons in charge of the Central Committee of the CPSU 
印度总统	President of India 
江北区_(宁波市)	Jiangbei District_(Ningbo) 
梦幻流行	Dream Pop 
甄子丹	Donnie Yen 
舛添要一	Jia Tian wants one 
大分三神	Oita Sanshin 
喜剧中心	Comedy Central 
朱千雪	Zhu Qianxue 
伏见宫博恭王	Fushimi Miyahiro Kyou 
孟菲斯_(田纳西州)	Memphis_(Tennessee) 
格鲁吉亚苏维埃社会主义共和国	Georgian Soviet Socialist Republic 
哈勒姆·丁尼生，第二代丁尼生男爵	Haarlem Tennyson, the second Baron Tennyson 
比属刚果	Belgian Congo 
庇护十一世	Pius XI 
拉努斯竞技俱乐部	Lanus Athletic Club 
波士尼亚与赫塞哥维纳联邦	Federation of Bosnia and Herzegovina 
北安普敦郡	Northamptonshire 
爱尔兰自由邦	Free State of Ireland 
大萨孔内	Grand saconne 
茂庭照幸	Teruyuki Moniwa 
娱乐时间电视网	Entertainment Time Television Network 
仁元王后	Queen Niwon 
加拿大皇家空军	Royal Canadian Air Force 
古木基文	Motofumi Furuki 
张晋创	Zhang Jinchuang 
天上智喜	Cheon Sang Chi Hee 
家得宝中心球场	Home Depot Center 
我那霸和树	My naha and tree 
职业挑战系列赛3	Professional Challenge Series 3 
mac电脑	mac computer 
奥古斯都	Augustus 
第三国际	Third international 
第二次阿都拉内阁	Second Abdullah Cabinet 
中国共产党中央纪律检查委员会书记	Secretary of the Central Commission for Discipline Inspection of the Communist Party of China 
兰斯体育会	Reims Sports Club 
兰银官话	Lanyin Mandarin 
buono!	good! 
森内贵宽	Morinai Kihiro 
都灵大学	University of Turin 
保加利亚人民共和国	People's Republic of Bulgaria 
深水埗运动场	Sham Shui Po Sports Ground 
马修·汉考克	Matthew Hancock 
汉莎航空	Lufthansa 
塞维利亚奥林匹克体育场	Seville Olympic Stadium 
马拉普兰县	Malappuram County 
袁浚楠	Yuan Junnan 
孝端文皇后	Queen Xiao Duanwen 
中国民用航空局	Civil Aviation Administration of China 
再次重逢的世界	The world that meets again 
新加坡总统	President of Singapore 
西喜马拉雅语支	Western Himalayan branch 
利奥波德王子_(奥尔巴尼公爵)	Prince Leopold_ (Duke of Albany) 
柏佳骏	Bai Jiajun 
中华电视公司	China Television Corporation 
大山雀	Big tits 
北爱尔兰议会	Northern Ireland Parliament 
弗雷德里克_(威尔士亲王)	Frederick (Prince of Wales) 
朝鲜高宗	Gojong, North Korea 
利伟伦	Li Weilun 
索菲亚中央陆军足球俱乐部	CSKA Sofia Football Club 
潮州民系	Chaozhou folk 
f♯	f♯ 
迷（me）	Stray (me) 
帕尼奥尼奥斯足球俱乐部	Panionos Football Club 
巴尼特足球俱乐部	Barnett Football Club 
英格兰足球议会南部联赛	English Football Council Southern League 
彝语支	Yi branch 
慕尼黑工业大学	Munich Industrial University 
好汉两个半_(第三季)	Two and a half heroes_ (season three) 
大宫站_(埼玉县)	Omiya Station_ (Saitama Prefecture) 
约旦国家足球队	Jordan National Football Team 
阿裕尼集选区	Aljunied GRC 
坂田大辅	Daisuke Sakata 
奥坦丝·德·博阿尔内	Otense de Boarnet 
西美昂二世·萨克森-科堡-哥达斯基	Simeon II Saxe-Coburg-Goldsky 
理察王子_(告罗士打公爵)	Prince Richard_ (Duke of Gloucestershire) 
乔治·马戛尔尼，第一代马戛尔尼伯爵	George Macartney, the first Earl of Macartney 
朝鲜正祖	Joseon Jeongjo 
高田寿典	Takada Hisanori 
路易维尔_(肯塔基州)	Louisville_ (Kentucky) 
佩尔利-赛尔图	Perli-Selto 
郑礼骞	Zheng Liqian 
中国足协杯	Chinese Football Association Cup 
维多利亚·尤金妮亚公主_(巴腾堡)	Princess Victoria Eugenia_ (Batenberg) 
第二法则	The second rule 
阿肯那顿	Akhenaten 
英格兰甲组联赛	England League One 
国民政府	National Government 
帕斯卡·苏巴保拿	Pascal Subabona 
国际奥林匹克委员会	International Olympic Committee 
朱玟奎	Zhu Wenkui 
阿尔梅里亚体育联盟	Almeria Sports League 
内志与哈萨酋长国	Naizhi and the Emirate of Kazakhstan 
伊朗军事	Iranian military 
乌伊佩斯特足球俱乐部	Uypester Football Club 
廉政行动2009	Integrity Action 2009 
德国电视一台	German Television One 
自由法国	Free france 
方中信	Fang Zhongxin 
明日世界	Tomorrowland 
马来西亚日据时期	Malaysian Japanese occupation period 
盖酷家庭	Gaiku Family 
陈柏良_(足球运动员)	Chen Boliang_ (football player) 
反恐精英	Counter-strike 
古法语	Old French 
苏丹沙拉胡丁	Sultan Salahuddin 
闽南民系	Minnan 
好汉两个半_(第二季)	Two and a half heroes_ (season 2) 
立见尚文	Li Jian Shangwen 
丹麦教会	Danish church 
金东进	Kim Dongjin 
费德莉卡_(希腊王后)	Federica_ (Queen of Greece) 
好汉两个半_(第四季)	Two and a half heroes_ (fourth season) 
东低地德语	East Low German 
中央邦	Madhya Pradesh 
多马戈伊·维达	Domagoy Vida 
堕落体制	system of a Down 
佐久间左马太	Sakuma Zamata 
中非法郎	Central African Franc 
黑塔小说系列	Heita Novel Series 
范徐丽泰	Fan Xu Litai 
响度乐团	Loudness Orchestra 
布兰戴斯大学	Brandeis University 
超wonderful!⑥	Super wonderful! ⑥ 
王勇_(国务委员)	Wang Yong_(State Councilor) 
若槻礼次郎	Reijiro Wakatsuki 
后阳成天皇	Emperor Goyang 
德国足球总会	German Football Association 
列卡度·蒙度利禾	Lekadu Monduliho 
妈咪的男朋友	Mommy's boyfriend 
无敌破坏王	Invincible Destruction King 
死亡空间系列	Dead Space Series 
费城联	Philadelphia United 
法兰西的路易_(1729年–1765年)	Louis of France (1729–1765) 
路易斯公主	Princess Louis 
立窝尼亚公国	Duchy of Livonia 
晓高·洛达历加	Xiaogao Rodalica 
阮文全	Ruan Wenquan 
奥地利皇帝	Emperor of Austria 
梶浦由记	Yuki Kajiura 
幻想世界	Fantasy world 
另类嘻哈	Alternative Hip Hop 
孙政才	Sun Zhengcai 
宾菲加体育会b队	Benfica Athletic Club b team 
灼眼的夏娜	Shakugan's Shana 
让-吕克·德阿纳	Jean-Luc Dahne 
法兰西的亨利埃塔·玛丽亚	Henrietta Maria of France 
生化危机6	Resident Evil 6 
台北车站	Taipei Main Station 
唐高宗	Tang Gaozong 
弗罗西诺内足球俱乐部	Frosinone Football Club 
太平洋群岛托管地	Pacific Islands Trust 
隆裕太后	Queen Mother Longyu 
法兰西第五共和国	French Fifth Republic 
哈比人：五军之战	The Hobbit: Battle of the Five Armies 
姜积弘	Jiang Jihong 
中国人民银行	People's Bank of China 
孝德显皇后	Queen Xiaodexian 
克利福德镇区_(巴特勒县)	Clifford Township_ (Butler County) 
刺客教条：大革命	Assassin's Creed: The Revolution 
基督教民主和弗拉芒党	Christian Democracy and Flemish Party 
glitter/fated	glitter/fated 
松方正义	Matsukata Masayoshi 
赫尔河畔京士顿	Kingston upon Hull 
范登堡空军基地	Vandenberg Air Force Base 
孝贤纯皇后	Xiaoxian Pure Queen 
渥太华大学	University of Ottawa 
430事件	430 events 
维多利亚·梅丽塔_(萨克森-科堡-哥达)	Victoria Merita_ (Saxony-Coburg-Gotha) 
都柏林三一学院	Trinity College Dublin 
七年战争	Seven Years War 
罗彻斯特大学	University of Rochester 
茹费理	Jules Ferry 
安德鲁·戴维斯_(足球运动员)	Andrew Davis_ (football player) 
星际大战：复制人之战_(2003年电视影集)	Star Wars: Clone Wars_ (2003 TV series) 
胶辽官话	Jiaoliao Mandarin 
英格兰足球议会北部联赛	Northern Football League 
哈利·布莱克蒙	Harry Blackmond 
英国军队	British Army 
丰田皇冠	Toyota Crown 
卡尔·弗朗岑斯格拉茨大学	Karl Franzens University of Graz 
庇护十二世	Pius XII 
柏斯波利斯足球俱乐部	Perspolis Football Club 
北大西洋公约组织	NATO 
德黑兰大学	University of Tehran 
拿祖·蒙利尔	Nazu Monlier 
艾哈迈德·马田-达夫塔里	Ahmed Martin-Daftari 
今野泰幸	Yasuyuki Konno 
林凤娇	Lin Fengjiao 
梅克伦堡-什未林大公国	Mecklenburg-Schwerin 
有你终生美丽_(电视剧)	You are beautiful forever _ (TV series) 
韩升洙	Han Shengzhu 
台湾方音符号	Taiwan dialect 
奥尔汗一世	Orhan I 
王心凌	Wang Xinling 
f4_(男子团体)	f4_ (men's team) 
费利克斯亲王_(卢森堡亲王)	Prince Felix_ (Prince of Luxembourg) 
列托-罗曼斯语	Lieto-Romans 
张纪中	Zhang Jizhong 
卡利克斯特三世	Calixter III 
纳伊夫·本·阿卜杜勒－阿齐兹·阿勒沙特	Naif Bin Abdul-Aziz Al Shat 
astro小太阳	astro little sun 
中华民国交通部	Ministry of Transport of the Republic of China 
服部年宏	Toshihiro Hattori 
弗雷德里克·亨德里克_(奥兰治亲王)	Frederick Hendrick_ (Prince of Orange) 
唐中宗	Tang Zhongzong 
卡莱尔联足球俱乐部	Carlisle United Football Club 
ah-64阿帕契直升机	ah-64 Apache helicopter 
水户蜀葵	Mito Hollyhock 
2pm	2pm 
曹芳	Cao Fang 
占美·杨格	Jimmy Young 
东台湾南岛语族	Austronesian of Eastern Taiwan 
天津团泊足球场	Tianjin Tuanbo Football Stadium 
巴恩斯利足球俱乐部	Barnsley Football Club 
亨德里克亲王_(梅克伦堡-什未林)	Prince Hendrick_ (Mecklenburg-Schwerin) 
绍利·尼尼斯托	Sauli Niinisto 
(miss)understood	(miss)understood 
纳巴泰字母	Nabatean alphabet 
温莎-梅登黑德	Windsor and Maidenhead 
西门菲莎大学	Simon Fraser University 
牛津郡	Oxfordshire 
第五代罗斯伯里伯爵阿奇博尔德·普里姆罗斯	Archibald Primrose, Fifth Earl of Rothbury 
仁孝文皇后	Queen Ren Xiaowen 
阿拉姆吉尔二世	Alam Gil II 
元明天皇	Empress Genmei 
中华帝国	Chinese Empire 
澳大利亚君主	Australian monarch 
ts娱乐	ts entertainment 
张晋	Zhang Jin 
民主柬埔寨	Democratic Cambodia 
阿尔及利亚总理	Prime Minister of Algeria 
翁贝托二世	Umberto II 
刘期纯	Liu Qichun 
依诺增爵二世	Innocent II 
柔佛州	Johor 
真爱黑白配	True love 
姜大卫	Jiang David 
李维汉	Li Weihan 
建制派	Establishment 
最高人民会议	Supreme people's assembly 
斯坦尼斯瓦夫一世	Stanislaw I 
石原伸晃	Nobuteru Ishihara 
一部分与全部/dive	Part and all/dive 
卡尔十五世	Karl XV 
华盛顿特区联	Washington DC United 
池田勇人	Hayato Ikeda 
西班牙皇家足球协会	Real Spanish Football Association 
r3hab	Horror 
邓莲如	Deng Lianru 
迪士尼动物王国	Disney's Animal Kingdom 
绍森德足球俱乐部	Southend Football Club 
以色列工党	Israel Labor Party 
斯洛文尼亚总理列表	List of Prime Ministers of Slovenia 
三级方程式欧洲系列赛	Formula 3 European Series 
巴基斯坦人民党	Pakistan People's Party 
元顺帝	Emperor Yuan Shun 
迪尔艾比球场	Deer Abbey Stadium 
乌克兰正教会_(莫斯科宗主教圣统)	Ukrainian Orthodox Church_ (Patriarch of Moscow) 
澳门足球代表队	Macau National Football Team 
东久迩宫稔彦王	King Minohiko Higashigu 
海梅_(马德里公爵)	Jaime_ (Duke of Madrid) 
仁显王后	Queen Inhyun 
欧阳靖_(饶舌者)	Ouyang Jing_ (Rapper) 
普鲁士公国	Principality of Prussia 
比萨足球俱乐部	Pisa football club 
荷兰王国	Kingdom of the Netherlands 
岸信介	Nobusuke Kishi 
瓦迪斯瓦夫四世	Władysław IV 
寮文字	Lao Script 
玛丽-泰瑞丝	Mary Tyrese 
山形新干线	Yamagata Shinkansen 
变形金刚_(2007年电影)	Transformers_ (2007 movie) 
黑执事	Black Butler 
大田市民足球俱乐部	Daejeon Citizens Football Club 
相模原市	Sagamihara 
卫斯理大学	Wesleyan University 
沙加缅度国王	King of Sacramento 
新加坡国会	Singapore Parliament 
巴斯蒂安·施魏因斯泰格	Bastian Schweinsteiger 
狂野夏洛特	Wild Charlotte 
阿伯丁大学	University of Aberdeen 
沙特阿拉伯国王	King of Saudi Arabia 
法国足球总会	French Football Association 
圣约翰安尼利女男爵乔伊思·安尼利	Joyce Annily, Baroness of St. John Annily 
p-3猎户座海上巡逻机	p-3 Orion maritime patrol aircraft 
李铭顺	Li Mingshun 
土肥洋一	Yoichi Doi 
第五代何奥子爵威廉·何奥	William Hoo, the fifth Viscount Hoo 
2014年英格兰社区盾	2014 England Community Shield 
西川周作	Shusaku Nishikawa 
克雷芒十二世	Clement XII 
土耳其大国民议会	Grand National Assembly of Turkey 
路西安奴·比治奥	Luciano Bizio 
布雷西亚足球俱乐部	Brescia Football Club 
好汉两个半_(第五季)	Two and a half men_ (season 5) 
再说一次我愿意_(电视剧)	Say it again I do _ (TV series) 
梦游仙境_(玛丽亚·凯莉专辑)	Dreaming in Wonderland_(Maria Kelly Album) 
普拉姆格罗夫镇区_(巴特勒县)	Plum Grove Township_ (Butler County) 
查尔斯·戈登-伦诺克斯，第六代里士满公爵	Charles Gordon-Lennox, 6th Duke of Richmond 
f-4幽灵ii战斗机	f-4 Ghost II fighter 
额我略十五世	Gregory XV 
布里斯本市政府	Brisbane City Council 
曹赟定	Cao Yunding 
犬夜叉	Inuyasha 
平安道方言	Ping An Tao Dialect 
叶刘淑仪	Ye Liu Shuyi 
美亭国家体育场	Meiting National Stadium 
贝尼格诺·阿基诺三世	Benigno Aquino III 
罗兰大学	Rowland University 
田纳西大学	University of Tennessee 
成均馆大学	Sungkyunkwan University 
杰尔丹·沙奇里	Gerdan Shaqiri 
金色琴弦	Golden strings 
沃特福德_(赫特福德郡)	Watford_(Hertfordshire) 
罗马大学	University of Rome 
欧几里得·察卡洛托斯	Euclid Chakalotos 
芦田均	Ashida Jun 
帕罗奥图_(加利福尼亚州)	Palo Alto_ (California) 
都柏林地区	Dublin area 
华斯高达伽马划艇会	Vasco Gamma Rowing Club 
陈公博	Chen Gongbo 
天空之城—美特拉	Sky City-Metra 
粟裕	Su Yu 
南非总统	President of South Africa 
.net框架	.net framework 
1971–72年欧洲足协杯	1971–72 UEFA Cup 
天堂执法者	Heaven enforcer 
戈亚斯体育会	Goias Sports Club 
利贝雷茨足球俱乐部	Liberec Football Club 
南京大学	Nanjing University 
山梨半造	Yamanashi Hanzo 
意大利职业足球联赛	Italian Professional Football League 
鸟取飞翔	Tottori Flying 
波特兰_(俄勒冈州)	Portland_ (Oregon) 
埃曼努埃莱·菲利贝托_(奥斯塔公爵)	Emmanuel Filiberto (Duke of Aosta) 
西班牙足球乙二级联赛	Spanish Football League Two 
澳大利亚国立大学	Australian National University 
绿洲乐队	Oasis 
阿联酋阿拉伯海湾联赛	UAE Arab Gulf League 
若泽·萨尔内	Jose Sarne 
日本航空	Japan Airlines 
美国第二夫人	Second Lady of the United States 
波蒂亚·辛普森-米勒	Portia Simpson-Miller 
斯洛文尼亚足球甲级联赛	Slovenia Football League 
国家自由党_(罗马尼亚)	National Liberal Party_ (Romania) 
尼古拉·维克托罗维奇·波德戈尔内	Nikolai Viktorovich Podgorny 
圣巴泰勒米	Saint Barthélemy 
纽约州立大学	State University of New York 
朝鲜人民军空军	Korean People's Army Air Force 
第一频道	Channel One 
爱上两个我	Fall in love with two me 
日本职业足球联赛	Japan Professional Football League 
永远的蝙蝠侠	Batman Forever 
徐若瑄	Xu Ruoxuan 
泰因河城堡球场	Tyne Castle Stadium 
巴西葡萄牙语	Brazilian Portuguese 
飓风吉尔伯特	Hurricane Gilbert 
加拿大君主	Canadian monarch 
切斯特菲尔德足球俱乐部	Chesterfield Football Club 
联合舰队	Combined fleet 
印度总理	Prime Minister of India 
中华民国足球协会	Republic of China Football Association 
微笑正义	Smile justice 
阮福保隆	Nguyen Phuc Paolo 
小嶋阳菜	Kojima Haruna 
伊利诺理工学院	Illinois Institute of Technology 
oh-58奇奥瓦侦察直升机	oh-58 Chiova reconnaissance helicopter 
施科德兰·穆斯塔菲	Schudland Mustafi 
果阿邦足球会	Goa Football Club 
中国足球协会	Chinese Football Association 
英国航空	British Airways 
杭州话	Hangzhou dialect 
智利大学足球俱乐部	University of Chile Football Club 
加利西亚足球代表队	Galician National Football Team 
巴斯蒂亚体育会	Bastia Sports Club 
红星大奖2003	Red Star Award 2003 
恩斯特一世_(萨克森-科堡-哥达)	Ernst I_ (Saxony-Coburg-Gotha) 
内博贵	Nebogui 
罗伯特·史都华，卡苏里子爵	Robert Stewart, Viscount Cassuri 
非洲联盟	African Union 
塞帕足球俱乐部	Sepa Football Club 
孟买足球会	Bombay Football Club 
保禄五世	Paul V 
权力的游戏_(电视剧)	Game of Thrones_ (TV series) 
乌克兰空军	Ukrainian Air Force 
加利福尼亚州众议院	California State House 
温哥华白帽足球会	Vancouver White Cap Football Club 
生活大爆炸_(第三季)	The Big Bang Theory_ (Season 3) 
黑田清隆	Kiyotaka Kuroda 
街头霸王_(虚拟乐团)	Street Fighter_ (Virtual Orchestra) 
瑞典足球超级联赛	Swedish Premier League 
陈威仁	Chen Weiren 
南非总理	Prime Minister of South Africa 
石川直宏	Naohiro Ishikawa 
卢恩字母	Runic alphabet 
圣安德鲁斯大学	University of St Andrews 
韩寒	Han Han 
帕尔马公国	Principality of Palma 
中央外事工作领导小组	Central Leading Group for Foreign Affairs 
摩尼字母	Mani 
清高宗继皇后	Emperor Gaozong of the Qing Dynasty 
伊甸园体育场	Eden Stadium 
杨昊_(足球运动员)	Yang Hao_ (football player) 
西游记_(2011年电视剧)	Journey to the West_ (2011 TV series) 
黑暗曙光	Dark dawn 
宾·科士打_(足球运动员)	Bin Foster_ (football player) 
幸福论_(椎名林檎单曲)	Happiness _ (Shiina Ringo single) 
第一代维明顿伯爵斯宾塞·康普顿	Spencer Compton, 1st Earl of Wilmington 
少女已过，熟女未满	The girl is over, the mature is not full 
了不起的狐狸爸爸	Great fox daddy 
维多利亚·路易丝_(普鲁士公主)	Victoria Louise (Princess of Prussia) 
李升基	Li Shengji 
超级男孩	Super Boy 
德内语支	German branch 
国立自治大学俱乐部	National Autonomous University Club 
巴洛克流行	Baroque Pop 
谦逊耗子	Humble mouse 
恩波利足球俱乐部	Empoli Football Club 
联邦巩固与发展党	Federal consolidation and development party 
日本丙组职业足球联赛	Japan Group C Professional Football League 
亚历克斯·奥克斯雷德-张伯伦	Alex Oxlade-Chamberlain 
南芳皇后	Queen Nam Fong 
打倒男孩	Down boy 
达芒语支	Damans 
巴西国家女子足球队	Brazil National Women's Football Team 
马来西亚华语	Malaysian Chinese 
尹潽善	Yin Yunshan 
小安东尼娅	Little Antonia 
奥地利的安妮	Anne of Austria 
威尼斯足球体育会	Venice Football Club 
希拉克略王朝	Heraclius 
危险情人	Dangerous lover 
全效工作室	Full effect studio 
鲍登学院	Bowdoin College 
埃及阿拉伯语	Egyptian Arabic 
石井正忠	Masatada Ishii 
音乐电视网	Music Television Network 
俄罗斯空军	Russian Air Force 
教宗乌尔巴诺二世	Pope Urbano II 
香港初级组银牌	Hong Kong Junior Group Silver Medal 
红星大奖2002	Red Star Award 2002 
杨超声	Yang Ultra 
香港特别行政区财政司司长	Financial Secretary of the Hong Kong Special Administrative Region 
纳尼亚传奇	The Chronicles of Narnia 
皮克斯动画工作室	Pixar Animation Studio 
青叶区_(横滨市)	Aoba Ward_(Yokohama City) 
北卡罗来纳大学教堂山分校	University of North Carolina at Chapel Hill 
海南话	Hainanese 
周子轩	Zhou Zixuan 
朴主永	Park Chu-young 
胜利游戏	Victory game 
美国中央司令部	U.S. Central Command 
两西西里王国	Two Kingdoms of Sicily 
阿部信行	Nobuyuki Abe 
uh-1直升机	uh-1 helicopter 
李学鹏	Li Xuepeng 
星际争霸	Starcraft 
凤凰卫视香港台	Phoenix TV Hong Kong Channel 
胡阿里·布迈丁	Huali Bumadin 
黑太子爱德华	Edward the Black Prince 
维克托三世	Victor III 
国立成功大学	National Cheng Kung University 
浩克_(足球运动员)	Hulk_ (football player) 
中华人民共和国国防部	Ministry of National Defense of the People's Republic of China 
阎嵩	Yan Song 
中古藏语	Middle Tibetan 
莫尔塔礼-戈利·巴亚特	Mortali-Goli Bayat 
赫勒·托宁-施密特	Heller Thorning-Schmidt 
苏联－阿富汗战争	Soviet-Afghan War 
得农省	Denon 
中华人民共和国外交部	People's Republic of China Ministry of Foreign Affairs 
石柯_(足球运动员)	Shi Ke_ (football player) 
傅政华	Fu Zhenghua 
谢斯伯利足球俱乐部	Shesbury Football Club 
坎塔布连方言	Cantabrian dialect 
红星大奖2001	Red Star Award 2001 
法兰西第四共和国	Fourth French Republic 
普渡大学	Purdue University 
激进左翼联盟	Radical left coalition 
北京话	Beijing dialect 
西园寺公望	Xiyuan Temple Gongwang 
立陶宛大公国	Grand Duchy of Lithuania 
剑桥郡	Cambridgeshire 
胡温体制	Huwen System 
乌克兰总统	President of Ukraine 
法鲁克一世	Farouk I 
伦敦大学亚非学院	School of Oriental and African Studies, University of London 
约翰·坎贝尔，第九代阿盖尔公爵	John Campbell, the 9th Duke of Argyll 
贵霜帝国	Guishuang Empire 
波兰立陶宛	Poland Lithuania 
谭志源	Tan Zhiyuan 
t-pain	t-pain 
利奥十三世	Leo XIII 
澳大利亚行政区划	Australian administrative divisions 
海豹部队	SEAL 
渡边千真	Watanabe Chima 
麻省理工斯隆管理学院	MIT Sloan School of Management 
查理六世_(神圣罗马帝国)	Charles VI_ (Holy Roman Empire) 
利比亚王国	Kingdom of Libya 
雷丁_(宾夕法尼亚州)	Reading_(Pennsylvania) 
恶魔在身边	The devil is around 
泽田泰司	Taiji Sawada 
文明系列	Civilization Series 
英照皇太后	Queen Mother Ying Zhao 
奥地利-巴伐利亚语	Austrian-Bavarian 
阿兹占阿都拉萨	Azjan Abdul Razak Baginda 
威廉·本廷克，第四代波特兰公爵	William Bentinck, fourth Duke of Portland 
每一次	every time 
宋博轩	Song Boxuan 
日语假名	Japanese Kana 
新加坡福建话	Singapore Hokkien 
兰顿·当奴云	Langton Downey 
尚州尚武足球俱乐部	Sangju Sangmu Football Club 
山景城_(加利福尼亚州)	Mountain View_ (California) 
埃玛公主_(瓦尔德克-皮尔蒙特)	Princess Emma_ (Waldeck-Pyrmont) 
艾华路·彭利拿	Alvaro Penlina 
芬兰总统	President of Finland 
w&w	w&w 
绿光森林	Green Light Forest 
法律与公正	Law and justice 
蜘蛛人	Spider-Man 
教宗何诺二世	Pope Horno II 
伊斯法罕佐布阿汉足球俱乐部	Isfahan Zob Ahan Football Club 
冯光青	Feng Guangqing 
杨旭	Yang Xu 
若弗鲁瓦二世_(布列塔尼)	Geoffroy II_ (Brittany) 
因杜利斯·埃姆西斯	Indulis Emsis 
伊莎贝拉二世	Isabella II 
朝鲜纯祖	Chosun Cho 
孝懿王后	Queen Xiaoyi 
费迪南多一世_(帕尔马)	Ferdinand I_ (Parma) 
奥尔格里特足球俱乐部	Allgrit Football Club 
夏洛特_(卢森堡大公)	Charlotte_(Grand Duke of Luxembourg) 
无法满足	Not satisfied 
洛杉矶纪念体育场	Los Angeles Memorial Stadium 
透明色_(乃木坂46专辑)	Transparent color_ (Nogizaka 46 album) 
茱迪·科士打	Judy Foster 
苹果a5x	Apple a5x 
风的啦啦啦	Windy la la la 
飓风伊西多尔	Hurricane Isidore 
那楚克·巴嘎班迪	Nachuk Bagabandi 
新加坡总理	Prime Minister of Singapore 
伊雷娜·德古蒂埃内	Irene De Gutierne 
好想谈恋爱	I really want to fall in love 
法兰西的路易_(1661-1711)	Louis of France (1661-1711) 
橙子焦糖	Orange caramel 
奈洛比	Nairobi 
程拜仁	Cheng Bairen 
李丽珍	Li Lizhen 
玩具总动员3	Toy Story 3 
阿伦敦_(宾夕法尼亚州)	Allentown_(Pennsylvania) 
大韩民国空军	Republic of Korea Air Force 
池东沅	Chi Dongyuan 
第一代西蒙子爵约翰·西蒙	John Simon, Viscount Simon 
tiger×dragon！	tiger×dragon! 
奥地利德语	Austrian German 
中央山脉_(伊比利亚半岛)	Central Mountains_ (Iberian Peninsula) 
艾因	Ain 
空中客车a300	Airbus a300 
香淳皇后	Queen Xiangshun 
威秀电影	Wayshow Movie 
民主行动党_(马来西亚)	Democratic Action Party_ (Malaysia) 
穆罕默德-阿里·纳杰菲	Muhammad Ali Najafi 
高梨康治	Yasuharu Takanashi 
果阿邦	Goa 
郑秀晶	Zheng Xiujing 
联盟驻伊拉克临时管理当局	Coalition Provisional Administration in Iraq 
飓风丽丽	Hurricane Lili 
涂醒哲	Tu Xingzhe 
上越新干线	Joetsu Shinkansen 
加的斯足球俱乐部	Cadiz Football Club 
老爸老妈的浪漫史	how I Met Your Mother 
唐迪拉体育会	Dondila Sports Club 
挣脱宿命合唱团	Breaking Free from Fate Choir 
张丰毅	Zhang Fengyi 
奥拉夫五世	Olaf V 
匈牙利王国_(1920–1946)	Kingdom of Hungary_(1920–1946) 
巴哈杜尔沙二世	Bahadursha II 
波兰流亡政府	Polish government in exile 
格奥尔格_(萨克森-迈宁根)	Georg_ (Saxony-Meiningen) 
医院骑士团	Knights Hospital 
约克公爵安德鲁王子	Prince Andrew, Duke of York 
starship娱乐	starship entertainment 
查理三世_(西法兰克)	Charles III_ (West Franco) 
魔法少女小圆	Madoka Magica 
福林德斯郡政府	Flinders County Government 
卢展工	Lu Zhangong 
任天堂wi-fi连接	Nintendo Wi-Fi connection 
内志与汉志王国	Neizhi and the Kingdom of Hanzhi 
古斯塔夫五世	Gustav V 
女王公园足球俱乐部	Queens Park Football Club 
雪兰莪	Selangor 
花漾年华	Blooming years 
赵容衡	Zhao Rongheng 
dice洛杉矶	dice los angeles 
西苏门答腊省	West Sumatra 
英格兰女子足球代表队	England Women's Football Team 
平野博文	Hirofumi Hirano 
梅赛德斯amg车队	Mercedes-AMG Team 
托勒密六世	Ptolemy VI 
亚布洛内茨足球俱乐部	Jablonec Football Club 
圣塔克鲁兹加利福尼亚大学	University of California, Santa Cruz 
第聂伯罗彼得罗夫斯克足球俱乐部	Dnipropetrovsk Football Club 
佛罗里达大学	University of Florida 
青海森科足球俱乐部	Qinghai Senke Football Club 
额我略九世	Gregory IX 
乾贵士	Takashi Inui 
兰尼埃三世	Rainier III 
刘永清	Liu Yongqing 
万维网联盟	World Wide Web Consortium 
马尔他骑士团	Knights of Malta 
郭胜_(足球运动员)	Guo Sheng_(Football Player) 
伍冰枝	Wu Bingzhi 
意大利足球丁级联赛	Italian Football League 
罗瑟勒姆足球俱乐部	Rotherham Football Club 
游骑兵8号	Ranger 8 
川村景明	Kawamura Keaki 
光明球场	Stadium of Light 
鸭绿江体育团	Yalu River Sports Team 
大人小孩双拍档	Adult and child dual partner 
群青日和	Ideal Days for Ultramarine 
伊瑟力治郡政府	Iserwich County Government 
格拉纳达足球俱乐部	Granada Football Club 
游骑兵7号	Ranger 7 
马斯里体育俱乐部	Masri Sports Club 
田刚	Tian Gang 
爱之歌	Love song 
2002年飓风凯尔	2002 Hurricane Kyle 
胡威威	Hu Weiwei 
纽约州议会	New York State Assembly 
空中客车a340	Airbus a340 
红星足球俱乐部	Red Star Football Club 
莱昂诺尔_(阿斯图里亚斯公主)	Leonor_ (Princess of Asturias) 
朱挺	Zhu Ting 
埼玉2002体育场	Saitama 2002 Stadium 
美国航空191号班机空难	American Airlines Flight 191 crash 
少女的祈祷_(布兰妮·斯皮尔斯歌曲)	Maiden's Prayer_ (Britney Spears song) 
淘气小亲亲	Naughty kiss 
莱蒂西亚_(西班牙王后)	Leticia_(Queen of Spain) 
伊朗最高领袖	Supreme Leader of Iran 
王霏霏	Wang Feifei 
狄金森学院	Dickinson College 
职业挑战系列赛5	Professional Challenge Series 5 
约翰·保罗·琼斯_(音乐家)	John Paul Jones_ (musician) 
贝恩哈德王子_(利珀-比斯特费尔德)	Prince Bernhard_ (Lipper-Bisterfeld) 
荷属东印度日据时期	Dutch East India Japanese Occupation Period 
马凯特大学	Marquette University 
酒井高德	Sakai Gaode 
贝伦人足球俱乐部	Belém Football Club 
畑俊六	Hata Shunroku 
越南帝国	Vietnam Empire 
黎凡特阿拉伯语	Levantine Arabic 
俄白联盟	Russian-Belarusian Union 
北西兰足球俱乐部	North Sealand Football Club 
胡安_(蒙提宗伯爵)	Juan_(Count of Montizon) 
君士坦丁三世	Constantine III 
利亚内拉	Llanella 
陶伟_(1966年出生)	Tao Wei_ (born in 1966) 
法国业馀联赛	French Amateur League 
美国陆军游骑兵	U.S. Army Rangers 
索尼电脑娱乐全球工作室	Sony Computer Entertainment Global Studio 
米哈伊尔·亚历山德罗维奇_(亚历山大三世之子)	Mikhail Alexandrovich (son of Alexander III) 
米尔顿镇区_(巴特勒县)	Milton Township_ (Butler County) 
塞帕汉足球俱乐部	Sepahan Football Club 
游骑兵4号	Ranger 4 
和歌山县	Wakayama County 
王亮_(1989年出生)	Wang Liang_ (born in 1989) 
本笃十三世	Benedict XIII 
元正天皇	Empress Gensho 
翟威廉	William Zhai 
本杰明·富兰克林·巴特勒_(1795年出生)	Benjamin Franklin Butler (born in 1795) 
和田昌裕	Masahiro Wada 
拉斐尔·瓦拉内	Rafael Varane 
google光纤	google fiber 
"jumpin"]	"jumpin"] 
雷定三世	Lei Ding III 
你让我疯狂	you make me Crazy 
克里西乌马竞技俱乐部	Crissium Athletic Club 
波希米扬斯1905足球俱乐部	Bohemia 1905 Football Club 
麦克·卡顿保	Mike Cattonbau 
元明宗	Yuan Mingzong 
克伦语支	Karen branch 
马修·华贝拿	Matthew Waberner 
东京迪士尼乐园	Tokyo Disneyland 
d-day_(电视剧)	d-day_ (TV series) 
阿斯特里德王后_(比利时)	Queen Astrid_ (Belgium) 
古斯塔夫·阿道夫亲王	Prince Gustav Adolf 
2011年西班牙超级杯	Spanish Super Cup 2011 
维斯理学院	Wesley College 
禾克斯公园球场	Hex Park Stadium 
威廉·琼斯_(1760年出生)	William Jones_ (born in 1760) 
最终幻想x	Final Fantasy x 
神秘竞速者	Mystery racer 
2009年英格兰社区盾	2009 England Community Shield 
香港足球总会	Hong Kong Football Association 
威廉姆斯学院	Williams College 
圣保罗书院	St. Paul's College 
gtk+	gtk+ 
防卫者体育	Defender Sports 
格罗兹尼捷列克足球俱乐部	Grozny Terek Football Club 
怒苏语	Nusu 
俄罗斯苏维埃联邦社会主义共和国人民委员会	People's Committee of the Russian Soviet Federal Socialist Republic 
海南航空	Hainan Airlines 
巴西海军	Brazilian Navy 
给索恩_(昆士兰州)	To Thorne_ (Queensland) 
里奇蒙郡政府	Richmond County Government 
乃木希典	Maresuke Nogi 
阿特罗米托斯足球俱乐部	Atromitos Football Club 
砵甸乍	Pottinger 
中国东方航空	China Eastern Airlines 
温州葆隆足球俱乐部	Wenzhou Baolong Football Club 
野兽男孩	Beast boy 
days/green	days/green 
火炬木小组	Torchwood Group 
游骑兵6号	Ranger 6 
巴厘字母	Balinese 
耶拿大学	University of Jena 
庇护十世	Pius X 
张玉宁_(1997年出生)	Zhang Yuning_ (born in 1997) 
威廉王子_(格洛斯特)	Prince William_ (Gloucester) 
中山王国	Zhongshan Kingdom 
流星花园_(韩国电视剧)	Meteor Garden_ (Korean TV Drama) 
杜震宇	Du Zhenyu 
庆南足球俱乐部	Kyungnam Football Club 
伊利诺大学	University of Illinois 
徐锦江	Xu Jinjiang 
卡瑞_(北卡罗莱纳州)	Cary_ (North Carolina) 
马丁五世	Martin V 
韩国国会	Korean National Assembly 
山崎正昭	Masaaki Yamazaki 
羌语支	Qiang language branch 
教宗本笃十四世	Pope Benedict XIV 
1976–77年欧洲冠军杯	1976–77 European Champions Cup 
莱茵邦联	Rhine Confederation 
泰坦系列运载火箭	Titan series launch vehicle 
虔诚者路易	Louis the Pious 
fearless唱片	fearless record 
文虎一	Wen Huyi 
赵宏略	Zhao Honglue 
斯蒂芬_(英格兰国王)	Stephen_ (King of England) 
艾奥瓦大学	University of Iowa 
俄罗斯共和国	Republic of Russia 
基地组织	Al Qaeda 
最后一战：战斗进化	The last battle: battle evolution 
萨格勒布足球俱乐部	Zagreb Football Club 
齐塔皇后_(奥匈帝国)	Queen Zeta_ (Austro-Hungarian Empire) 
卫藏方言	Wei Zang dialect 
克拉克大学	Clark University 
卡迪斯亚体育会	Kadizia Sports Club 
江东区_(东京都)	Koto Ward_(Tokyo) 
新见政一	Masaichi Niimi 
卡洛斯·乌戈_(帕尔马)	Carlos Hugo_ (Parma) 
料理高校生	Cooking high school student 
伊拉克国家男子足球队	Iraqi National Men's Football Team 
英格兰乙组联赛	England League Two 
身延町	Minobu Town 
haswell微架构	haswell microarchitecture 
田村宪久	Tamura Kenhisa 
樱花绽放于酸甜春季	Cherry blossoms bloom in sweet and sour spring 
唐睿宗	Tang Ruizong 
初音未来	Hatsune Miku 
贝德福德郡	Bedfordshire 
rise唱片	rise record 
闽东语	Mindong 
火影忍者	Naruto 
大同足球队	Datong Football Team 
丹麦的乔治王子	Prince George of Denmark 
马来西亚超级足球联赛	Malaysia Super League 
漂流者_(美国组合)	Drifters_ (American Group) 
塔拉戈纳体操	Tarragona gymnastics 
斯台普斯中心	Staples Center 
王喜	Wang Xi 
罗莹雪	Luo Yingxue 
越南共和国第1军	1st Army of the Republic of Vietnam 
周刊少年magazine	Weekly Junior Magazine 
伍斯特_(马萨诸塞州)	Worcester_ (Massachusetts) 
李·邦比	Lee Bangby 
白线条乐团	White Lines 
霍比特人2：史矛革之战	The Hobbit 2: The Battle of Smaug 
科威特国家男子足球队	Kuwait National Men's Football Team 
冢野真树	Tsukano Maki 
锡金语	Sikkim 
卡罗琳_(安斯巴赫)	Caroline_ (Ansbach) 
科尔多瓦足球俱乐部	Cordoba Football Club 
第6师团_(日本陆军)	6th Division_ (Japanese Army) 
凉宫春日系列	Haruhi Suzumiya Series 
麦德林独立	Medellin independence 
旺阿兹莎	Wan Azizah 
冈萨洛·伊瓜因	Gonzalo Higuain 
jungle娱乐	jungle entertainment 
牛津大学莫德林学院	Modlin College, Oxford University 
大卫·帕特森_(政治人物)	David Patterson_ (political figure) 
郑大世	Zheng Dashi 
黑街圣徒系列	Black Street Saints Series 
约翰·j·麦金太尔_(政治人物)	John J. McIntyre_ (political figure) 
民谣金属	Folk Metal 
爱尔兰共和国_(1919–1922)	Republic of Ireland_(1919–1922) 
卡塞利体育	Caseli Sports 
崔鹏_(足球运动员)	Cui Peng_ (football player) 
盐崎恭久	Yasuhisa Shiozaki 
1982–83年欧洲冠军杯	1982–83 European Champions Cup 
英国三级方程式锦标赛	British Formula Three Championship 
里斯本大学	University of Lisbon 
比尔森胜利足球俱乐部	Pilsen Victory Football Club 
萨伏依	Savoy 
红星大奖2009	Red Star Awards 2009 
绚香金曲极选_2006-2009	Xuanxiang Golden Melody Selection_2006-2009 
东京电视网	TV TOKYO 
马斯泰拿球场	Masters Stadium 
第七章“太美了真抱歉”	Chapter 7 "Sorry to be so beautiful" 
升阳电脑	Sun Computer 
詹姆斯·布鲁斯，第八代额尔金伯爵	James Bruce, the 8th Earl of Elgin 
扇谷健司	Kenji Ogiya 
田中义一	Tanaka Yoshiichi 
热带风暴汉娜	Tropical Storm Hannah 
阿尔萨斯-香槟-阿登-洛林	Alsace-Champagne-Ardennes-Lorraine 
卡昂马莱伯体育会	Caen Malebe Sports Club 
雒树刚	Luo Shugang 
e-3空中预警机	e-3 airborne early warning aircraft 
哈维尔王子_(波旁-帕尔马)	Prince Javier_ (Bourbon-Parma) 
阿卜杜勒-迈吉德二世	Abdul-Mejid II 
柬埔寨国民议会	National Assembly of Cambodia 
伊诺给拉区_(昆士兰州)	Inogela District_ (Queensland) 
特纳经典电影频道	Turner Classic Movie Channel 
立法院院长	President of the Legislative Yuan 
卡洛斯·山塔那	Carlos Santana 
unite!	united ! 
新西兰工党	New Zealand Labor Party 
好汉两个半_(第一季)	Two and a half heroes_ (season one) 
玛格丽特_(瓦卢瓦)	Marguerite_ (Valois) 
上古汉语	Ancient Chinese 
詹姆斯_(塞文子爵)	James_ (Viscount Severn) 
横山由依	Yokoyama Yui 
2010年英格兰社区盾	2010 England Community Shield 
美属维尔京群岛	United States Virgin Islands 
rule/sparkle	rule/sparkle 
神游科技	Shenyou Technology 
黎公荣	Li Gongrong 
嗣永桃子	Tsugunaga Momoko 
我们仍未知道那天所看见的花名。	We still don't know the name of the flower we saw that day. 
上海体育场	Shanghai Stadium 
王彤_(足球运动员)	Wang Tong_(football player) 
洪七公	Hong Qigong 
北安普顿足球俱乐部	Northampton Football Club 
阿当·拉尔拉拿	Adam Lalana 
宝活议会	Burwood Council 
突尼斯总统	President of Tunisia 
伦敦帝国学院	Imperial College London 
川又坚碁	Chuanyou 
四日市市	Yokkaichi 
普利茅斯足球俱乐部	Plymouth Football Club 
蒂姆·伯纳斯-李	Tim Berners-Lee 
云路足球俱乐部	Yunlu Football Club 
德国国家女子足球队	Germany Women's National Football Team 
饶舌金属	Rap Metal 
加利福尼亚大学圣塔芭芭拉分校	University of California Santa Barbara 
约翰·列侬/塑胶小野乐团	John Lennon/Plastic Ono 
孝哲毅皇后	Queen Xiaozheyi 
路易二世_(西法兰克)	Louis II_ (West Franco) 
绿区_(横滨市)	Midori Ward_(Yokohama City) 
中你的毒	Poison you 
法国业馀乙组联赛	French Amateur League Two 
比萨高等师范学校	Higher Normal School of Pisa 
币原喜重郎	Kihara Kijuro 
中华人民共和国最高人民法院	Supreme People's Court of the People's Republic of China 
七级炼狱	avenged sevenfold 
丹尼臣·哥度巴	Denison Cordoba 
如龙系列	Rulong series 
盛光祖	Sheng Guangzu 
麦金利郡政府	McKinley County Government 
sage引擎	sage engine 
路易斯·亚历山大·蒙巴顿，第一代米尔福德黑文侯爵	Louis Alexander Mountbatten, the first Marquis of Milford Haven 
枕边故事_(玛丹娜专辑)	Pillow Story_(Madonna Album) 
基尔肯尼郡	Kilkenny County 
法布里西奥·科洛奇尼	Fabrizio Kolocini 
李始荣	Li Sirong 
博莱斯拉夫足球俱乐部	Boleslav Football Club 
至上女声组合	Supreme Female Voice Group 
大野忍	Ohno Shinobu 
赫尔辛基奥林匹克体育场	Helsinki Olympic Stadium 
依诺增爵七世	Innocent VII 
纳瓦拉王国	Kingdom of Navarra 
徐一鸿	Xu Yihong 
范文同	Fan Wentong 
维多利亚王储	Crown Prince of Victoria 
阿拉贡的凯瑟琳	Catherine of Aragon 
梨本宫守正王	Shouzheng King 
罗马尼亚人	Romanian 
李智塱	Li Zhilong 
阿尔巴尼亚社会主义人民共和国	Socialist People's Republic of Albania 
克隆克里郡政府	Clone Kerry County Government 
邱添一	Qiu Tianyi 
张耀坤	Zhang Yaokun 
同庆帝	Emperor Tongqing 
澳大利亚众议院	Australian House of Representatives 
祁济时	Qi Jishi 
春日井市	Kasugai City 
荷兰足球乙级联赛	Dutch Football League 
家长昭博	Parent Zhao Bo 
八王子市	Hachioji City 
阿塔图尔克奥林匹克体育场	Ataturk Olympic Stadium 
枪与玫瑰	Gun and rose 
克鲁足球俱乐部	Crewe Football Club 
古典拉丁语	Classical Latin 
列治文	Richmond 
年少轻狂	Young and frivolous 
罗马尼亚足球甲级联赛	Romanian Football League 
怀克里夫·让	Wycliffe Jean 
徐守盛	Xu Shousheng 
回鹘语	Uighur 
安大略省省议会	Ontario Provincial Assembly 
巴黎迪士尼乐园	Disneyland Paris 
武汉大学	Wuhan University 
娜塔莉·科修斯柯－莫里塞	Natalie Kosciusko-Morise 
摩根·舒尼达连	Morgan Sunidalian 
飓风艾克	Hurricane Ike 
天生自然	Natural 
倪玉崧	Ni Yusong 
莱斯大学	Rice University 
黄克诚	Huang Kecheng 
阿卜杜勒-哈米德二世	Abdul Hamid II 
尼各老三世	Nicholas III 
普雷尼-尚贝西	Preny-Chambeth 
俄国二月革命	Russian February Revolution 
第二次布匿战争	Second Punic War 
教宗博义八世	Pope Boyi VIII 
中国蒙古族	Chinese Mongolian 
大马士革大学	University of Damascus 
达斯泰特98体育会	Dastedt 98 Sports Club 
赵铭_(足球运动员)	Zhao Ming_ (Football Player) 
克雷芒三世	Clement III 
多哈艾阿拉比体育俱乐部	Al Arabi Sports Club Doha 
宇津木瑠美	Rumi Utsugi 
旋风管家	Hayate the Combat Butler 
良十一世	Liang XI 
新藤义孝	Yoshitaka Shindo 
斯洛伐克足球超级联赛	Slovak Premier League 
哈佛医学院	Harvard Medical School 
佛雷德里科·查韦斯·格德斯	Frederico Chavez Godes 
维希法国	Vichy France 
皇家荷兰足球协会	Royal Dutch Football Association 
基多利加大学体育会	Quito Liga University Sports Club 
拉瓦尔大学	Laval University 
藤谷阳介	Yosuke Fujigaya 
路德维科一世_(伊特鲁里亚)	Ludwig I_ (Etruscan) 
德里大学	Delhi University 
阿尔巴尼亚劳动党	Albanian Labour Party 
欢乐.乐团	Joy. Orchestra 
小町号列车	Komachi Train 
雷定二世	Lei Ding II 
校园迷糊大王	Campus Confusion King 
大久保嘉人	Yoshito Okubo 
大流士三世	Darius III 
英沙里	Insari 
教宗维笃一世	Pope Vitus I 
索马里内战	Somali Civil War 
约瑟芬·德·博阿尔内	Josephine de Boarnet 
托米斯拉夫二世	Tomislav II 
得墨忒耳	Demeter 
history/ghosts	history/ghosts 
别让我最后知道	Don't let me know at last 
希尔星堡体育会	Hill Star Sports Club 
伦敦奥林匹克体育场	London Olympic Stadium 
现代标准阿拉伯语	Modern Standard Arabic 
因德尔·库马尔·古杰拉尔	Inder Kumar Gujral 
东村山市	Higashimurayama 
奥地利的安娜_(1573年-1598年)	Anna of Austria (1573-1598) 
中华台北五人制足球代表队	Chinese Taipei Futsal Team 
李源一	Li Yuanyi 
石桥湛山	Shiqiao Zhanshan 
鲤明水体育团	Liming Water Sports Team 
沈阳奥林匹克体育中心	Shenyang Olympic Sports Center 
泽田研二	Kenji Sawada 
南安普敦大学	University of Southampton 
佛罗伦萨大学	University of Florence 
亲卫队第1师	1st Guards Division 
元文宗	Yuan Wenzong 
吴曦_(足球运动员)	Wu Xi_ (football player) 
吉林大学	Jilin University 
占美·加历查	Jimmy Calica 
谢佳见	Xie Jia see 
穆罕默德一世_(奥斯曼帝国)	Muhammad I_ (Ottoman Empire) 
拉孔内	La Conne 
美国陆军特种部队	U.S. Army Special Forces 
海得拉巴_(土邦)	Hyderabad 
驹野友一	Yuichi Komano 
苏格兰民族党	Scottish National Party 
约阿希姆·高克	Joachim Gaoke 
你快乐_我快乐	You happy_i happy 
剑桥公爵威廉王子	Prince William, Duke of Cambridge 
卡斯柏·安卡格连	Kasper Ankagren 
谭震林	Tan Zhenlin 
阿梅迪奥_(第三代奥斯塔公爵)	Amedio_ (the third Duke of Aosta) 
克娄巴特拉二世	Cleopatra II 
河岸球场	Riverside Course 
弗罗茨瓦夫大学	University of Wroclaw 
清浦奎吾	Qingpu Kuiwu 
纳粹德国陆军	Nazi German Army 
游骑兵5号	Ranger 5 
中国达人秀_(第二季)	China's Got Talent_(Season 2) 
白鹿径球场	White Hart Trail 
火星侦察轨道器	Mars Reconnaissance Orbiter 
中华民国中央银行	Central Bank of the Republic of China 
蔡锷与小凤仙	Cai E and Xiaofengxian 
河内t&t足球俱乐部	Hanoi t&t football club 
灵魂解放	Soul liberation 
好莱坞环球影城	Hollywood Universal Studios 
西班牙海军	Spanish Navy 
波希米亚狂想曲	Bohemian Rhapsody 
圣武天皇	Emperor Shengmu 
法兰西第二共和国	Second French Republic 
何诺三世	Horno III 
德黑兰帕斯足球俱乐部	Tehran Pass Football Club 
2009年中国足球超级联赛	2009 Chinese Football Super League 
通用电气genx发动机	General Electric genx engine 
夏威夷共和国	Republic of Hawaii 
钉宫理惠	Kugimiya Rie 
马尔蒂·阿赫蒂萨里	Marti Ahtisaari 
河田晃兵	Kohei Kawata 
红色风暴娱乐	Red Storm Entertainment 
成都双流国际机场	Chengdu Shuangliu International Airport 
中国俄罗斯族	Chinese Russian 
新西兰航空	Air New Zealand 
恶作剧之吻_(韩国电视剧)	Mischievous Kiss_ (Korean TV Drama) 
贝里足球俱乐部	Berry football club 
协约国武装干涉俄国内战	Allied forces intervened in the Russian Civil War 
纽卡斯尔喷气机足球俱乐部	Newcastle Jets Football Club 
康科德_(新罕布什尔州)	Concord_ (New Hampshire) 
鄂毕-乌戈尔诸语言	Ob-Ugric languages 
就是要你爱上我	Just want you to fall in love with me 
格罗瑟托足球俱乐部	Grosseto Football Club 
黑莓手机	Blackberry 
路爵二世	Lujue II 
哈康六世	Hakon VI 
刘逸云	Liu Yiyun 
穆罕默德-礼萨·拉希米	Muhammad-Reza Rahimi 
英格兰北部超级联赛	Northern England Premier League 
波道帕耶	Podapaje 
佩那罗尔足球俱乐部	Penarol Football Club 
捷克斯洛伐克流亡政府	Czechoslovak Government in Exile 
柳原爱子	Yanagihara Naruko 
李香凝	Li Xiangning 
额我略十二世	Gregory XII 
西南航空	Southwest Airlines 
2011年英格兰社区盾	2011 England Community Shield 
宋元战争	Song Yuan War 
首尔衣恋足球俱乐部	Seoul Yilian Football Club 
格拉斯哥卡利多尼安大学	Caledonian University of Glasgow 
那不勒斯语	Neapolitan 
曼利议会	Manly Council 
蒙哥马利_(亚拉巴马州)	Montgomery_ (Alabama) 
本地治里市	Pondicherry 
1989–90年欧洲足协杯	1989-90 UEFA Cup 
娱乐周刊	Entertainment Weekly 
kat-tun	kat-tun 
森重真人	Mori Shige 
1971–72年欧洲冠军杯	1971–72 European Champions Cup 
植物学湾市	Botany Bay 
浦那	Pune 
中华民国内政部	Ministry of Internal Affairs of the Republic of China 
崔东昱	Cui Dongyu 
张震_(上将)	Zhang Zhen_(Admiral) 
第一代法夫公爵亚历山大·达夫	Alexander Duff, Duke of Fife 
试金石影业	Touchstone Pictures 
扎多敏梭	Zadominsuo 
大卫·库塔_(赛车手)	David Kuta_ (racing driver) 
让-巴蒂斯特·拉马克	Jean-Baptiste Lamarck 
德意志皇帝	German Emperor 
邦乔飞	Bon Joe Fei 
费利克斯王子	Prince Felix 
2011年欧洲超级杯	European Super Cup 2011 
杀手2：沉默刺客	Killer 2: Silent Assassin 
仁荷大学	Inha University 
老爸老妈的浪漫史_(第四季)	Mom and Dad's Romance_(Season 4) 
贝蒂尔亲王	Prince betil 
阿尔伯特·维克托王子_(克拉伦斯和阿文代尔公爵)	Prince Albert Victor_ (Duke of Clarence and Avondale) 
皮亚琴察足球俱乐部	Piacenza Football Club 
巴西足球丙级联赛	Brazilian Football League C 
佐藤荣作	Sato Eisaku 
鞑靼语	Tatar 
老爸老妈的浪漫史_(第三季)	Mom and Dad's Romance_(Season 3) 
塔夫茨大学	Tufts University 
伊朗总统	President of Iran 
爱在你左右	Love is around you 
芳泽谦吉	Yoshizawa Kenji 
圣文亚当奥林匹克体育馆	St. Vincent Adam's Olympic Stadium 
阿卜杜勒-迈吉德一世	Abdul-Mejid I 
冯慧兰	Feng Huilan 
泰国国家足球队	Thailand National Football Team 
韩家宝	Han Jiabao 
祖汉·佐罗	Zuhan Zorro 
板野友美	Tomomi Itano 
科普特语	Coptic 
让·迪厄多内	Jean Dieudone 
蒙古入侵高丽	Mongolia invades Goryeo 
抢救雷恩大兵	Rescue Private Rennes 
塞纳-圣但尼省	Seine-Saint-Denis 
樱花纷飞时	When the cherry blossoms are flying 
贵由	Kiyu 
跑车浪漫旅系列	Sports car romantic travel series 
明成皇后	Empress Myeongseong 
锡耶纳足球俱乐部	Siena Football Club 
中国达人秀_(第三季)	China's Got Talent_(Season 3) 
博多-库奇语支	Bodo-Kuchi 
中国传媒大学	Communication University of China 
苑琼丹	Yuan Qiongdan 
西斯都四世	Sistus IV 
四川大学	Sichuan University 
罗贝尔二世_(诺曼底)	Robert II_ (Normandy) 
扎马莱克体育俱乐部	Zamalek Sports Club 
对伊斯兰国的军事打击	Military strikes against Islamic State 
刑事侦缉档案	Criminal Investigation File 
千叶和彦	Chiba Kazuhiko 
沃尔索尔足球俱乐部	Walsall Football Club 
义大利-达尔马提亚语支	Italian-Dalmatian branch 
橘子新乐园	Orange New Paradise 
卢戈体育俱乐部	Lugo Sports Club 
马尔科姆四世	Malcolm IV 
英国疯狂汽车秀	British Crazy Car Show 
希尔维亚王后	Queen Sylvia 
索菲亚斯拉维亚足球俱乐部	Sofia Slavia Football Club 
岩城光英	Mitsuhide Iwaki 
廉洙政	Yeom Soo Jung 
阿德里安四世	Adrian IV 
诱惑本质	Seductive essence 
教宗狄约尼削	Pope Dionysian 
woollim娱乐	woollim entertainment 
城市电视	City TV 
恩斯特·奥古斯特三世_(汉诺威)	Ernst August III_ (Hannover) 
卢吉	Lugi 
维克多·弗朗索瓦，第二代布罗伊公爵	Victor François, the second Duke of Broy 
印度人民党	Bharatiya Janata Party 
赖幸媛	Lai Xingyuan 
日耳曼人路易	Germanic Louis 
班汉·西巴阿差	Banhan Siba Acha 
勒克瑙	Lucknow 
阿方索·卡洛斯_(圣海梅公爵)	Alfonso Carlos_ (Duke of San Jaime) 
青年民主主义者联盟－匈牙利公民联盟	League of Young Democrats-Union of Hungarian Citizens 
圣玛利亚主教座堂_(泰恩河畔纽卡斯尔)	St. Mary's Cathedral_ (Newcastle upon Tyne) 
思维二世	Mind II 
1979–80年欧洲冠军杯	1979–80 European Champions Cup 
石板沟长江大桥	Shibangou Yangtze River Bridge 
超级星光大道_(第一届)	Super Avenue of Stars_ (first edition) 
1982–83年欧洲杯赛冠军杯	1982–83 European Cup Championship 
懂我	you got me 
卡尔·亚历山大_(萨克森-魏玛-艾森纳赫)	Karl Alexander (Saxony-Weimar-Eisenach) 
魔力红	Magic Red 
圣马刁郡_(加利福尼亚州)	San Mateo County_ (California) 
芬兰正教会	Finnish Orthodox Church 
中华民国国家发展委员会	National Development Council of the Republic of China 
中国人民解放军艺术学院	Chinese People's Liberation Army Art Academy 
朗格多克-鲁西永-南部-庇里牛斯	Languedoc-Roussillon-Mid-Pyrénées 
cfm国际	cfm international 
河村建夫	Takeo Kawamura 
朝鲜景宗	Kyungjong 
乌克兰足球超级联赛	Ukrainian Premier League 
侠盗猎魔	Grand Theft Auto 
小米手机2a	Mi mobile phone 2a 
青岛海利丰足球俱乐部	Qingdao Hailifeng Football Club 
福坦莫大学	Fordham University 
蔡卓妍	Charlene Choi 
皇家盐湖城	Royal Salt Lake City 
天主教人民党	Catholic People's Party 
瑞典浩室黑手党	Swedish House Mafia 
伊东祐亨	Ito Yuhiro 
苗语川黔滇方言	Sichuan, Guizhou and Yunnan dialects 
维迪奥顿足球俱乐部	Vidi Orton Football Club 
清武弘嗣	Hiroshi Kiyotake 
李纯揆	Li Chunkui 
巴黎圣母院	Notre Dame de Paris 
隆德大学	Lund University 
星际大战三部曲：西斯大帝的复仇	Star Wars Trilogy: Revenge of the Sith 
阿道弗斯王子_(剑桥公爵)	Prince Adolphus_ (Duke of Cambridge) 
约旦君主列表	List of Jordanian monarchs 
乱马½	Ranma 
中国达人秀_(第四季)	China's Got Talent_(Season 4) 
妖怪手表系列	Monster Watch Series 
滨田靖一	Yasukazu Hamada 
让-克里斯托夫·拿破仑	Jean-Christophe Napoleon 
德涅斯特河沿岸	Transnistria 
杨洋_(男演员)	Yang Yang_ (Actor) 
奥本大学	Okumoto University 
模拟人生系列	The Sims Series 
法属圣马丁	Saint Martin 
旧乌利维球场_(2008年)	Old Ulivi Stadium_ (2008) 
西班牙议会	Spanish Parliament 
布加勒斯特迪纳摩足球俱乐部	Dynamo Bucharest Football Club 
浅野拓磨	Takuma Asano 
金知元_(饶舌者)	Jin Zhiyuan_(Rapper) 
周本顺	Zhou Benshun 
戴麟趾	Dai Linzhi 
本笃十五世	Benedict XV 
玛丽公主_(哈伍德伯爵夫人)	Princess Mary_ (Countess of Harwood) 
李壮飞	Li Zhuangfei 
朝鲜人民军	Korean People's Army 
奥本议会	Auburn Council 
持统天皇	Emperor Jitong 
伊莎贝拉_(帕尔马郡主)	Isabella_ (Lord of Parma) 
德川秀忠	Tokugawa Hidetada 
额我略十三世	Gregory XIII 
维瑟罗游戏	Visero Game 
印度超级联赛	Indian Premier League 
北京首都国际机场	Beijing Capital International Airport 
真爱趁现在	find true love today 
路易丝公主_(萨克森-哥达-阿尔滕堡)	Princess Louise_ (Saxony-Gotha-Altenburg) 
皮托德里球场	Pittodri Stadium 
2016年中国足球协会超级杯	2016 Chinese Football Association Super Cup 
亚捷隆大学	Jagiellonian University 
普拉克里特诸语言	Prakrit languages 
傲视天下	Disregard the world 
卡塔尼亚足球俱乐部	Catania Football Club 
赫尔大学	University of Hull 
老挝人民革命党中央委员会总书记	General Secretary of the Central Committee of the Lao People's Revolutionary Party 
亚力安传说	Legend of Ariane 
克里斯蒂安十世	Christian X 
乡村流行乐	Country pop 
mr._(kara单曲)	mr._ (kara single song) 
贝诺瓦·阿索-埃科托	Benova Asso-Ekoto 
星际大战：复制人之战_(2008年电视影集)	Star Wars: Clone Wars_ (2008 TV series) 
新加坡华语	Singapore Chinese 
田中达也	Tanaka Tatsuya 
帕纳托利克斯足球俱乐部	Panatolix Football Club 
金性洙	Jin Xingzhu 
江～公主们的战国～	Jiang~The Princesses’ Warring States~ 
mtv音乐录影带大奖	mtv music video award 
托卢卡体育足球俱乐部	Toluca Sports Football Club 
爱的力量_(珍妮佛·罗许歌曲)	The Power of Love_ (Jennifer Rosh Song) 
贞纯王后	Queen Zhenchun 
于涛	Yu Tao 
曹格	Gary 
乔治·里德_(澳洲政治人物)	George Reid_ (Australian political figure) 
庆长琉球之役	Battle of Keicho Ryukyu 
小米手机	Xiaomi mobile phone 
cfr克卢日足球俱乐部	cfr Cluj Football Club 
1860慕尼黑体育会	1860 Munich Sports 
朝鲜纯宗	Korean Chunjong 
声名狼藉先生	Mr. Notorious 
阿基坦的埃莉诺	Eleanor of Aquitaine 
钱穆	Qian Mu 
南部町_(山梨县)	Nanbu Town_(Yamanashi Prefecture) 
剑桥联足球俱乐部	Cambridge United Football Club 
联合国际影业	United International Pictures 
卡洛曼二世_(西法兰克)	Carloman II_ (West Franco) 
横滨国际综合竞技场	Yokohama International Arena 
吉尔维森特足球俱乐部	Gil Vicente Football Club 
任天堂2ds	Nintendo 2ds 
钱达尔勒·哈利勒帕夏	Chandalli Khalil Pasha 
拖线和鬼火	Drag line and wildfire 
达西四世	Darcy IV 
国际汽车联盟欧洲三级方程式锦标赛	FIA European Formula 3 Championship 
布拉迪斯拉发夸美纽斯大学	Comenius University of Bratislava 
松井珠理奈	Jurina Matsui 
达维迪·卡尔拿	Davidi Karna 
2005年英国大选	2005 British General Election 
神盾局特工	Agents of S.H.I.E.L.D. 
秋田新干线	Akita Shinkansen 
悉尼商业中心区	Sydney CBD 
那曲地区	Nagqu area 
前田敦子	Maeda Atsuko 
好汉两个半_(第六季)	Two and a half men_ (season six) 
周刊少年sunday	Weekly Youth sunday 
闽北语	Hokkien 
联邦调查局长	Federal Investigation Director 
李在龙	Li Zailong 
指原莉乃	Rino Sashihara 
阿卜杜勒-法塔赫·塞西	Abdul-Fattah Sisi 
女浩克	Female Hulk 
奥林比亚体育会	Olympia Sports 
偶像宣言	Idol declaration 
拉脱维亚大学	University of Latvia 
克雷芒八世	Clement VIII 
中国共产党中央纪律检查委员会	Central Commission for Discipline Inspection of the Communist Party of China 
科威特竞技俱乐部	Kuwait Athletic Club 
教宗哈德良二世	Pope Hadrian II 
路易三世_(西法兰克)	Louis III_ (West Franco) 
黑人娱乐电视台	Black Entertainment Television 
拿尼沙体育会	Nanisha Sports Club 
瑞士足球协会	Swiss Football Association 
强纳斯兄弟	Jonas Brothers 
教宗波尼法爵四世	Pope Bonifac IV 
奥希金斯体育俱乐部	O'Higgins Sports Club 
擎天神-半人马运载火箭	Sky God-Centaur Carrier Rocket 
巴迪斯拉华施洛云体育会	Badislawar Schlown Sports Club 
圣赫勒拿、阿森松和特里斯坦-达库尼亚	Saint Helena, Ascension and Tristan da Cunha 
新西兰国家党	New Zealand National Party 
土耳其人	Turk 
酋长球场	Emirates Stadium 
诺罗敦·诺林达拉那	Norodom Nolindalana 
路易丝_(奥尔良公主)	Louise_ (Princess of Orleans) 
那加兰邦	Nagaland 
but/爱的证明	but/proof of love 
数学摇滚	Math Rock 
马斯姆·罗马斯真高	Masim Romas really high 
穆尔西亚地区	Region of Murcia 
休·艾弗雷特三世	Hugh Everett III 
他威·汶耶革	Thawee Venyeg 
谢赫哈利法国际体育场	Sheikh Khalifa International Stadium 
耶路撒冷希伯来大学	The Hebrew University of Jerusalem 
郝德杰	Calder 
卡莱尔_(宾夕法尼亚州)	Carlisle_ (Pennsylvania) 
澳视澳门台	ATV Macau 
梁丽芳	Liang Lifang 
西方学院	Western Academy 
若望二十一世	John XXI 
范云龙	Fan Yunlong 
马里兰大学学院市分校	University of Maryland College City 
王大雷	Wang Dalei 
徐朱玄	Xu Zhuxuan 
印度海军	Indian Navy 
穆罕默德五世_(奥斯曼帝国)	Mohammed V_ (Ottoman Empire) 
中华民国国家安全会议	National Security Conference of the Republic of China 
平壤体育团	Pyongyang Sports Team 
游骑兵3号	Ranger 3 
吴新雄	Wu Xinxiong 
苏莱曼一世_(奥斯曼帝国)	Suleiman I_ (Ottoman Empire) 
欧仁·德·博阿尔内	Eugene de Boarnet 
比利时足球协会	Belgian Football Association 
吴兴涵	Wu Xinghan 
比亚斯华夏普尔足球会	Bias China Hapoel Football Club 
kc-135空中加油机	kc-135 aerial tanker 
谷口彰悟	Akira Taniguchi 
2014–15年欧霸杯	2014-15 Europa Cup 
爱尔兰独立战争	Irish War of Independence 
自由叙利亚军	Free Syrian Army 
若望十八世	John XVIII 
李云在	Li Yunzai 
卡-27直升机	Ka-27 helicopter 
杨念祖_(台湾学政界人物)	Yang Nianzu_ (a figure in Taiwanese academic and political circles) 
印度尼西亚斗争派民主党	Indonesian Struggle Democratic Party 
法国国家女子足球队	France Women's National Football Team 
哈康七世	Hakon VII 
贝鲁特美国大学	American University of Beirut 
红星大奖2000	Red Star Award 2000 
水手10号	Mariner 10 
叶卡捷琳娜二世	Catherine II 
贞熹王后	Queen Zhenxi 
死神之子	Son of death 
穆沙·施素高	Musa Shisuga 
漫威影业	Marvel Pictures 
班菲尔德竞技俱乐部	Banfield Athletic Club 
联合航空232号班机空难	United Airlines Flight 232 crash 
热尔兰球场	Gerland Stadium 
中北美洲及加勒比海联赛冠军杯	Central America and Caribbean League Champions Cup 
老爸老妈的浪漫史_(第六季)	The Romance of How I Met Your Mother_ (Season Six) 
新沙洞老虎	Xinshadong Tiger 
若望十七世	John XVII 
真实的自我	True self 
水母、流星	Jellyfish, meteor 
爱情雷达	Love radar 
星际大战：反抗军起义	Star Wars: Rebellion Uprising 
大韩航空007号班机空难	Korean Air Flight 007 crash 
立窝尼亚十字军入侵	Livonian Crusade Invasion 
矮子丕平	Piping 
尼尔斯·尼尔高	Niels Nilgau 
阿赫利体育俱乐部	Ahli Sports Club 
四个门牌一个梦	Four house numbers and one dream 
加利福尼亚大学戴维斯分校	University of California Davis 
柏木由纪	Yuki Kashiwagi 
田北辰	Tian Beichen 
邪恶力量	Evil force 
本田车队	Honda Team 
恩斯特·奥古斯特一世_(汉诺威)	Ernst August I_ (Hannover) 
圣加伦足球俱乐部	St. Gallen Football Club 
杰出服务勋章	Outstanding Service Medal 
彼尔姆安卡足球俱乐部	Perm Anka Football Club 
蒲隆地	Burundi 
拉菲克·夏利治	Rafic Harriet 
比沙特·贝利沙	Bishat Belisha 
凡尔登条约	Treaty of Verdun 
金宝镇市	Campbelltown 
扬克斯_(纽约州)	Yonkers_ (New York State) 
柬埔寨共产党	Communist Party of Cambodia 
生活大爆炸_(第五季)	The Big Bang Theory_ (Season 5) 
国家地理频道	National Geographic Channel 
法国国家铁路	French National Railway 
历山三世	Alexandre III 
累西腓竞技俱乐部	Recife Athletic Club 
零之使魔	Zero Servants 
北京西站	Beijing West Railway Station 
维多利亚足球会	Victoria Football Club 
李世仁	Li Shiren 
依诺增爵三世	Innocent III 
社会科学高等学院	College of Social Sciences 
米卡埃尔·尼尔松_(1978年出生)	Mikael Nelson_ (born in 1978) 
柬埔寨参议院	Senate of cambodia 
密西西比大学	University of Mississippi 
周美欣	Zhou Meixin 
仁川文鹤竞技场	Incheon Munhak Stadium 
香港工会联合会	Hong Kong Federation of Trade Unions 
永远的诗	Poem forever 
马丁·海因里希	Martin Heinrich 
厚生劳动省	Ministry of Health, Labour and Welfare 
西班牙军队	Spanish army 
美国海岸警卫队	United States Coast Guard 
市立吹田足球场	Municipal Suita Football Stadium 
东突厥斯坦伊斯兰运动	East Turkestan Islamic Movement 
韦尔港足球俱乐部	Port Vail Football Club 
挪威足球甲级联赛	Norwegian Football League 
陈妍希	Chen Yanxi 
昆士兰大学	Queensland university 
玉树藏族自治州	Yushu Tibetan Autonomous Prefecture 
放开手	let it go 
台山话	Taishan dialect 
儒略二世	Julius II 
薛仕凌	Xue Shiling 
曾德成	Zeng Decheng 
达根汉姆和雷德布里奇足球俱乐部	Duggenham and Redbridge Football Club 
北九州市	Kitakyushu 
利奥波德三世_(比利时)	Leopold III_ (Belgium) 
小富兰克林·德拉诺·罗斯福	Franklin Delano Roosevelt Jr 
华纳兄弟互动娱乐	Warner Bros. Interactive Entertainment 
保罗·费拉拿	Paul Ferrana 
经济合作与发展组织	Organisation for Economic Co-operation and Development 
联合派拉蒙电视网	United Paramount Television Network 
桃色幸运草z	Peach Clover z 
吉林汉姆足球俱乐部	Gillingham Football Club 
九头蛇_(漫威漫画)	Hydra_ (Marvel Comics) 
董蘅毅	Dong Hengyi 
祖国之光	The light of the motherland 
万代南梦宫控股	Bandai Namco Holdings 
奥斯卡·克莱因	Oscar Klein 
元武宗	Yuan Wuzong 
克娄巴特拉三世	Cleopatra III 
jojo的奇妙冒险	jojo's bizarre adventure 
马自达323	Mazda 323 
涪陵长江大桥	Fuling Yangtze River Bridge 
泰雅语群	Atayal Group 
西斯都五世	Sistus V 
藤田直之	Naoyuki Fujita 
日惹特区	Special Region of Yogyakarta 
爱德华王子_(肯特及斯特拉森公爵)	Prince Edward_ (Duke of Kent and Strathson) 
圣庄士东足球俱乐部	St. Johnston Football Club 
黑莓公司	Blackberry company 
纳舒厄_(新罕布什尔州)	Nashua_ (New Hampshire) 
走廊奔跑队	Corridor running team 
法国军事	French military 
魏灭蜀之战	The Battle of Wei Mieshu 
费尔芒特镇区_(巴特勒县)	Fairmount Township_(Butler County) 
约瑟夫二世_(神圣罗马帝国)	Joseph II_ (Holy Roman Empire) 
艾贝斯费特联足球俱乐部	Ebbsfelter United Football Club 
职业挑战系列赛1	Career Challenge Series 1 
爱的真谛	the truth of love 
游骑兵2号	Ranger 2 
那木巴尔·恩赫巴亚尔	Nambal Enkhbayar 
德仁亲王	Prince Naruhito 
额我略八世	Gregory VIII 
斯德哥尔摩大学	Stockholm University 
台风世代_-typhoon_generation-	Typhoon Generation_-typhoon_generation- 
二十世纪福斯	Twentieth Century Fox 
香港迪士尼乐园	Hong Kong Disneyland 
wb电视网	wb television network 
加拿大进步保守党	Progressive Conservative Party of Canada 
1965–66年欧洲杯赛冠军杯	1965–66 European Cup Championship 
哈拉尔五世	Harald V 
弗利特伍德镇足球俱乐部	Fleetwood Town Football Club 
额我略十六世	Gregory XVI 
澳大利亚华人	Australian Chinese 
阿克希萨尔体育会	Akhisar Sports Association 
本田圭佑	Keisuke Honda 
狮门影视公司	Lions Gate Television 
汪精卫政权	Wang Jingwei regime 
沙特职业足球联赛	Saudi Professional Football League 
深圳航空	Shenzhen Airlines 
老爸老妈的浪漫史_(第二季)	Mom and Dad's Romance_(Season 2) 
英格兰足球南部联赛	English Football Southern League 
崔天凯	Cui Tiankai 
幸福兑换券	Happiness voucher 
北普拉特_(内布拉斯加州)	North Platte_ (Nebraska) 
华星唱片	China Star Records 
野村哲也	Tetsuya Nomura 
李放	Li Fang 
滨海绍森德	Southend-on-Sea 
汉志王国	Kingdom of Hanzhi 
马克西米连·冯·巴登	Maximilian von Baden 
曼哈顿海滩_(加利福尼亚州)	Manhattan Beach_ (California) 
菲利波一世_(帕尔马)	Philip I_ (Parma) 
香港丁组足球联赛	Hong Kong Group D Football League 
荷兰国会	Dutch Parliament 
法国航空4590号班机空难	Air France Flight 4590 crash 
美国运输部长	U.S. Secretary of Transportation 
符腾堡王国	Kingdom of Württemberg 
也门总理	Prime Minister of Yemen 
格但斯克莱吉亚足球俱乐部	Gdansk Clegia Football Club 
汉达基王朝	Handaki Dynasty 
西伯利亚语支	Siberian 
武吉加里尔国家体育场	Bukit Jalil National Stadium 
京叶道路	Keiyo Road 
苏菲亚_(西班牙王女)	Sophia_(The Queen of Spain) 
姜敏寿	Jiang Min Shou 
2012年夏季奥林匹克运动会	2012 Summer Olympic Games 
图帕克·瓦尔帕	Tupac Valpa 
意大利统一	Unification of Italy 
玛布亚科技学院	Mapuya Institute of Technology 
威廉九世_(奥兰治)	William IX_ (Orange) 
陈全国	Chen Quanguo 
麦克·李_(美国政治家)	Mike Lee_ (American politician) 
金与正	Kim Yo-jung 
松山新店线	Songshan Xindian Line 
厄巴纳_(伊利诺伊州)	Urbana_ (Illinois) 
朝鲜睿宗	Rejong 
阿图尔·赛斯-英夸特	Artur Seth-Inquart 
乌克兰希腊礼天主教费城总教区	Ukrainian Greek Catholic Archdiocese of Philadelphia 
恩斯特·奥古斯特四世_(汉诺威)	Ernst August IV_ (Hannover) 
西木工作室	Westwood Studio 
拿骚的毛里茨	Mauritz of Nassau 
德宏傣语	Dehong Dai 
日利纳足球俱乐部	Zilina Football Club 
航天飞机	space shuttle 
威斯敏斯特大学	University of Westminster 
前田辽一	Maeda Ryoichi 
方镜淇	Fang Jingqi 
李敏镐	Lee Minho 
p-8波赛顿海上巡逻机	P-8 Poseidon maritime patrol aircraft 
世界贸易组织	World Trade Organization 
香港丙组（甲）足球联赛	Hong Kong Group C (A) Football League 
新宿区	Shinjuku 
延边朝鲜族自治州	Yanbian Korean Autonomous Prefecture 
沙勒尼塔纳足球俱乐部	Charlenetana Football Club 
林青霞	Lin Qingxia 
陕西国力足球俱乐部	Shaanxi Guoli Football Club 
卡佩王朝	Cape Dynasty 
马尼拉雅典耀大学	Ateneo de Manila University 
成亮_(足球运动员)	Cheng Liang_ (football player) 
劳动人民进步党	Working people progressive party 
亨里克配亲王	Henryk and Prince 
波斯尼亚和黑塞哥维那部长会议主席	Chairman of the Council of Ministers of Bosnia and Herzegovina 
小亨利·摩根索	Henry Morgenthau Jr 
协和飞机	Concorde 
大分水岭	Great Divide 
tvbs新闻台	tvbs news station 
湾流g550	Gulfstream g550 
联邦快递	Federal Express 
埃文斯顿_(伊利诺伊州)	Evanston_ (Illinois) 
利雅德战役	Battle of Riyadh 
迪士尼乐园度假区	Disneyland Resort 
圣托马斯医院	St Thomas Hospital 
天主教首尔总教区	Catholic Archdiocese of Seoul 
北加利福尼亚州	Northern California 
吴志扬_(政治人物)	Wu Zhiyang_(Politician) 
西班牙第二共和国	Second Spanish Republic 
男人之苦	Man suffering 
华信航空	Mandarin Airlines 
帝汶海	Timor Sea 
教育部国语推行委员会	National Language Promotion Committee of the Ministry of Education 
在这里接吻	Kiss here 
berryz公寓9阶	berryz apartment 9th floor 
就趁现在	Just now 
利物浦大学	University of Liverpool 
卡尔·奥古斯特_(萨克森-魏玛-艾森纳赫大公世子)	Karl August _ (son of the Grand Duke of Saxony-Weimar-Eisenach) 
阿姆斯特丹奥林匹克体育场	Amsterdam Olympic Stadium 
孤岛危机系列	Crysis series 
香港经济民生联盟	Hong Kong Economic and Livelihood Alliance 
少年杨家将	Young Yang Jiajiang 
cbs公司	cbs company 
白玛赤林	Baima Chilin 
橘郡风云	Orange County Storm 
鲁普雷希特_(巴伐利亚王储)	Ruprecht_ (Crown Prince of Bavaria) 
巴黎北站	Gare du Nord 
刘健_(足球运动员)	Liu Jian_ (football player) 
莫文蔚	Karen Mok 
凤凰卫视	Phoenix Television 
朗福德郡	Longford County 
泰坦3号e运载火箭	Titan 3 e launch vehicle 
御殿场市	Gotemba City 
于荣光	Yu Rongguang 
挪威皇家空军	Royal Norwegian Air Force 
上海迪士尼乐园	Shanghai Disneyland 
阿波罗11号	Apollo 11 
甜蜜出关	Sweet exit 
布雷斯特足球俱乐部	Brest Football Club 
国立故宫博物院	National Palace Museum 
多田爱佳	Aika Ota 
加特林机枪	Gatling Gun 
佛罗里达州立大学	Florida State University 
巴勒斯坦阿拉伯语	Palestinian Arabic 
小学馆集英社制作	Produced by Shogakukan Shueisha 
洛桑大学	University of Lausanne 
吴廷琰	Wu Tingyan 
平凡如我	Ordinary as me 
奥西耶克足球俱乐部	Osijek Football Club 
萨拉曼卡足球俱乐部	Salamanca Football Club 
联合航空811号班机事故	United Airlines Flight 811 Incident 
黎明行者号	Dawnwalker 
尼泊尔王国	Kingdom of Nepal 
武藤雄树	Muto Yuki 
国防部服役奖章	Ministry of Defense Service Medal 
根德公爵	Duke of Kent 
张思鹏	Zhang Sipeng 
scratch语言	scratch language 
曼哈顿金融区	Manhattan Financial District 
古巴共产党	Communist Party of Cuba 
雷东多海滩_(加利福尼亚州)	Redondo Beach_ (California) 
切尔滕汉姆足球俱乐部	Cheltenham Football Club 
仇和	Qiu He 
群马草津温泉	Gunma Kusatsu Onsen 
匈牙利社会主义工人党	Hungarian socialist workers' party 
第一代康沃利斯侯爵查尔斯·康沃利斯	Charles Cornwallis, the first Marquis of Cornwallis 
穆罕默德·乌尔德·阿卜杜勒-阿齐兹	Mohamed Ould Abdul-Aziz 
克罗伊登郡政府	Croydon County Government 
俄罗斯海军	Russian Navy 
巴纳德学院	Barnard College 
拉斐特_(印第安纳州)	Lafayette_(Indiana) 
uh-1n双休伊直升机	uh-1n double Huey helicopter 
中古日语	Middle Japanese 
奥卡斯体育会	Orcas Sports Club 
三角洲4号运载火箭	Delta 4 launch vehicle 
大侦探福尔摩斯2：诡影游戏	Sherlock Holmes 2: A Game of Shadows 
卡尔·瓦勒里	Carl Valery 
条顿骑士团国	Teutonic Knights 
松岛绿	Songdo Green 
小米手机2	Xiaomi mobile phone 2 
苏格兰圣公会	Scottish Anglican Church 
奥地利航空	Austrian Airlines 
布拉格查理大学	Charles University in Prague 
水晶工具	Crystal tools 
奥尔加·尼古拉耶芙娜_(符腾堡王后)	Olga Nikolaevna (Queen of Wurttemberg) 
乔宝宝	Baby Joe 
蔡堆	Caidui 
英国独立党	British Independence Party 
奥洛穆克足球俱乐部	Olomouc Football Club 
北台湾南岛语族	Austronesian of Northern Taiwan 
全日本空输	All Japan Air Loss 
小金井市	Koganei City 
邓卓翔	Deng Zhuoxiang 
全光益	Quan Guangyi 
艾莲娜_(西班牙王女)	Elena_ (The Queen of Spain) 
帕特森_(新泽西州)	Patterson_ (New Jersey) 
高加米拉战役	Battle of Gaugamela 
南锡体育会	Nancy Sports Club 
黑塔v_卡拉之狼	Dark Tower v_The Wolf of Kara 
弗朗切斯科一世_(两西西里)	Francesco I_ (Two Sicily) 
琴韵心声	Qin Yun's Heart Voice 
联邦调查局	FBI 
舆石东	Yushidong 
past＜future	past＜future 
1972–73年欧洲冠军杯	1972–73 European Champions Cup 
俄罗斯帝国海军	Imperial Russian Navy 
美国共产党	Communist Party of America 
波兰军事	Polish military 
都市恋人的追逐	The chase of urban lovers 
巴什基尔人	Bashkir 
伦敦大学伯贝克学院	Birkbeck, University of London 
莫斯科国立国际关系学院	Moscow State Institute of International Relations 
金正也	Kim Jung Ya 
梦工厂动画公司	DreamWorks Animation 
战国无双系列	Warring States Warriors Series 
生活大爆炸_(第四季)	The Big Bang Theory_ (Fourth Season) 
地拉那大学	University of Tirana 
葡属澳门	Portuguese Macau 
岩渊真奈	Mana Iwabuchi 
宋嘉澍	Song Jiashu 
卡斯蒂利亚王国	Kingdom of Castile 
天主教巴黎总教区	Catholic Archdiocese of Paris 
柳好贞	Liu Haozhen 
罗马尼亚君主	Romanian monarch 
克里斯蒂娜_(西班牙王女)	Christina_ (The Queen of Spain) 
罗马-叙利亚战争	Roman-Syrian War 
少年泰坦	Teen Titans 
克利奥帕特拉一世	Cleopatra I 
现在就要	Need now 
玉田圭司	Keiji Tamada 
超时空记忆	Temporal memory 
周一岳	Zhou Yue 
祖国联盟－立陶宛基督教民主党	Fatherland Alliance-Lithuanian Christian Democratic Party 
郭纯泉	Guo Chunquan 
约翰·奥斯本_(怀俄明州州长)	John Osborne_ (Governor of Wyoming) 
爱情魔发师	Love Magician 
米内光政	Mitsumasa Yonai 
古斯塔夫王子	Prince Gustav 
相隔千里	Thousands of miles apart 
孝献端敬皇后	Xiaoxian Duanjing Queen 
杨开慧	Yang Kaihui 
伊藤穰一	Ito Joichi 
赵宇豪	Zhao Yuhao 
中华人民共和国司法部	Ministry of Justice of the People's Republic of China 
提贝里乌斯	Tiberius 
雷哥公园	Lei Ge Park 
凯斯琳·甘迺迪_(电影监制)	Kathleen Kennedy_ (film producer) 
准噶尔汗国	Junggar Khanate 
厄瓜多尔甲组足球联赛	Ecuador First Division Football League 
爱丽斯王妃_(告罗士打公爵夫人)	Princess Alice_ (The Duchess of Gloucester) 
徐淑敏	Xu Shumin 
索尼动画	Sony Animation 
探险时光	Adventure time 
裴勇浚	Pei Yongjun 
北京南站	Beijing South Railway Station 
江东区_(宁波市)	Jiangdong District_(Ningbo) 
triumph巡回演唱会	triumph concert tour 
田口泰士	Taishi Taguchi 
希罗_(阿斯图里亚斯)	Hiero_ (Asturias) 
罗曼·格罗斯让	Romain Grosjean 
爱情奴隶	Love slave 
沈卓盈	Shen Zhuoying 
齐内丁·齐达内	Zinedine Zidane 
澳大利亚体育场	Australian Stadium 
钱嘉乐	Qian Jiale 
圣路易斯华盛顿大学	Washington University in St. Louis 
看不见的星星	Invisible stars 
圣十字学院	Holy Cross College 
印度军事	Indian military 
徐太志和孩子们	Xu Taizhi and the children 
门洛帕克_(加利福尼亚州)	Menlo Park_ (California) 
七色彩虹	Rainbow 
家本政明	Masaaki Kamoto 
三条天皇	Emperor Sanjo 
郑又荣	Zheng Yourong 
第二代法夫女公爵亚历山德拉郡主	Lord Alexandra, 2nd Duchess of Fife 
牛津联足球俱乐部	Oxford United Football Club 
萨格勒布火车头足球俱乐部	Lokomotiv Zagreb Football Club 
歌舞伎町的女王	Queen of Kabukicho 
王力宏	Wang Leehom 
杜伦大学	Durham University 
穆拉_(穆尔西亚自治区)	Mugla_(Autonomous Region of Murcia) 
巴斯大学	University of Bath 
俄罗斯联邦政府	Government of the Russian Federation 
约翰·康斯坦汀	John Constantine 
美国劳工部长	U.S. Secretary of Labor 
芬兰议会	Finnish Parliament 
一个人_(中岛美嘉单曲)	Alone_ (Mika Nakajima single) 
天空体育台	Sky Sports 
寿安固伦公主	Princess Shouan Gulun 
缅甸联邦议会	Union Assembly of Myanmar 
底特律梅西大学	Detroit Massey University 
苏格兰的亨利	Henry of Scotland 
古力娜扎	Gulinaza 
保禄三世	Paul III 
巴尔多内	Bardone 
松嶋菜菜子	Nanako Matsushima 
达让语	Darjan 
科莱-博西	Collet-Bossi 
圣巴特里克竞技足球俱乐部	St. Patrick's Athletic Football Club 
布里斯班机场	Brisbane Airport 
彭绍雄	Peng Shaoxiong 
费奥多尔三世	Fyodor III 
阿部勇树	Yuki Abe 
大阪国际机场	Osaka International Airport 
飓风汉娜	Hurricane Hannah 
韦恩州立大学	Wayne State University 
佛兰德的玛蒂尔达	Matilda of Flanders 
非洲人国民大会	African National Congress 
卡斯蒂利亚的布兰卡	Blanca of Castile 
乌克兰陆军	Ukrainian Army 
中天国际台	Zhongtian International Station 
田中斗莉王	Tori Tanaka 
西佐_(施瓦茨堡亲王)	Sizo_ (Prince Schwarzburg) 
城市足球集团	City Football Group 
爱荷华州立大学	Iowa State University 
全烋星	Full star 
中曾根弘文	Nakasone Hirofumi 
国土交通省	Ministry of Land, Infrastructure, Transport and Tourism 
上海浦东中邦足球俱乐部	Shanghai Pudong Zhongbang Football Club 
2008年热带风暴亚瑟	2008 Tropical Storm Arthur 
美国国务院	U.S. State Department 
李升炫	Lee Seung Hyun 
西班牙共产党	Communist Party of Spain 
那威	Banaue 
悉尼机场	Sydney Airport 
埃利亚的芝诺	Elia's Zeno 
香港礼宾府	Hong Kong Government House 
菅沼骏哉	Shunya Suganuma 
黑塔iii_荒原的试炼	Dark Tower III_ Trial of the Wasteland 
英雄连	Company of Heroes 
勃兰登堡-普鲁士	Brandenburg-Prussia 
纽约州议会大厦	New York State Capitol 
真下耕一	Koichi Mashimo 
太阳动力学天文台	Solar Dynamics Observatory 
圣胡安河_(科罗拉多河支流)	San Juan River_ (a tributary of the Colorado River) 
喜瑞都	Cerritos 
渡边麻友	Mayu Watanabe 
中华人民共和国国家卫生和计划生育委员会	National Health and Family Planning Commission of the People's Republic of China 
布鲁斯·穆雷_(行星科学家)	Bruce Murray_ (Planetary Scientist) 
庇护一世	Pius I 
纽约州众议院	New York State House 
阿德拉_(诺曼底)	Adela_ (Normandy) 
希拉克略	Chiracello 
王国的兴起	The rise of the kingdom 
多伦多大学三一学院	Trinity College, University of Toronto 
王郁琦	Wang Yuqi 
海布里球场	Highbury Stadium 
美丽花蝴蝶_(玛丽亚·凯莉专辑)	Beautiful Flower Butterfly_ (Maria Kelly Album) 
郑斌辉	Zheng Binhui 
北原里英	Rie Kitahara 
后一条天皇	The next emperor 
伊斯法罕大学	University of Isfahan 
万州长江大桥	Wanzhou Yangtze River Bridge 
中国中央电视台纪录频道	China Central Television Record Channel 
陈永康_(台湾军事将领)	Chen Yongkang_(Taiwan Military General) 
中华民国法务部	Ministry of Justice of the Republic of China 
内田笃人	Atsuto Uchida 
老爸老妈的浪漫史_(第五季)	The Romance of How I Met Your Mother_ (Season 5) 
姚星彤	Yao Xingtong 
拉萨贡嘎机场	Lhasa Gonggar Airport 
中华民国经济部	Ministry of Economy of the Republic of China 
巴斯克地区	Basque Country 
阿纳海姆_(加利福尼亚州)	Anaheim_ (California) 
不可阻挡的high_kick！	Unstoppable high_kick! 
telemundo电视台	telemundo television 
启定帝	Emperor Qiding 
南云忠一	Chuichi Nagumo 
查尔斯顿_(南卡罗来纳州)	Charleston_(South Carolina) 
元宁宗	Yuan Ningzong 
阿尔塔薛西斯一世	Artaxerxes I 
天主教耶路撒冷宗主教区	Catholic Patriarchate of Jerusalem 
唐德超	Tang Dechao 
上艾瑟尔省	Overijssel 
爱尔兰足球协会	Irish Football Association 
卡露莲_(汉诺威王妃)	Carolyn_ (Princess of Hannover) 
印第安纳大学	Indiana University 
魔女猎人	Witch Hunter 
詹姆斯六世及一世	James VI and I 
森冈亮太	Ryota Morioka 
老傣文	Old Dai 
第一代开尔文男爵威廉·汤姆森	William Thomson, the first Baron Kelvin 
张成祥	Zhang Chengxiang 
巴拉圭足球甲级联赛	Paraguay Football League 
邻家英雄	Hero next door 
谭小环	Tan Xiaohuan 
狮门娱乐	Lionsgate Entertainment 
布莱恩·莫尔可	Brian Morco 
张钧宁	Zhang Junning 
洪映早	Hong Yingzao 
鲍里索夫bate足球俱乐部	Borisov bate football club 
职业挑战系列赛2	Professional Challenge Series 2 
bang!	help! 
香港城市大学	City University of Hong Kong 
top媒体	top media 
哥伦比亚革命武装力量－人民军	Revolutionary Armed Forces of Colombia-People's Army 
金九	Jin Jiu 
世界卫生组织	World Health Organization 
戈里察足球俱乐部	Gorica Football Club 
江渡聪德	Jiang Du Congde 
外高加索社会主义联邦苏维埃共和国	Transcaucasus Socialist Federal Soviet Republic 
高城亚树	Takajo Aki 
墨西哥第一帝国	Mexican First Empire 
丰田阳平	Toyota Hinata 
美国犹太人	American Jews 
布拉格经济大学	Prague University of Economics 
阮福芳梅	Nguyen Phu Fang Mei 
我们是冠军	we are the champion 
一人分饰两角	One person plays two corners 
居鲁士二世	Cyrus II 
苏联占领区	Soviet occupation zone 
宿雾省	Cebu Province 
星际大战首部曲：威胁潜伏	Star Wars first episode: threats lurking 
1975年春季攻势	1975 spring offensive 
新英格兰革命	New England Revolution 
俄克拉何马城雷霆	Oklahoma City Thunder 
sunrise日本/horizon	sunrise Japan / horizon 
台湾铁路管理局	Taiwan Railway Administration 
教宗伊琪	Pope Iggy 
小山町	Oyama Town 
切尔西镇区_(巴特勒县)	Chelsea Township_ (Butler County) 
幸运儿_(傻朋克单曲)	Lucky Guy_ (Silly Punk Single) 
厄德_(西法兰克国王)	Odd_(King of West Franconia) 
让托	Letto 
埃塞尔雷德_(威塞克斯)	Ethel Red _ (Wessex) 
求生之路	Road to survival 
教宗立德	Pope Lider 
天主教大学竞技俱乐部	Catholic University Athletic Club 
阿尔萨斯-洛林	Alsace-Lorraine 
葛量洪	Grantham 
安赫塞娜蒙	Ankhsenamon 
霍尔与奥兹	Hall and Oz 
生活大爆炸_(第六季)	The Big Bang Theory_ (Season Six) 
山口萤	Yamaguchi Firefly 
楚利姆鞑靼人	Chulim Tatar 
南曼兰公爵卡尔·奥斯卡王子	Prince Carl Oscar, Duke of Southmanland 
约翰·哈夫斯泰因	John Hafsstein 
百万富翁足球俱乐部	Millionaire Football Club 
大西庇阿	Scipio 
素万那普机场	Suvarnabhumi Airport 
雷吉纳足球俱乐部	Regina Football Club 
鲍里斯三世	Boris III 
sh-3海王直升机	sh-3 Sea King helicopter 
威塞克斯伯爵夫人苏菲	Sophie, Countess of Wessex 
教宗西斯笃二世	Pope Sixtus II 
秘鲁足球甲级联赛	Peru Football League 
满满的财富	Full of wealth 
卡西尼－惠更斯号	Cassini-Huygens 
纳粹德国空军	Luftwaffe 
恋爱邻距离	Love neighbor distance 
建福帝	Jian Fu Di 
李渡长江大桥	Lidu Yangtze River Bridge 
苏格兰足球协会	Scottish Football Association 
威廉一世_(奥兰治)	William I_ (Orange) 
狄克西女子合唱团	Dixie Women's Choir 
屯门邓肇坚运动场	Tang Shiu Kin Sports Ground, Tuen Mun 
若望·保禄一世	John Paul I 
新版本合唱团	New version of the choir 
梁静茹	Liang Jingru 
中华民国卫生福利部	Ministry of Health and Welfare of the Republic of China 
丁昂敏乌	Ding Ang Min U 
长滩_(加利福尼亚州)	Long Beach_(California) 
弗朗茨一世_(神圣罗马帝国)	Franz I_ (Holy Roman Empire) 
沼田圭悟	Keigo Numata 
柏柏尔人	Berber 
卡美哈梅哈二世	Kamehameha II 
2013年德国足协杯决赛	2013 German Football Association Cup Final 
美国航空587号班机空难	American Airlines Flight 587 crash 
芬兰社会民主党	Finnish Social Democratic Party 
男孩特区	Boys Special Zone 
维尔纽斯大学	Vilnius University 
威廉四世_(奥兰治)	William IV_ (Orange) 
罗奇代尔足球俱乐部	Rochdale Football Club 
弘益大学	Hongik University 
神话世纪	Myth century 
朝鲜足球甲级联赛	Korean Football League 
儒略三世	Julius III 
马扎尔人	Magyars 
咸美顿学院足球俱乐部	Hamilton College Football Club 
查理大帝	Charles the Great 
新任天堂3ds	New Nintendo 3ds 
教宗启德	Pope Kai Tak 
日本国家女子足球队	Japan Women's National Football Team 
玛蒂尔达皇后	Queen Matilda 
中华民国财政部	Ministry of Finance of the Republic of China 
米纳尔迪车队	Minardi Team 
李在成	Li Zaicheng 
卢克·p·布莱克本	Luke P. Blackburn 
联邦储备系统	Federal Reserve System 
卡伊方言	Kay dialect 
王上源	Wang Shangyuan 
卡洛二世_(帕尔马)	Carlo II_ (Parma) 
曼荷莲学院	Manchester College 
明熹宗	Ming Xi Zong 
傣仂语	Dai Language 
奥兰多城足球俱乐部	Orlando City Football Club 
小野寺五典	Itsunori Onodera 
阿方索_(卡拉布里亚公爵)	Alfonso_ (Duke of Calabria) 
cnn国际新闻网络	cnn international news network 
华盛顿与李大学	Washington and Lee University 
镇海区_(宁波市)	Zhenhai District_(Ningbo) 
第五次中东战争	The Fifth Middle East War 
科罗拉多急流	Colorado Rapids 
小高加索山脉	Little Caucasus 
许其亮	Xu Qiliang 
英国皇家海军陆战队	Royal Marines 
圣何塞地震	San Jose earthquake 
昭宪皇太后	Empress Dowager Zhaoxian 
澳门特别行政区行政长官	Chief Executive of Macau Special Administrative Region 
拉德克利夫学院	Radcliffe College 
国家杜马	State Duma 
巴黎高等物理化工学院	Paris Higher School of Physics and Chemical Engineering 
李在敏	Lee Jae Min 
韦国清	Wei Guoqing 
邓振中	Deng Zhenzhong 
broadwell微架构	broadwell microarchitecture 
甲府风林	Kofu Fengbayashi 
长沙话	Changsha dialect 
路易-欧仁·卡芬雅克	Louis-Eugène Cavinjac 
摩尔多瓦总理	Prime Minister of Moldova 
罗纳-阿尔卑斯	Rhône-Alpes 
石勒苏益格-荷尔斯泰因	Schleswig-Holstein 
冯刚_(足球运动员)	Feng Gang_ (football player) 
纽约州立大学水牛城分校	State University of New York at Buffalo 
瓦诺莎·卡塔内	Vanoza Katane 
巴黎足球俱乐部	Paris Football Club 
爱的专辑⑧	Love Album⑧ 
中国人民解放军国防大学	Chinese People's Liberation Army National Defense University 
淡水信义线	Tamsui Xinyi Line 
阿里·本·侯赛因王子	Prince Ali Bin Hussein 
中古高地德语	Middle High German 
新宿站	Shinjuku Station 
老爸老妈的浪漫史_(第一季)	Mom and Dad's Romance_(Season One) 
宾夕法尼亚州立大学	Pennsylvania State University 
阿斯图里亚斯亲王奖	Prince of Asturias Award 
海峡大学	Kaikyo University 
沙·阿拉姆二世	Shah Alam II 
朦胧月夜～祈愿	Misty Moonlight ~ Pray 
四川航空	Sichuan Airlines 
托勒密九世	Ptolemy IX 
中华人民共和国卫生部	Ministry of Health of the People's Republic of China 
肯尼迪航天中心	Kennedy Space Center 
地维长江大桥	Diwei Yangtze River Bridge 
欧盟委员会主席	President of the European Commission 
刺客教条：枭雄	Assassin's Creed: Syndicate 
卡斯特利翁-德拉普拉纳	Castellon de la Plana 
艾蕾欧诺拉_(比利时公主)	Eleonora_ (Princess of Belgium) 
越南盾	Vietnamese Dong 
迈克·布朗_(篮球教练)	Mike Brown_ (basketball coach) 
田尻智	Tajiri Tomo 
萨格勒布大学	University of Zagreb 
中华人民共和国最高人民检察院	Supreme People's Procuratorate of the People's Republic of China 
叶伟超	Ye Weichao 
扇原贵宏	Takahiro Ogihara 
上海虹桥站	Shanghai Hongqiao Railway Station 
怀俄明州行政区划	Administrative divisions of Wyoming 
路易丝公主_(阿盖尔公爵夫人)	Princess Louise_ (Duchess of Argyll) 
君士坦斯二世	Constantine II 
香港粤语	Hong Kong Cantonese 
扬·卡齐米日	Jan Kazimierz 
公民纲领	Civic program 
国泰航空	Cathay Pacific 
柳真	Liu Zhen 
2013年中国足球协会超级杯	2013 Chinese Football Association Super Cup 
陆博飞	Lu Bofei 
布鲁郡政府	Brooke County Government 
克里斯蒂安九世	Christian IX 
菅野祐悟	Yugo Kanno 
瓦朗谢讷足球俱乐部	Valenciennes Football Club 
艾佛敦公园区_(昆士兰州)	Everton Park Area_(Queensland) 
清军入越战争	The Qing Army's entry into Vietnam 
南方之星	Southern Star 
怀念的未来～longing_future～	Missing the future~longing_future~ 
挪威足球乙级联赛	Norwegian Football Second Division 
岩松信	Mako Iwamatsu 
殷海光	Yin Haiguang 
世纪帝国系列	Century Empire Series 
芽笼国际足球会	Geylang International Football Club 
吉田麻也	Maya Yoshida 
奥托_(巴伐利亚国王)	Otto_ (King of Bavaria) 
寺田拓哉	Takuya Terada 
u-kiss	u-kiss 
艾拿度·路华斯·杜斯·山度士	Al Nadu Luvas dos Santos 
中央区_(东京都)	Chuo Ward_(Tokyo) 
埃及人	Egyptian 
让—伊夫·勒·德里安	Jean-Yves Le Drian 
法属玻里尼西亚	French Polynesia 
叶夫根尼·伊万诺维奇·扎米亚京	Yevgeny Ivanovich Zamiatin 
文武天皇	Emperor Monmu 
天生歌姬	Born singer 
2012年中国足球协会超级杯	2012 Chinese Football Association Super Cup 
霍尔比奇男爵约翰·泰勒	John Taylor, Baron Hall Beach 
费尔南多六世	Fernando VI 
机动战士gundam_00	Mobile suit gundam_00 
胡百全	Hu Baiquan 
凯里·欧文	Kyrie Irving 
香港丙组足球联赛	Hong Kong Group C Football League 
蒙特雷_(加利福尼亚州)	Monterey (California) 
李英浩	Lee Young Ho 
西格瓦尔德亲王_(乌普兰公爵)	Prince Siegwald_ (Duke of Upland) 
京沪铁路	Beijing-Shanghai Railway 
锡卡莫尔镇区_(巴特勒县)	Sycamore Township_ (Butler County) 
习李体制	Xi Li system 
拉玛二世	Rama II 
楚科奇－堪察加语系	Chukchi-Kamchatka language family 
独立电视台	Independent television 
金珍洙	Kim Jin Soo 
霍比特人：意外旅程	The Hobbit: An Unexpected Journey 
波音737max	Boeing 737max 
教宗若望三世	Pope John III 
横谷繁	Shigeru Yokotani 
斯特凡_(波兰国王)	Stefan_ (King of Poland) 
本田拓也	Takuya Honda 
密西根州立大学	Michigan State University 
易洛魁联盟	Iroquois League 
灵慈国母	灵 Ji Kingdom Mother 
塞尔维亚和黑山国家足球队	Serbia and Montenegro National Football Team 
m1911手枪	m1911 pistol 
密克罗尼西亚联邦	Federated States of Micronesia 
迈克尔·马罗内_(足球运动员)	Michael Marone_ (football player) 
明日传奇	Legend of Tomorrow 
皆川佑介	Yusuke Minagawa 
孙吉	Sun Ji 
北京理工大学	Beijing Institute of Technology 
洛伦兹亲王	Prince Lorenz 
四邑方言	Siyi Dialect 
金狮奖	Golden Lion Award 
南斯拉夫王国	Kingdom of Yugoslavia 
马乌雷加托_(阿斯图里亚斯)	Mauregato_ (Asturias) 
西英格兰大学	University of the West of England 
下一站，幸福	happiness at next stop 
庄静皇贵妃	Emperor Zhuang Jing 
北九州向日葵	Kitakyushu sunflower 
欧汉尼斯体育俱乐部	Ohannes Sports Club 
多瑙河足球俱乐部	Danube Football Club 
艾德礼区_(昆士兰州)	Attlee District_ (Queensland) 
游骑兵9号	Ranger 9 
黑塔iv_巫师与水晶球	Dark Tower iv_ Wizard and Crystal Ball 
施瓦茨堡-松德尔斯豪森	Schwarzburg-Sundelshausen 
峰岸南	Minegishi Minami 
琉球列岛美国民政府	American Civil Government of the Ryukyu Islands 
孝昭仁皇后	Empress Xiao Zhaoren 
保拉_(比利时王后)	Paula_ (Queen of Belgium) 
教宗色尔爵一世	Pope Sergio I 
国立宜兰高级中学	National Yilan High School 
超级马里奥兄弟	Super Mario Bros 
格拉兹风暴体育俱乐部	Graz Storm Sports Club 
威廉斯堡_(弗吉尼亚州)	Williamsburg_(Virginia) 
托勒密十二世	Ptolemy XII 
伦敦商学院	London Business School 
su-24战斗轰炸机	su-24 fighter bomber 
广田弘毅	Hirota 
七剑	Seven Swords 
亲亲郁金香	Kiss tulips 
管中闵	Guan Zhongmin 
德国联邦参议院	German Bundestag 
中山庆子	Nakayama Keiko 
杜亚斯足球俱乐部	Duas Football Club 
牛津大学大学学院	Ushizu University College 
第二次意大利独立战争	Second Italian War of Independence 
格奥尔格五世_(汉诺威)	Georg V_ (Hannover) 
武藏村山市	Musashi Murayama City 
吕昆锜	Lu Kunqi 
弗里德里希·约西亚斯_(萨克森-科堡-哥达)	Friedrich Josias (Saxony-Coburg-Gotha) 
老爸老妈的浪漫史_(第七季)	How I Met Your Mother_ (Season Seven) 
东大和市	East Yamato City 
离开的人是你	You are leaving 
好爱好爱你	Love you so much 
汉娜·蒙塔娜_(第一季)	Hannah Montana_ (Season One) 
空中客车a320系列	Airbus a320 series 
地区党	Regional Party 
卡奔塔利亚郡政府	Carpentaria County Government 
三星电影公司	Samsung Pictures 
南区区议会	Southern District Council 
袁国强	Yuan Guoqiang 
国际刑警组织	Interpol 
特鲁瓦体育会	Troyes Sports Club 
汉特-曼西自治区	Khanty-Mansi Autonomous Region 
爱德华六世	Edward VI 
槟城足球协会	Penang Football Association 
元仁宗	Yuan Renzong 
波士顿学院	Boston College 
兰讷斯足球俱乐部	Randers Football Club 
魔奇少年	Magic boy 
家乡公园球场	Hometown Park Stadium 
棕榈沙漠_(加利福尼亚州)	Palm Desert_ (California) 
埃曼努尔王子_(比利时)	Prince Emmanuel_(Belgium) 
安德烈-路易·德比埃尔内	André-Louis De Biernet 
欢乐合唱团	Glee 
长崎成功丸	Nagasaki Success Maru 
伦敦希斯路机场	London Heathrow Airport 
诺汀罕大学	Nottingham University 
北爱尔兰足球协会	Northern Ireland Football Association 
melody～sounds_real～	melody～sounds_real～ 
张成赫	Jang Sung Hyuk 
美国陆军第1骑兵师	U.S. Army 1st Cavalry Division 
澳门广播电视股份有限公司	Macau Radio and Television Co., Ltd. 
西东京市	Nishitokyo 
肯特的琼安	Joan of Kent 
苗语滇东北次方言	Miao dialect of northeastern Yunnan 
教宗郭诺	Pope Guo Nuo 
乂安蓝江足球俱乐部	Yi'an Lanjiang Football Club 
卡纳维拉尔角空军基地40号航天发射复合体	Cape Canaveral Air Force Base 40 Space Launch Complex 
香港大学李嘉诚医学院	Li Ka Shing School of Medicine, The University of Hong Kong 
林宥嘉	Yoga Lin 
王国明_(足球运动员)	Wang Guoming_ (Football Player) 
南浦特别市	Nanpu Special City 
深水埗体育会足球队	Sham Shui Po Sports Association Football Team 
中华民国对外贸易发展协会	Republic of China Foreign Trade Development Association 
贺斯比图勒体育中心	Hesbittule Sports Center 
奥卢塞贡·奥巴桑乔	Olusegun Obasanjo 
中国科学技术大学	University of Science and Technology of China 
湖南大学	Hunan University 
x战警	x-men 
额我略十四世	Gregory XIV 
瑞典足球协会	Swedish Football Association 
卡洛曼_(巴伐利亚国王)	Carloman_ (King of Bavaria) 
苏格兰挑战杯	Scotland Challenge Cup 
路易斯安那州立大学	Louisiana State University 
海梅_(巴尔迪伯爵)	Jaime_ (Earl of Baldi) 
奥克兰机场	Auckland Airport 
澳洲航空32号班机事故	Qantas Flight 32 accident 
川根本町	Kawanehon Town 
德罕_(北卡罗来纳州)	Durham_(North Carolina) 
香港足总杯	Hong Kong FA Cup 
上古卷轴v：天际	The Elder Scrolls v: Skyrim 
巴拉圭战争	Paraguay war 
夏洛特_(北卡罗来纳州)	Charlotte_(North Carolina) 
历山二世	Alexandre II 
庞多雷河	Pondore 
圣菲斯普林斯_(加利福尼亚州)	Santa Fe Springs (California) 
兰乔米拉_(加利福尼亚州)	Rancho Mirage (California) 
相模原体育会	Sagamihara Athletic Association 
草原马里语	Prairie Mali 
微软lumia_535	Microsoft lumia_535 
久远的河	Long-distance river 
美国财政部	U.S. Treasury Department 
教宗义禄	Pope's Righteousness 
河太均	He Taijun 
俞鸿钧	Yu Hongjun 
新加坡职业足球联赛	Singapore Professional Football League 
2008年南奥塞梯战争	2008 South Ossetian War 
吉卜力工作室	Studio Ghibli 
西雅图大学	Seattle University 
新线影业	New Line Pictures 
蜘蛛人3	Spiderman 3 
忍者外传系列	Ninja Gaiden Series 
教宗利奥十世	Pope Leo X 
destiny巡回演唱会	destiny concert tour 
威灵顿国际机场	Wellington International Airport 
大城王国	Kingdom of Ayutthaya 
徐中雄	Xu Zhongxiong 
长荣集团	Evergreen Group 
秘鲁华人	Peruvian Chinese 
越南南方民族解放阵线	South vietnam national liberation front 
鞑靼斯坦共和国	Republic of Tatarstan 
教宗斐理斯三世	Pope Felis III 
黄金海岸联足球会	Gold Coast United Football Club 
教宗良二世	Pope Leo II 
英属印度洋领地	British Indian Ocean Territory 
日本航空123号班机空难	Japan Airlines Flight 123 crash 
恰哈马哈勒－巴赫蒂亚里省	Chahamahal-Bahtiari Province 
古比雪夫水库	Gubyshev Reservoir 
赵正永	Zhao Zhengyong 
白金9人组	Platinum Group of 9 
f/a-18e/f超级大黄蜂式打击战斗机	f/a-18e/f Super Hornet Strike Fighter 
华特迪士尼世界度假区	Walt Disney World Resort 
广州白云国际机场	Guangzhou Baiyun International Airport 
肯特大学	University of Kent 
库里奇巴	Curitiba 
教宗柏拉奇一世	Pope Plachi I 
后街男孩	Backstreet Boys 
比尔足球俱乐部	Bill Football Club 
行政院经济建设委员会	Executive Yuan Economic Construction Committee 
圣母大学	University of Notre Dame 
张致恒	Zhang Zhiheng 
维也纳国际机场	Vienna International Airport 
卡特探员	Agent Carter 
恩斯特_(萨克森-迈宁根)	Ernst_(Saxony-Meiningen) 
盖茨堡之役	Battle of Gettysburg 
尚佩恩_(伊利诺伊州)	Champaign (Illinois) 
陆英修	Lu Yingxiu 
星际大战四部曲：曙光乍现	Star Wars Quadruple: Dawn 
淑嫔崔氏	Shu Bi Cui 
山田大记	Yamada Daiki 
曾健晃	Zeng Jianhuang 
英皇电影	Emperor movie 
东北英格兰	Northeast England 
炀愍皇后	Queen Yang Min 
奥克兰都会区	Auckland Metropolitan Area 
埃塞尔伍尔夫_(威塞克斯)	Ethel Woolf_ (Wessex) 
星际大战五部曲：帝国大反击	Star Wars Five Steps: The Empire Strikes Back 
波特兰木材	Portland Timbers 
三菱重工业	Mitsubishi Heavy Industries 
那格浦尔	Nagpur 
内布拉斯加大学林肯分校	University of Nebraska-Lincoln 
加拿大最高法院	Supreme Court of Canada 
"cant_sleep_cant_eat_im_sick/人鱼"]	"cant_sleep_cant_eat_im_sick/mermaid"] 
aek拉纳卡足球俱乐部	aek Larnaca Football Club 
艾迪索特镇足球俱乐部	Addison Town Football Club 
隆安同心足球俱乐部	Longan Tongxin Football Club 
教宗卡利克斯特二世	Pope Callixter II 
鹡鸰属	Wagtail 
阿姆斯特丹自由大学	Free University of Amsterdam 
巴黎高科	ParisTech 
九江长江大桥	Jiujiang Yangtze River Bridge 
朱尔_(波利尼亚克亲王)	Jul_(Prince of Polignac) 
麻辣教师gto	Spicy teacher gto 
尚穆根	Shanmugen 
卡洛·艾曼努尔四世	Carlo Emmanuel IV 
ballad～无名恋歌～	ballad～Anonymous Love Song～ 
北卡罗来纳大学系统	University of North Carolina System 
朴成哲_(1987年出生)	Park Sung Cheol_ (born in 1987) 
牡丹社事件	The Peony Club Incident 
李艾	Li Ai 
阮公凤	Ruan Gongfeng 
北洋水师	Beiyang Navy 
马岛战争	Falklands War 
爱德华四世	Edward IV 
多德雷赫特	Dordrecht 
重庆市奥林匹克体育中心	Chongqing Olympic Sports Center 
柯士甸_(香港辅政司)	Austin_(Secondary Secretary of Hong Kong) 
从不介意	Never mind 
中华人民共和国国家民族事务委员会	National Ethnic Affairs Commission of the People's Republic of China 
西山朝	Xishan Dynasty 
俄亥俄州立大学七叶树队	Ohio State Buckeyes 
拉兹格勒卢多戈雷茨足球俱乐部	Razgrad Ludogorets Football Club 
末日警钟_毁灭·新生	Doomsday Alarm_Destruction·Rebirth 
阿拉木图中央体育场	Almaty Central Stadium 
习志野市	Narashino City 
卡云农舍球场	Kayun Farmhouse Stadium 
戴娇倩	Dai Jiaoqian 
美国偶像	American idol 
吉兹字母	Geez 
交通部民用航空局	Civil Aviation Administration of the Ministry of Communications 
迈阿密大学_(佛罗里达州)	University of Miami_ (Florida) 
全美超级模特儿新秀大赛	National Super Model Rookie Contest 
哈里王子	Prince Harry 
赞比亚总统列表	List of Presidents of Zambia 
五月天	Mayday 
美国司法部	U.S. Department of Justice 
曾少宗	Zeng Shaozong 
巴萨尔_(华盛顿州)	Bassal_ (Washington State) 
福阿德二世	Fuad II 
再见单人床	Goodbye single bed 
毛新宇	Mao Xinyu 
丰田汽车	Toyota Automotive 
波兰王国_(1385年-1569年)	Kingdom of Poland_ (1385--1569) 
麦地那省	Medina 
1984年夏季奥林匹克运动会	1984 Summer Olympic Games 
菲利普斯学院	Phillips College 
圣马丁德尔雷奥雷利奥	San martin del le aurelio 
别告诉我	Don't tell me 
克丽奥佩脱拉五世	Cleopatra V 
老挝保护国	Protectorate of Laos 
呛音乐	Choking music 
一骑当千	One ride 
茅野爱衣	Ai Chino 
富兰克林县_(华盛顿州)	Franklin County_(Washington State) 
圣荷西州立大学	San Jose State University 
你鼓舞了我	you encouraged me 
费利蒙_(加利福尼亚州)	Fremont_ (California) 
朋友战队	Friends team 
马来亚联邦	Federation of Malaya 
府中市_(东京都)	Fuchu City_(Tokyo) 
感谢感激暴风雨	Thanks, grateful, storm 
以色列足球超级联赛	Israel Premier League 
灵异教师神眉	Spiritual Teacher's Eyebrow 
中共中央办公厅	General Office of the CPC Central Committee 
微软移动	Microsoft Mobile 
札幌巨蛋	Sapporo Dome 
英国广播公司美国台	BBC America 
巴林国家体育场	Bahrain National Stadium 
教宗哲拉修一世	Pope Gerasius I 
达格玛公主	Princess Dagmar 
丹麦足球协会	Danish Football Association 
夏雨_(中国大陆)	Xia Yu_(Mainland China) 
维吉尼亚军事学院	Virginia Military Academy 
三笠宫崇仁亲王	Prince Takahito Mikasa Palace 
克雷芒十四世	Clement XIV 
哈特尔普尔联足球俱乐部	Hartlepool United Football Club 
艾兰路球场	Island Road Stadium 
东大阪市	Higashiosaka City 
地成	Dicheng 
许子根	Xu Zigen 
一世代	one generation 
大阿格里皮娜	Grand Agrippina 
我的另类罗曼史	My alternative romance 
程开甲	Cheng Kaijia 
坦帕_(佛罗里达州)	Tampa_(Florida) 
范德堡大学	Vanderbilt University 
托勒密十世	Ptolemy X 
苏格兰保守党	Conservative Party of Scotland 
特攻联盟	Special Attack League 
高级包装工具	Advanced packaging tools 
袁姗姗	Yuan Shanshan 
爱德华·雷兹-希米格维	Edward Rez-Himigewei 
北京协和医学院	Peking Union Medical College 
湾湖_(佛罗里达州)	Bay Lake_ (Florida) 
艾资哈尔大学	Al-Azhar University 
不再失去	Never lose 
平山相太	Sota Hirayama 
弗里德里希·京特尔_(施瓦茨堡亲王)	Friedrich Gunter_ (Prince Schwarzburg) 
喀喇昆仑山脉	Karakoram Mountains 
比雅尼·斯特劳斯特鲁普	Bijani Strastrup 
新城市	New city 
喜欢，喜欢，喜欢。/唯有你	Like, like, like. /only you 
越南南方共和国	South Vietnam 
百兽战队牙吠连者	Beast Team Yabari 
山形山神	Yamagata Mountain God 
立荣航空	Uni Air 
思齐四世	Siqi IV 
突厥文	Turkic 
教宗色尔爵二世	Pope Sergio II 
滨海新区	Binhai New Area 
卡尔·约翰亲王	Prince Carl John 
范特西	Fantasy 
贾思潘王子	Prince Jaspan 
山东省体育中心体育场	Shandong Sports Center Stadium 
王羽	Wang Yu 
皇太子妃雅子	Crown Princess Masako 
哈德良六世	Hadrian VI 
陈昌源	Chen Changyuan 
英国外交及联邦事务部	British Foreign and Commonwealth Office 
西北航空	Northwest Airlines 
茜茜公主	Sissi 
音乐盒_(玛丽亚·凯莉专辑)	Music Box_ (Maria Kelly Album) 
卡拉卡尔帕克斯坦共和国	Karakalpakstan Republic 
安喜延	An Xiyan 
大卫·盛伯理，特维尔的盛伯理男爵	David Shengbury, Baron Shengbury of Tver 
黑塞哥维那-涅雷特瓦州	Herzegovina-Neretva Region 
uh-60黑鹰直升机	uh-60 Black Hawk helicopter 
荷兰皇家航空	Royal Dutch Airlines 
台北市政府	Taipei City Government 
小孩不笨2	Children are not stupid 2 
爱德华亲王_(肯特公爵)	Prince Edward_ (Duke of Kent) 
2008年夏季奥林匹克运动会	2008 Summer Olympic Games 
锦户亮	Nishino Ryo 
乌兹别克职业足球联赛	Uzbek Professional Football League 
木更津市	Kisarazu 
约翰·斯特拉特，第三代瑞利男爵	John Strath, third Baron Rayleigh 
桃园国际机场捷运	Taoyuan International Airport MRT 
刘涛_(足球运动员)	Liu Tao_ (football player) 
天主教波多-圣鲁菲纳罗马城郊教区	Roman Catholic Diocese of Porto-San Rufina 
皮洛士战争	Pyrrhic War 
波兹南	Poznan 
法国航空	Air France 
曼彻斯特维多利亚大学	Victoria University of Manchester 
南京南站	Nanjing South Railway Station 
李镕	Li Rong 
越南共和国陆军	Army of the Republic of Vietnam 
巴塞尔大学	University of Basel 
罗利_(北卡罗来纳州)	Raleigh_ (North Carolina) 
十万个为什么？	One hundred thousand why? 
名门世家加义	Jiayi 
松本刚明	Matsumoto Takeaki 
博义九世	Pope IX 
阿尔比诺莱费足球俱乐部	Albino Lefee Football Club 
教宗沙德	Pope Shad 
比萨大学	University of Pisa 
泰坦2号运载火箭	Titan 2 launch vehicle 
梅田彩佳	Ayaka Umeda 
旺楚克王朝	Wangchuk Dynasty 
阿伊莎·宾特·侯赛因公主	Princess Aisha Bint Hussein 
新复仇者	New Avengers 
拉脱维亚21岁以下国家足球队	Latvia Under-21 National Football Team 
30秒上火星	30 seconds to Mars 
夏乔士·罗便臣	Charlotte Robinson 
圣彼得大学	St. Peter's University 
生活大爆炸_(第二季)	The Big Bang Theory_ (Season 2) 
戈尔韦郡	County Galway 
北朝鲜人民委员会	North Korean People's Committee 
前朋克	Pre-punk 
刘纯燕	Liu Chunyan 
加勒比海盗2：聚魂棺	Pirates of the Caribbean 2: Soul Gathering Coffin 
突出部之役	Battle of the Bulge 
洛斯利亚诺斯德亚里达内	Los lanos de aridane 
讨好自己	Please yourself 
教宗若望五世	Pope John V 
阿拉巴马大学	University of Alabama 
欧洲中央银行	European Central Bank 
凌志慧	Ling Zhihui 
魏孝武帝	Emperor Xiaowu Wei 
德里苏丹国	Delhi Sultanate 
柬埔寨日占时期	Cambodian Japanese Occupation Period 
李少光	Li Shaoguang 
田中顺也	Tanaka Junya 
空中客车a380	Airbus a380 
冰雪奇缘_(原声带)	Frozen_(Original Soundtrack) 
汉娜·蒙塔娜_(第二季)	Hannah Montana_ (Season 2) 
香港华仁书院	Wah Yan College of Hong Kong 
谢富治	Xie Fuzhi 
多姆扎勒足球俱乐部	Domzal Football Club 
纽迪高体育会	Nutrico Sports Club 
苏格兰首席部长	Chief Minister of Scotland 
史特拉克男爵	Baron Strak 
埃斯特家族	Este family 
社会民主工党	Social Democratic Labor Party 
多瑙斯特雷达足球俱乐部	Donau Streda Football Club 
休·道丁，第一代道丁男爵	Hugh Dowding, the first Baron Dowding 
郭瑶琪	Guo Yaoqi 
空中客车a310	Airbus a310 
普安那公园_(加利福尼亚州)	Buena Park_ (California) 
御茶之水站	Ochanomizu Station 
曼彻斯特_(新罕布什尔州)	Manchester_(New Hampshire) 
威廉·欧文	William Irving 
田中将大	Tanaka General 
格奥尔格·多纳图斯_(黑森-达姆施塔特)	Georg Donatus_ (Hesse-Darmstadt) 
哈利法国际体育场	Khalifa International Stadium 
希腊军政府时期	Greek military government 
粉红淑女	Pink lady 
尚真王	King Shang Zhen 
俄罗斯陆军	Russian Army 
京哈客运专线	Beijing-Harbin Passenger Dedicated Line 
sakura～樱花雾海～	sakura～Sakura mist sea～ 
国家大呼拉尔	National Great Hural 
飞鹰航空	Flying Eagle Airlines 
马高·苏拿	Margo Suna 
哈桑·宾·塔拉勒_(约旦王子)	Hassan Bin Talal_ (Prince of Jordan) 
莫奇米林体育会	Mochimilin Sports Club 
英国内战	British Civil War 
尼各老五世	Nicholas V 
新北市市长	Mayor of New Taipei City 
超级星光大道_(第二届)	Super Avenue of Stars_ (2nd) 
奥迪q7	Audi q7 
摩纳哥大奖赛	Monaco Grand Prix 
尹志强	Yin Zhiqiang 
贝林佐纳足球俱乐部	Bellinzona Football Club 
大长今_(电视剧)	Dae Jang Geum_ (TV series) 
弗兰茨·卡尔大公	Grand Duke Franz Karl 
爱默生学院	Emerson College 
西江大学	Sojiang University 
安倍昭惠	Akie Abe 
亚齐特区	Aceh 
卡纳维拉尔角空军基地17号航天发射复合体	Cape Canaveral Air Force Base 17 Space Launch Complex 
韩国荣	Korea Rong 
雅丽珊郡主_(欧志伟爵士夫人)	Princess Alexandra_ (Mrs. Ou Zhiwei) 
无耻之徒_(美国电视剧)	Shameless_ (American TV series) 
吉兰丹足球协会	Kelantan Football Association 
长久手市	Nagakute City 
中华民国科技部	Ministry of Science and Technology of the Republic of China 
邵氏兄弟（香港）	Shaw Brothers (Hong Kong) 
第二代亨廷顿伯爵夫人莫德	Maude, the second Countess of Huntington 
西好莱坞_(加利福尼亚州)	West Hollywood_(California) 
匈牙利社会党	Hungarian Socialist Party 
维斯瓦克拉科夫足球俱乐部	Wisla Krakow Football Club 
玩命关头系列	Deadly Critical Series 
金在成	Kim Jae Sung 
京九铁路	Beijing-Kowloon Railway 
图森_(亚利桑那州)	Tucson_ (Arizona) 
路易二世体育场	Louis II Stadium 
围头话	Round head words 
奇幻马和传说	Fantasy horses and legends 
明神宗	Myojin sect 
武器种族传说	Weapon Race Legend 
富士河口湖町	Fujikawaguchiko Town 
密歇根大学狼獾队	University of Michigan Wolverines 
阿劳足球俱乐部	Aarau Football Club 
图坦卡蒙	Tutankhamun 
小室桂子	Keiko Komuro 
珍珠港事件	Pearl Harbor incident 
尼姆奥林匹克	Nimes Olympic 
民主党_(蒙古国)	Democratic Party_ (Mongolia) 
恩斯特·奥古斯特五世_(汉诺威)	Ernst August V_ (Hannover) 
杜兰大学	Tulane University 
塞巴斯蒂安·吉奥文科	Sebastian Giovenko 
荷兰皇家陆军	Royal Dutch Army 
圣地牙哥_(加利福尼亚州)	San Diego_(California) 
彼得伯勒联足球俱乐部	Peterborough United Football Club 
电磁战队百万连者	Electromagnetic Team Million Company 
华晨宇	Hua Chenyu 
李威廉	William Lee 
曹叡	Cao Rui 
mozilla公共许可证	mozilla public license 
巴兰基亚青年体育俱乐部	Barranquilla Youth Sports Club 
谢菲尔德大学	University of Sheffield 
武藏野市	Musashino City 
约翰·甘迺迪国际机场	John F. Kennedy International Airport 
伊达市_(福岛县)	Date City_(Fukushima Prefecture) 
伊曼·宾特·侯赛因公主	Princess Iman Bent Hussein 
腓特烈·威廉三世	Frederick William III 
加州大学河滨分校	University of California Riverside 
马德里共同体	Madrid Community 
李翔宙	Li Xiangzhou 
北九州机场	Kitakyushu Airport 
利尼史特朗体育会	Lini Strang Sports Club 
日本棒球机构	Japan Baseball Agency 
奇米·雷克南	Kimi Raikkonen 
安哥拉空军	Angolan Air Force 
顿巴斯战争	Donbass War 
纽西兰君主	Monarch of New Zealand 
新挪威语	New Norwegian 
怀特河_(格林河支流)	White River_(Tributary of Green River) 
罗斯郡足球俱乐部	Ross County Football Club 
札马战役	Battle of Zama 
苏格兰足球甲级联赛	Scottish Football League 
亨利王子_(巴腾堡)	Prince Henry_ (Batenberg) 
恩斯特·路德维希_(黑森大公)	Ernst Ludwig_ (Grand Duke of Hessen) 
新加坡武装部队	Singapore Armed Forces 
我将永远爱你	I will love you forever 
+44	+44 
西安大略大学	University of Western Ontario 
张皇后_(刘禅)	Queen Zhang_(Liu Chan) 
崔秀荣	Cui Xiurong 
凤凰卫视欧洲台	Phoenix TV Europe 
名神高速公路	Mingshen Highway 
李敖	Li Ao 
伦敦金融城	City of London 
大韩航空	Korean Air 
毛里塔尼亚总统	President of Mauritania 
圣殿骑士团	Knights Templar 
天主教纽约总教区	Catholic Archdiocese of New York 
伊斯兰革命卫队	Islamic Revolutionary Guard Corps 
真爱找麻烦	Really love to make trouble 
圣雄甘地	Mahatma Gandhi 
中华民国文化部	Ministry of Culture of the Republic of China 
游骑兵1号	Ranger 1 
庇护四世	Pius IV 
慈幼会	Charity Association 
圣塔克拉拉县_(加利福尼亚州)	Santa Clara County_ (California) 
博恩哈德_(萨克森-迈宁根)	Bernhard_ (Saxony-Meiningen) 
艾塞克斯大学	University of Essex 
西马里兰铁路	Western Maryland Railway 
标致208	Peugeot 208 
察合台语	Chagatai 
苹果a9	Apple a9 
香港足球会	Hong Kong Football Club 
老街省	Lao Cai Province 
我是歌手	I'm a singer 
高嘉华自治市	Gao Jiahua Municipality 
契丹大字	Khitan characters 
香港浸会大学	Hong Kong Baptist University 
西北大学野猫队	Northwestern University Wildcats 
罪恶王冠	Guilt crown 
托勒密五世	Ptolemy V 
阿勒颇	Aleppo 
韩家沱长江大桥	Hanjiatuo Yangtze River Bridge 
白智荣	Bai Zhirong 
榎本武扬	Enomoto Takeaki 
阿卜杜勒-阿齐兹·贝勒卡迪姆	Abdul Aziz Belkadim 
牛津大学伍斯特学院	Worcester College, Oxford University 
天津航空	Tianjin Airlines 
史匹哲太空望远镜	Spitzer Space Telescope 
电台司令	Radio commander 
何诺四世	Horno IV 
斯普林菲尔德_(伊利诺伊州)	Springfield_ (Illinois) 
生活党与山本太郎与伙伴们	Life party with Taro Yamamoto and friends 
安德烈阿斯_(萨克森-科堡-哥达)	Andreas_ (Saxony-Coburg-Gotha) 
挪威足球协会	Norwegian Football Association 
伊迈加利·努尔加利耶维奇·塔斯马加姆别托夫	Imagali Nurgalyevich Tasmagambetov 
内务人民委员部	NKVD 
郭雪芙	Xuefu Guo 
吉安尼纳竞技俱乐部	Giannina Athletic Club 
若昂·菲格雷多	Joao Figueretto 
路易·阿方索_(安茹公爵)	Louis Alfonso_ (Duke of Anjou) 
潜力无限	Unlimited potential 
宋文杰	Song Wenjie 
阿贡国家实验室	Argonne National Laboratory 
西纳尼丁·法基·优素福帕夏	Sinanidine Faki Yusuf Pasha 
阿富汗酋长国	Emirate of Afghanistan 
蓝光光碟	Blu-ray Disc 
葛迪逊公园球场	Gdison Park Stadium 
拉玛五世	Rama V 
磐城市	Iwaki City 
叶翠翠	Ye Cuicui 
蒋伟宁	Jiang Weining 
普罗夫迪夫火车头足球俱乐部	Plovdiv Lokomotiv Football Club 
ok电脑	ok computer 
凯尼恩学院	Kenyon College 
加斯顿王子	Prince Gaston 
神鬼通牒	Supernatural powers 
日内瓦大学	University of Geneva 
米兰公国	Duchy of Milan 
通邢·塔马冯	Tonsing Tamafon 
萨丁斯柯达体育会	Sardinia Skoda Sports Club 
萨克森-阿尔滕堡	Saxony-Altenburg 
麦西玛_(荷兰王后)	Messima_ (Queen of Holland) 
新干线e6系电力动车组	Shinkansen e6 series electric train set 
教宗格拉修二世	Pope Glacius II 
伊犁哈萨克自治州	Yili Kazakh Autonomous Prefecture 
额我略五世	Gregory V 
海伦娜公主_(奥尔巴尼公爵夫人)	Princess Helena_ (Duchess of Albany) 
教宗儒略一世	Pope Julius I 
阿塞拜疆国家足球队	Azerbaijan National Football Team 
迈克·罗杰斯_(阿拉巴马州政治人物)	Mike Rogers_ (Alabama political figure) 
naked/fight_together/tempest	naked/fight together/tempest 
孔祥熙	Kong Xiangxi 
平成风俗	Heisei Customs 
巴斯克维尔的猎犬	Hound of the Baskervilles 
重盟战争	Heavy alliance war 
过度保护	Overprotection 
葡萄牙足球乙级联赛	Portuguese Football League Two 
超时空要塞frontier	Macross frontier 
利特克斯足球俱乐部	Litex Football Club 
勇士足球会	Warriors Football Club 
让-巴蒂斯特_(维莱尔伯爵)	Jean-Baptiste (Earl of Villers) 
星际大战二部曲：复制人全面进攻	Star Wars II: The clones attack 
圆融天皇	Emperor Yuanrong 
萨塞克斯大学	University of Sussex 
俄罗斯空降军	Russian Airborne Army 
路爵三世	Lujue III 
索伯车队	Sauber 
京津城际铁路	Beijing-Tianjin Intercity Railway 
朱厚任	Zhu Houren 
国际橄榄球总会	International Rugby Federation 
如果没有你_(艾莉西亚·凯斯歌曲)	Without You_ (Alicia Keys Song) 
兰尼埃里_(两西西里)	Rainieri_ (Two Sicily) 
唐民凯	Tang Minkai 
玛蒂尔德_(比利时王后)	Mathilde_ (Queen of Belgium) 
明仁宗	Ming Renzong 
平阳贝卡麦克斯足球俱乐部	Pingyang Bekamax Football Club 
麦马士达大学	McMaster University 
焦点影业	Focus Pictures 
梅小青	Mei Xiaoqing 
ah-1眼镜蛇直升机	ah-1 Cobra helicopter 
三角洲2号运载火箭	Delta 2 launch vehicle 
哈姆扎·本·侯赛因_(约旦王子)	Hamza bin Hussein_ (Prince of Jordan) 
迪祖亚拿足球会	Dizuana Football Club 
采列足球俱乐部	Celje Football Club 
严德发	Yan Defa 
潘圭奇_(犹他州)	Panguitch_ (Utah) 
天空之歌	Song of the Sky 
巴基斯坦塔利班运动	Taliban Movement in Pakistan 
朝鲜太宗	King Taejong 
维拉诺瓦大学	Villanova University 
毁灭战士系列	Doom series 
库德最高委员会	Kuder Supreme Council 
韩佳人	Han Jiaren 
亚历山德拉·尼古拉耶夫娜女大公_(黑森-卡塞尔王妃)	Grand Duke Alexandra Nikolaevna_ (Princess of Hessen-Kassel) 
环游世界八十天	Eighty days around the world 
日本共产党	Communist Party of Japan 
教宗福禄	Pope Froe 
翼号列车	Wing Train 
出崎统	Desaki Order 
香港科技大学	Hong Kong University of Science and Technology 
迈克尔王子	Prince Michael 
越洋航空236号班机事故	Transocean Airlines Flight 236 Incident 
天主教赫克瑟姆暨纽卡斯尔教区	Catholic Diocese of Hexham and Newcastle 
阿八哈	Abaha 
周渝民	Zhou Yimin 
天主教弗雷斯诺教区	Catholic Diocese of Fresno 
环球主题乐园及度假村	Universal Theme Parks and Resorts 
犹他爵士	Utah Jazz 
新加坡航空	Singapore Airlines 
泷与翼	Taki and Tsubasa 
奥雷利欧_(阿斯图里亚斯)	Aurelio_ (Asturias) 
伊宁事变	Yining Incident 
劳埃德·奥斯汀三世	Lloyd Austin III 
威廉·恩斯特_(萨克森-魏玛-艾森纳赫)	Wilhelm Ernst_ (Saxony-Weimar-Eisenach) 
圣克里斯多福与尼维斯	Saint Kitts and Nevis 
极道车魂：旧金山	Extreme car soul: San Francisco 
奥迪rsq	Audi rsq 
奥萨马·本·拉登之死	The death of Osama bin Laden 
武藏小杉站	Musashikosugi Station 
长濑智也	Nagase Tomiya 
阿尔弗雷德大王	King Alfred 
奎尔皮郡政府	Quelpi County Government 
苏格兰足球乙级联赛	Scottish Football League Two 
纳粹德国海军	Nazi German Navy 
伊丽莎白_(新泽西州)	Elizabeth_(New Jersey) 
彭萨科拉_(佛罗里达州)	Pensacola_ (Florida) 
机场南站	Airport South Station 
凯考斯二世	Caicos II 
诈欺游戏_(韩国电视剧)	Fraud Game_ (Korean TV Drama) 
神奇搬运家	Magic mover 
宝利亚郡政府	Paulia County Government 
法马古斯塔新萨拉米斯足球俱乐部	Famagusta New Salamis Football Club 
赵安_(韩国艺人)	Zhao An_ (Korean artist) 
水手9号	Mariner 9 
庆和省	Khanh Hoa 
克里米亚鞑靼语	Crimean Tatar 
成泰帝	Cheng Tai Di 
自由人民党_(义大利)	Liberal People's Party_ (Italy) 
土耳其航空	Turkish Airlines 
埃托利亚战争	Atolian War 
比什凯克多多伊足球会	Bishkek Dodoi Football Club 
最终幻想vii_降临之子	Final Fantasy vii_Advent Children 
劳达航空	Lauda Air 
萧氏通讯	Shaw Communications 
复活节攻势	Easter offensive 
基督公学	Christian School 
旭烈兀	Asahi Retsu 
王赓武	Wang Gungwu 
京广铁路	Beijing-Guangzhou Railway 
九龙华仁书院	Wah Yan College, Kowloon 
女神异闻录4	Persona 4 
激走战队车连者	Rogue One Troopers 
美国职业棒球大联盟	Major League Baseball 
黑领带_(我为喜剧狂)	Black tie_ (I am a comedy mad) 
德梅因	Des Moines 
提帮功王子	Prince Tibanggong 
纽华克自由国际机场	Newark Liberty International Airport 
nhk综合频道	nhk integrated channel 
波札那	Botswana 
菲律宾自由党	Liberal Party of the Philippines 
海峡交流基金会	Straits Exchange Foundation 
最后武士	The last samurai 
云阳长江大桥	Yunyang Yangtze River Bridge 
希达斯皮斯河战役	Battle of Sida Spice 
许永生	Xu Yongsheng 
手越祐也	Yuya Tegoshi 
圣士提反女子中学	St. Stephen's Girls' College 
奔驰吧！bicycle	Benz! bicycle 
杉森建	Shan Mori Jian 
坎特伯雷基督教会大学	Canterbury Christ Church University 
努曼西亚足球俱乐部	Numancia Football Club 
明治神宫	Meiji Jingu 
梦醒美国	Awaken America 
sbs人气歌谣	sbs popular song 
奥兰多环球影城度假村	Universal Orlando Resort 
中华人民共和国监察部	Ministry of Supervision of the People's Republic of China 
通用电气航空	GE Aviation 
中国达人秀_(第五季)	China's Got Talent_(Season 5) 
如果你找到amy	If you find amy 
世纪帝国online	Century Empire online 
赵又廷	Zhao Youting 
大高加索山脉	Greater Caucasus Mountains 
伊苏斯战役	Battle of Issus 
教宗斯德望三世	Pope Stephen III 
天主教南京总教区	Catholic Diocese of Nanjing 
声声不息	Keep on talking 
中华民国外交部	Ministry of Foreign Affairs of the Republic of China 
雷阿尔城省	Ciudad Real 
拉米罗二世_(莱昂)	Ramiro II_ (Leon) 
杰克遇上丹尼斯	Jack meets Dennis 
忍者战队隐连者	Team Ninja Hermit 
上海交通大学	Shanghai Jiaotong University 
吴克俭	Wu Kejian 
