暗杀教室	Assassination classroom 
阿尔科尔孔体育协会	Alcorcon Sports Association 
教宗玛策禄一世	Pope Matheru I 
开罗国际体育场	Cairo International Stadium 
任天堂明星大乱斗	Super Smash Bros. For Nintendo 
新店区	Xindian District 
意大利职业一级足球联赛	Italian Professional Football League 
匈牙利福林	Hungarian Forint 
因为你所以我存在	I exist because of you 
阿尔蒂尔一世	Altiel I 
秋筿宫文仁亲王	Prince Wenren of Qiuyun Palace 
二宫町_(神奈川县)	Ninomiya Town (Kanagawa Prefecture) 
泰国华人	Thai Chinese 
立陶宛王国	Kingdom of Lithuania 
2011年利比亚内战	Libyan Civil War in 2011 
赫里斯托斯·萨采塔基斯	Christos Sachetakis 
凯利·约翰逊_(工程师)	Kelly Johnson_ (Engineer) 
金浦国际机场	Gimpo International Airport 
孟加拉国总统	President of Bangladesh 
神舟六号	Shenzhou VI 
全国城市足球联赛	National City Football League 
惠灵_(西弗吉尼亚州)	Wheeling_(West Virginia) 
惠比寿_(东京都)	Ebisu_(Tokyo) 
博义王	Boyi King 
阿尔巴尼亚超级足球联赛	Albanian Super League 
奉节长江大桥	Fengjie Yangtze River Bridge 
google地图	google map 
缅甸总统	President of Myanmar 
若因维利竞技俱乐部	Joinville Athletic Club 
樱花庄的宠物女孩	Sakura Village's Pet Girl 
猫头鹰之城	Owl City 
约阿希姆王子_(比利时)	Prince Joachim_ (Belgium) 
德国共产党	Communist Party of Germany 
北山宏光	Kitayama Hongguang 
李幼梨	Li Youli 
安条克三世	Antioch III 
夷陵长江大桥	Yiling Yangtze River Bridge 
特使航空	Envoy aviation 
csi犯罪现场：网路犯罪	csi crime scene: cyber crime 
克莱孟一世	Clement I 
新时代党	New age party 
让-埃里克·维尔格尼	Jean-Eric Vergne 
黑塔ii_三张预言牌	Dark Tower ii_ Three Prophecy Cards 
朝鲜世祖	Sejo Joseon 
爱德华一世	Edward I 
拉脱维亚超级足球联赛	Latvia Super League 
俄法战争	Russo-French War 
英国广播公司世界新闻频道	BBC World News Channel 
海西蒙古族藏族自治州	Haixi Mongolian and Tibetan Autonomous Prefecture 
库克县_(伊利诺伊州)	Cook County_ (Illinois) 
马克西米利安二世_(巴伐利亚国王)	Maximilian II (King of Bavaria) 
温布尔登网球锦标赛	Wimbledon Tennis Championships 
深圳湾体育中心	Shenzhen Bay Sports Center 
薛西斯一世	Xerxes I 
米德堡_(佛罗里达州)	Fort Meade_ (Florida) 
巴黎迪士尼乐园度假区	Disneyland Paris Resort 
伊庇鲁斯同盟	League of Epirus 
驱魔少年	Exorcist boy 
斯帕-弗朗科尔尚赛道	Spa-Francorchamps 
极微之歌	Tiny Song 
牛津大学出版社	Oxford University Press 
顽皮狗	Naughty dog 
喀罗尼亚战役	Battle of Caronia 
白藤江之战_(938年)	Battle of Baitengjiang_ (938) 
危机边缘_(第三季)	Edge of Crisis_ (Season 3) 
埃塞尔伯特_(威塞克斯)	Ethelbert_ (Wessex) 
弗里德里希·约翰王子_(萨克森-迈宁根)	Prince Friedrich John_ (Saxony-Meiningen) 
瓦杜兹足球俱乐部	Vaduz Football Club 
吐鲁番市	Turpan 
高能加速器研究机构	High Energy Accelerator Research Institute 
星悦航空	Star Air 
土耳其大奖赛	Turkish Grand Prix 
巴卡尔丁区政府	Bakaldine District Government 
外环江津长江大桥	Outer Ring Jiangjin Yangtze River Bridge 
阿拉胡埃伦斯体育俱乐部	Alajuelens Sports Club 
让-雅克·威尔马	Jean-Jacques Wilma 
教宗西西诺	Pope Sisino 
全乌克兰联盟“祖国”	All-Ukrainian Union "Motherland" 
石溪大学	Stony Brook University 
立陶宛议会	Lithuanian Parliament 
秋留野市	Akiruno 
田中信孝	Nobutaka Tanaka 
陈睿宗	Chen Ruizong 
地下浩多	Lots of underground 
乌尔巴诺三世	Urbano III 
伦敦玛丽王后大学	Queen Mary University of London 
大嘴巴	Big mouth 
年度最佳学生	Student of the Year 
namidairo	Tear color 
阿尔巴尼亚武装力量	Albanian Armed Forces 
西安咸阳国际机场	Xi'an Xianyang International Airport 
教宗波尼法爵三世	Pope Bonifac III 
法鲁人体育俱乐部	Faro Sports Club 
王重阳	Wang Chongyang 
波蒂莫嫩塞竞技俱乐部	Portimonense Athletic Club 
献敬王后	Tribute to the Queen 
利奥四世	Leo IV 
皇家韦斯达路足球会	Royal Westerland Football Club 
向云	Xiang Yun 
斯普林菲尔德_(马萨诸塞州)	Springfield_ (Massachusetts) 
让-皮埃尔·塞尔	Jean-Pierre Serre 
西藏航空	Tibet Airlines 
明星帝国娱乐	Star Empire Entertainment 
教宗本笃一世	Pope Benedict I 
阿里地区	Ali area 
救急战队gogov	Emergency team gogov 
宜万铁路宜昌长江大桥	Yichang Yangtze River Bridge on Yiwan Railway 
丰田体育场	Toyota Stadium 
空中客车集团	Airbus Group 
阿蒙霍特普三世	Amenhotep III 
麦哲伦号金星探测器	Magellan Venus Probe 
设拉子	Shiraz 
危机边缘_(第二季)	Edge of Crisis_ (Season 2) 
埃佩利·奈拉蒂考	Epeli Neratika 
加州州立大学萨克拉门托分校	California State University Sacramento 
左翼，丹麦自由党	Left, Danish Liberal Party 
威尼斯电影节	Venice Film Festival 
黑龙江火山鸣泉足球俱乐部	Heilongjiang Volcano Mingquan Football Club 
山东大学	Shan Dong University 
年轻岁月	Young years 
宜万铁路万州长江大桥	Wanzhou Yangtze River Bridge on Yiwan Railway 
应采儿	Ying Caier 
阿迪卜·施舍克里	Adib Shishekri 
a-4天鹰式攻击机	a-4 Skyhawk attack aircraft 
第一次摩哈赤战役	The first battle of Mohachi 
八打雁省	Batangas Province 
victory巡回演唱会	victory tour 
阿卜杜勒-阿齐兹一世	Abdul Aziz I 
娜欧蜜·芳纳·吉伦荷	Naomi Fanner Gyllenho 
博恩哈德三世_(萨克森-迈宁根)	Bornhard III_ (Saxony-Meiningen) 
佩尼贝蒂科山脉	Penibettico Mountains 
辛普森一家	The Simpsons 
利奥十二世	Leo XII 
尚贝里	Chambery 
龟梨和也	Kazuya Kamenashi 
宇都宫市	Utsunomiya City 
沪昆线	Shanghai-Kunming Line 
niconico动画	niconico animation 
越南共和国第3军	3rd Army of the Republic of Vietnam 
碧水议会	Clearwater Council 
切斯特城足球俱乐部	Chester City Football Club 
哈德良五世	Hadrian V 
格鲁吉亚王国	Kingdom of Georgia 
具惠善	Gu Hye Sun 
忠县长江大桥	Zhongxian Yangtze River Bridge 
朝鲜成宗	Seongjong of Joseon 
天使怪盗	Angel thief 
纽约洋基	New York Yankees 
爆音dance!	Explosive dance! 
提拉_(丹麦公主)	Tira_ (Danish Princess) 
美国陆军第3军	U.S. Army 3rd Corps 
美国能源部长	U.S. Secretary of Energy 
南澳大利亚州	South Australia 
陈顺宗	Chen Shunzong 
拉脱维亚议会	Latvian Parliament 
拿萨夫足球会	Nasaf FC 
克娄巴特拉七世	Cleopatra VII 
拉米拉达_(加利福尼亚州)	La Mirada_ (California) 
水晶镇_(亚利桑那州)	Crystal Town_(Arizona) 
f-102三角剑战斗机	f-102 triangle sword fighter 
中华人民共和国国家安全部	Ministry of National Security of the People's Republic of China 
蝙蝠侠归来	Batman returns 
埃克塞特城足球俱乐部	Exeter City Football Club 
尼各老一世	Nicholas I 
上夸克	Upper quark 
晕炫风暴	Dazzling Storm 
哈萨克苏维埃社会主义共和国	Kazakh Soviet Socialist Republic 
科佩尔足球俱乐部	Koper Football Club 
李博_(政治人物)	Li Bo_ (political figure) 
罗彻斯特_(纽约州)	Rochester_ (New York State) 
新大阪站	Shin-Osaka Station 
skylake微架构	skylake microarchitecture 
松本润	Matsumoto Jun 
大流士二世	Darius II 
俄罗斯全国足球联赛	Russian National Football League 
英格兰足球依斯米安联赛	English Football Ismian League 
第三次哈尔科夫战役	The third battle of Kharkiv 
地狱厨房_(美国节目)	Hell's Kitchen_ (American program) 
洞穴乐队	Cave band 
无暇精选辑	Flawless Collection 
叙利亚反对派和革命力量全国联盟	National alliance of syrian opposition and revolutionary forces 
叶匡时	Ye Kuangshi 
白沙沱长江大桥	Baishatuo Yangtze River Bridge 
m1加兰德步枪	m1 Garland rifle 
大和郡山市	Yamatokoriyama 
林心如	Ruby Lin 
一片空白	Blank 
冈比西斯二世	Cambyses II 
天主教马那瓜总教区	Catholic Archdiocese of Managua 
大社区	Large community 
教宗维吉吕	Pope Vigilius 
若阿尚·缪拉	Joachim Murat 
卡美哈梅哈三世	Kamehameha III 
黑暗正义联盟	Dark Justice League 
郑珍云	Zheng Zhenyun 
埃西哈	Ecija 
萨斯喀彻温大学	University of Saskatchewan 
金喜爱	Gold favorite 
天堂执法者_(第三季)	Heaven Enforcer_ (Season 3) 
李玹雨	Li Xuanyu 
西部裕固语	Western Yugu 
努斯拉阵线	Nusra Front 
星际大战六部曲：绝地大反攻	Star Wars Six: The Jedi Counterattack 
祯子内亲王	Prince Zhenzi Nei 
希腊足球联赛	Greek Football League 
俄罗斯联邦会议	Russian Federation Conference 
高圆宫宪仁亲王	Prince Kenhito Takawongu 
凯斯西储大学	Case Western Reserve University 
雷定五世	Lei Ding V 
洪正好	Hong Zhenghao 
若昂六世	Joao VI 
华盛顿州州长	Governor of Washington State 
埃塞俄比亚帝国	Ethiopian Empire 
台湾公共广播电视集团	Taiwan Public Broadcasting Corporation 
委内瑞拉足球甲级联赛	Venezuela Football League 
东加里曼丹省	East Kalimantan 
植村庆	Kei Uemura 
张发奎	Zhang Fakui 
郡上市	Gujo 
纪尧姆一世_(布洛涅)	Guillaume I_ (Bologne) 
汤河原町	Yugawara Town 
神舟五号	Shenzhou V 
凤凰卫视资讯台	Phoenix Satellite TV Information Channel 
呼叫乐团	Call orchestra 
查特斯塔区政府	Chatesta District Government 
世界上最happy的女孩	The happiest girl in the world 
武文牡	Wu Wenmu 
洛朗-德西雷·卡比拉	Laurent-Desire Kabila 
中华人民共和国文化部	Ministry of Culture of the People's Republic of China 
老友记_(第四季)	Friends_ (Fourth Season) 
泰国国际航空	Thai Airways International 
安东尼·戴维斯_(篮球运动员)	Anthony Davis_ (basketball player) 
三菱扶桑canter	Mitsubishi Fuso canter 
拉玛四世	Rama IV 
阿根廷别为我哭泣_(原声带)	Argentina don't cry for me_ (original soundtrack) 
rkb每日放送	rkb delivered daily 
跨湾隧道	Cross Bay Tunnel 
音乐gatas	Music gatas 
芬兰语支	Finnish 
冈山国际赛道	Okayama International Circuit 
通往明日的桥梁	The bridge to tomorrow 
巴黎第七大学	University of Paris 7 
土星1号运载火箭	Saturn 1 launch vehicle 
凯恩斯_(昆士兰州)	Cairns_(Queensland) 
利奥波德_(霍亨索伦)	Leopold_ (Hohenzollern) 
校园乌托邦_学美向前冲！	Campus Utopia_Xuemei goes forward! 
暮光之城系列	Twilight Series 
clap&love/why	clap&love/why 
马赞德兰省	Mazandran 
福冈市营地下铁	Fukuoka Municipal Subway 
保禄一世	Paul I 
照明娱乐	Lighting entertainment 
荷尔斯泰因公国	Duchy of Holstein 
利斯科_(内布拉斯加州)	Lisco_ (Nebraska) 
简万里	Jian Wanli 
第一代纳尔逊子爵霍雷肖·纳尔逊	Horatio Nelson, 1st Viscount Nelson 
尼古拉·列佐里	Nicolas Rezori 
亚西西的方济各	Francis of Assisi 
丽萨·布伦南-乔布斯	Lisa Brennan-Jobs 
阿塞拜疆足球超级联赛	Azerbaijan Football Premier League 
冷泉天皇	Emperor Reizei 
凤凰城天港国际机场	Phoenix Sky Harbor International Airport 
美国太平洋舰队	U.S. Pacific Fleet 
山口升	Yamaguchi 
北千住站	Kitasenju Station 
圣塔克鲁兹_(加利福尼亚州)	Santa Cruz_ (California) 
穆拉德一世	Murad I 
涩谷昴	Shibuya Subaru 
印度大奖赛	Indian Grand Prix 
土耳其足球总会	Turkish Football Association 
kiss合唱团	kiss chorus 
韦皇后	Queen Wei 
法国大革命战争	French Revolutionary War 
巴黎高等商业研究学院	Higher School of Business Studies in Paris 
来吧shampoo！	Come on shampoo! 
海梅_(塞戈维亚公爵)	Jaime_ (Duke of Segovia) 
飓风贡萨洛	Hurricane Gonzalo 
f-111战斗轰炸机	f-111 fighter bomber 
奥什科什_(内布拉斯加州)	Oshkosh_ (Nebraska) 
后朱雀天皇	Queen Suzaku 
别册friend	Separate book friend 
瑞典民主党	Swedish democratic party 
赵涛	Zhao Tao 
马尔科姆三世	Malcolm III 
疯狂的麦克斯：狂暴之路	Mad Max: Fury Road 
法罗群岛足球代表队	Faroe Islands National Football Team 
额我略四世	Gregory IV 
鸟人战队喷射人	Birdman Team Jetman 
2010年冬季奥林匹克运动会	2010 Winter Olympic Games 
遗迹娱乐	Relic Entertainment 
b-29超级堡垒轰炸机	b-29 superfortress bomber 
元英宗	Former Hidemune 
公明党	Komeito 
南加州大学电影艺术学院	School of Cinematic Arts, University of Southern California 
格林河_(科罗拉多河支流)	Green River_ (a tributary of the Colorado River) 
莫尔豪斯学院	Morehouse College 
刘峙	Liu Zhi 
教宗斯德望四世	Pope Stephen IV 
中国邮政	China Post 
艾曼·扎瓦希里	Ayman Zawahiri 
玛丽亚·安东尼娅公主_(施瓦茨堡)	Princess Maria Antonia_ (Schwarzburg) 
石黑升	Ishiguro 
撒拉威阿拉伯民主共和国	Sahrawi Arab Democratic Republic 
后周	Next week 
犹他－阿兹特克语系	Utah-Aztec Languages 
华沙起义	Warsaw Uprising 
haifisch	shark 
本顿县_(华盛顿州)	Benton County_(Washington State) 
爱赫特波一世	Echterbo I 
黑暗骑士：黎明升起	The Dark Knight: Dawn Rises 
川越町	Kawagoe Town 
星焕国际	Xinghuan International 
sumerian唱片	sumerian record 
色彩咏唱／孤独的破晓	Color chant/lonely breaking dawn 
越南国家电视台	Vietnam National Television 
巴音郭楞蒙古自治州	Bayingoleng Mongolian Autonomous Prefecture 
国际航空集团	International Aviation Group 
伊拉克库尔德斯坦	Iraqi Kurdistan 
以色列国防军	Israel Defense Forces 
英国公开大学	Open University 
卡尔十四世·约翰	Karl XIV John 
花漾派对	Flower party 
妖夜寻狼前传之狼神诞生	The Birth of the Wolf God 
天津西站	Tianjin West Railway Station 
新墨西哥雷鸟	New Mexico Thunderbirds 
福建体育会	Fujian Sports Association 
克里米亚自治共和国	Autonomous Republic of Crimea 
英国最高法院	Supreme Court of the United Kingdom 
超级玛利欧3d世界	Super Mario 3D World 
堪察加边疆区	Kamchatka Territory 
黑塔vi_苏珊娜之歌	Black Tower vi_Song of Susanna 
想见你的寂寞圣诞节	I want to see your lonely Christmas 
圣心大学	Sacred Heart University 
兴都库什山脉	Hindu Kush Mountains 
美国天主教大学	Catholic University of America 
牛津大学埃克塞特学院	Exeter College, Oxford University 
安地斯山脉	Andes Mountains 
周美青	Zhou Meiqing 
暮光之城：蚀	Twilight Saga: Eclipse 
windows相片图库	windows photo gallery 
玛利亚·比阿特丽斯_(萨伏伊)	Maria Beatrice (Savoy) 
索马里和解和重建委员会	Somalia Reconciliation and Reconstruction Commission 
美国空军太空司令部	U.S. Air Force Space Command 
黑金属音乐	Black metal music 
马格努斯七世	Magnus VII 
尼各老二世	Nicholas II 
邓迪大学	University of Dundee 
wild/dr.	wild/dr. 
塞琉古一世	Seleucus I 
天堂执法者_(第二季)	Heaven Enforcer_ (Season 2) 
大韩民国海军	Republic of Korea Navy 
巴尔库郡政府	Barku County Government 
e-2空中预警机	e-2 airborne early warning aircraft 
暮光之城：新月	Twilight Saga: New Moon 
完美小姐进化论	The Evolution of Miss Perfect 
魔裟斗	Devil fight 
未来战队时间连者	Future Team Time Company 
本都王国	Pontus Kingdom 
神雕侠侣	Condor Heroes 
北京鸭首钢篮球俱乐部	Beijing Yashougang Basketball Club 
吴世勋	Wu Shixun 
何志平	He Zhiping 
常陆宫正仁亲王	Prince Hitachi Miya Masahito 
关原之战	Battle of Sekihara 
山东航空	Shandong Airlines 
陈国坤	Chen Guokun 
隐形女侠	Invisible Woman 
朝鲜世宗	Sejong of Joseon 
赫米特_(加利福尼亚州)	Hemet_ (California) 
桃色sparkling	Peach sparkling 
香港民主同盟	Hong Kong Democratic League 
埃及足球甲级联赛	Egyptian Football League 
张花冠	Corolla 
实习医生_(电视剧)	Intern_(TV series) 
卡洛三世_(帕尔马)	Carlo III_ (Parma) 
洛根市_(昆士兰州)	Logan City_(Queensland) 
阿散蒂科托科足球俱乐部	Ashanti Kotoco Football Club 
纽约州立大学奥本尼分校	State University of New York at Albany 
教宗马尔谷	Pope Margu 
伊朗伊斯兰共和国军队	Army of the Islamic Republic of Iran 
不要怀疑	do not doubt 
乌克兰21岁以下国家足球队	Ukraine Under-21 National Football Team 
弗兰克·阿奇姆彭	Frank Achimpen 
斯柯达汽车	Skoda 
德顿语	Teton 
重庆江北国际机场	Chongqing Jiangbei International Airport 
国民生活第一	National life first 
天空新闻台	Sky News 
教宗斐理斯一世	Pope Felix I 
匹尔斯堡_(佛罗里达州)	Fort Pierce_(Florida) 
国际民用航空组织	International Civil Aviation Organization 
国库控股	Khazanah 
格兰特县_(华盛顿州)	Grant County_(Washington State) 
莫亨巴根竞技俱乐部	Mohenbagen Athletic Club 
南方公园	South Park 
超新星闪光人	Supernova Flash Man 
我为喜剧狂_(第2季)	I'm Crazy for Comedy_ (Season 2) 
巴西圣保罗州联赛	Brazil São Paulo State League 
吸血鬼侦探	Vampire detective 
长寿长江大桥	Changshou Yangtze River Bridge 
孟汉娜	Meng Hannah 
花漾年华：甜心全记录	Love in the Flower: Sweetheart Full Record 
爱情梦	Love dream 
吴朝	Wu Dynasty 
表原玄太	Omotohara Genta 
教宗若望六世	Pope John VI 
结局的开始	Beginning of ending 
捷星航空	Jetstar Airways 
沈祖尧	Shen Zuyao 
全美超级模特儿新秀大赛_(第十一季)	National Super Model Rookie Contest_ (Season 11) 
户松遥	Tomatsu Haruka 
阿森纳女子足球俱乐部	Arsenal Women's Football Club 
萨拉托加战役	Battle of Saratoga 
旗山区	Qishan District 
韦纳尔_(犹他州)	Vernal_ (Utah) 
布兰尼夫国际航空	Braniff International Airlines 
erj-145系列	erj-145 series 
仁川国际机场	Incheon International Airport 
莎瓦·哈桑王妃	Princess Shava Hassan 
日产march	Nissan March 
崔世安	Cui Shian 
欧洲大奖赛	European Grand Prix 
联盟90/绿党	Alliance 90/Green Party 
日本国有铁道	Japanese National Railway 
生物股长	Chief of Biology 
宝石宠物_twinkle☆	Gem Pet_twinkle☆ 
厨房噩梦	Kitchen nightmare 
印度足球甲级联赛	Indian Football League 
团结名单－红绿联盟	Solidarity List-Red-Green Alliance 
s7航空	s7 aviation 
韩国首都圈	South Korean Capital Region 
广珠城际铁路	Guangzhou-Zhuhai Intercity Railway 
艾宁顿斯坦利足球俱乐部	Einington Stanley Football Club 
世界摔角娱乐	World Wrestling Entertainment 
大马士革农村省	Rural Damascus 
中国国家女子足球队	China National Women's Football Team 
山阳新干线	Sanyo Shinkansen 
欧鸿炼	Ou Honglian 
教宗亚纳大削二世	Pope Anna Tachibana II 
劳伦斯伯克利国家实验室	Lawrence Berkeley National Laboratory 
杨吴	Yang Wu 
电子战队电磁人	Electromagnetic Man 
上海浦东国际机场	Shanghai Pudong International Airport 
超级马里奥系列	Super Mario Series 
天主教曼谷总教区	Catholic Archdiocese of Bangkok 
橘然自得	Orange and content 
沪宁城际铁路	Shanghai-Nanjing Intercity Railway 
教宗佳德	Pope Jiade 
魔法师的外甥	Nephew of the magician 
劳伦特王子_(比利时)	Prince Laurent_(Belgium) 
生活大爆炸_(第七季)	The Big Bang Theory_ (Season 7) 
圣马力诺国家足球队	San Marino National Football Team 
河内长野市	Nagano City, Hanoi 
南沙群岛	Spratly Islands 
大力士高速列车	Hercules high-speed train 
列伊达	Leida 
波兰人民党	Polish People's Party 
制服模特儿	Uniform model 
斯普林菲尔德_(密苏里州)	Springfield_(Missouri) 
洪都拉斯职业足球联赛	Honduras Professional Football League 
福岛站_(福岛县)	Fukushima Station_(Fukushima Prefecture) 
上海奥迪国际赛车场	Shanghai Audi International Circuit 
侯友宜	Hou Youyi 
马来西亚国际航空	Malaysia Airlines 
橘皮马末兰果酱_(电视剧)	Orange Marmalade_(TV series) 
孝节烈皇后	Queen of Filial Piety 
路易四世_(西法兰克)	Louis IV_ (West Franco) 
邓弗姆林修道院	Dunfermline Abbey 
新疆广汇飞虎篮球俱乐部	Xinjiang Guanghui Flying Tiger Basketball Club 
卡巴尔达-巴尔卡尔共和国	Kabardino-Balkaria Republic 
洛泰尔一世_(中法兰克)	Lotaire I_ (Central Franco) 
风之影	Shadow of the Wind 
中华雄立宇宙间	Between China and the Universe 
孛儿帖	Peer Tie 
港铁公司	MTR Corporation 
尚宣威王	King Shang Xuanwei 
真爱如血_(第三季)	True Love is Blood_ (Season 3) 
阿尤布王朝	Ayub Dynasty 
黄永胜	Huang Yongsheng 
希腊第二共和国	Second Hellenic Republic 
卡尔·腓特烈_(萨克森-魏玛-艾森纳赫大公)	Karl Friedrich_ (Grand Duke of Saxony-Weimar-Eisenach) 
五星战队大连者	Five-star team Dalian player 
教宗哈德良三世	Pope Hadrian III 
克卜勒太空望远镜	Kepler Space Telescope 
男女共学_(音乐团体)	Co-education_ (music group) 
伊莲妮公主_(黑森和莱茵)	Princess Elaine_ (Hesse and Rhein) 
wta巡回赛锦标赛	Wta Tour Championship 
k-on！轻音部	k-on! Light part 
徐才厚	Xu Caihou 
东京小子	Tokyo Kid 
1973–74年欧洲杯赛冠军杯	1973–74 European Cup Champions League 
秘境探险2：盗亦有道	Mystery Adventure 2: Pirates are also the way 
舞力全开3d_(原声带)	Just Dance 3d_ (original soundtrack) 
上越市	Joetsu City 
威尔士足球超级联赛	Welsh Premier League 
坚尼地	Kennedy 
重返恶夜魔境/爸爸的小怪兽	Return to the Night Demon/Dad's Little Monster 
都知嫄	All know 
滑板少年	Skater boy 
真爱如血_(第二季)	True Love is Blood_ (Season 2) 
多莫杰多沃国际机场	Domodedovo International Airport 
蜘蛛人：惊奇再起	Spider-Man: Surprise again 
德国铁路	German Railway 
窗帘围绕	Curtains around 
太阳战队太阳火神	Sun Team Sun Vulcan 
方向－社会民主党	Direction-Social Democratic Party 
穹顶之下_(电视剧)	Under the Dome_ (TV Series) 
阿方索一世_(阿斯图里亚斯)	Alfonso I_ (Asturias) 
喀山国立大学	Kazan State University 
教宗美基德	Pope Mejid 
蒙古人民军	Mongolian People's Army 
南非商务航空	South African Business Aviation 
阿尔巴尼亚王国_(1939年－1943年)	Kingdom of Albania_ (1939-1943) 
岐阜足球会	Gifu Football Club 
天后再临-解放咪咪	The Queen Comes Again-Free Mimi 
保加利亚社会党	Bulgarian Socialist Party 
皇家安大略博物馆	Royal Ontario Museum 
罗渣士中心	Rogers Center 
李千娜	Li Qianna 
尚圆王	Shang Yuan Wang 
国际汽车联合会	International Automobile Federation 
纯元王后	Queen of Pure Yuan 
杨铁梁	Yang Tieliang 
罗德里格斯兄弟赛道	Rodriguez Brothers Circuit 
布列塔尼的安妮	Anne of Brittany 
天津滨海国际机场	Tianjin Binhai International Airport 
多治见市	Tajimi City 
花边教主_(电视剧)	Lace Master_ (TV series) 
傅恒	Fu Heng 
神隐之狼	The Hidden Wolf 
韩亚航空	Asiana Airlines 
教宗德吾一世	Pope Dewu I 
高速战队涡轮连者	High Speed Team Turbo Company 
教宗亚历山大一世	Pope Alexander I 
世界童军运动组织	World Scouting Organization 
异世奇人_(系列2)	Strange People_ (Series 2) 
学生会长是女仆！	The student council president is a maid! 
乐天_(1997年建立)	Lotte_ (established in 1997) 
教宗则斐琳	Pope Zephyrin 
图林根	Thuringia 
北爱尔兰超级足球联赛	Northern Ireland Premier League 
埃利亚斯一世_(帕尔马)	Elias I_ (Parma) 
捷克和摩拉维亚共产党	Communist Party of Czech and Moravia 
教宗斯德望一世	Pope Stephen I 
汶莱国家足球队	Brunei National Football Team 
哥伦比亚足球乙级联赛	Colombian Football Second Division 
尤金_(俄勒冈州)	Eugene_ (Oregon) 
剑桥公爵夫人凯萨琳	Catherine, Duchess of Cambridge 
我是传说	I am legend 
孝谦天皇	Empress Koken 
若望八世	John VIII 
鬼太郎之妻	Wife of Kitaro 
由利本庄市	Yurihonjo City 
塔奇拉竞技足球俱乐部	Takira Athletic Football Club 
阿拉丁帕夏_(维齐尔)	Aladdin Pasha (Vizier) 
菲利普斯埃克塞特学院	Phillips Exeter College 
诺斯洛普公司	Northrop Corporation 
哈萨克超级足球联赛	Kazakh Super League 
蚌埠南站	Bengbu South Railway Station 
连环粉红命案	Serial pink murder 
金智媛	Kim Ji Won 
庆尚方言	Gyeongsang Dialect 
全美超级模特儿新秀大赛_(第十二季)	National Super Model Rookie Contest_ (Season 12) 
陈圣宗	Chen Shengzong 
波特兰大学	University of Portland 
教宗良三世	Pope Leo III 
唐与高句丽的战争	War between Tang and Goguryeo 
达戈贝尔特一世	Dagobert I 
利奥九世	Leo IX 
萨哈罗夫奖	Sakharov Prize 
民族主义共和联盟	Nationalist Republican Union 
奥多尼奥二世_(莱昂)	Ordoño II_ (Leon) 
家政妇三田	Housekeeper Sanda 
木兰属	Magnolia 
福尔摩斯归来记	The Return of Sherlock Holmes 
2014年夏季青年奥林匹克运动会	2014 Summer Youth Olympic Games 
图波列夫公司	Tupolev 
v6_(偶像团体)	v6_ (idol group) 
阿富汗君主列表	List of monarchs of Afghanistan 
侏罗纪公园	Jurassic Park 
奄美大岛	Amami Oshima 
北海道日本火腿斗士	Hokkaido Nippon Ham Fighter 
酷懒之味	Cool and lazy 
李海泉	Li Haiquan 
艾比尔体育会	Abil Sports Club 
李允智	Li Yunzhi 
崔西演柯南	Trish as Conan 
法拿莫达利体育会	Fana Modari Sports Club 
民主大会党	Democratic Congress Party 
罗贝尔一世_(西法兰克)	Robert I_ (West Franco) 
中国篮球协会	China Basketball Association 
查尔斯河	Charles River 
路易莎·玛丽亚公主	Princess Luisa Maria 
比佛利山_(加利福尼亚州)	Beverly Hills_(California) 
拉克夫由_(俄勒冈州)	Lakoff (Oregon) 
阿塞拜疆苏维埃社会主义共和国	Azerbaijan Soviet Socialist Republic 
光州世界杯竞技场	Gwangju World Cup Stadium 
巴勒斯坦民族权力机构	Palestinian National Authority 
动物星球频道	Animal Planet Channel 
三条市	Sanjo City 
费迪南多二世_(两西西里)	Ferdinand II_ (Two Sicily) 
巴尼亚卢卡战士足球俱乐部	Banja Luka Warriors Football Club 
任天堂情报开发本部	Nintendo Information Development Headquarters 
永远是你的女孩	Always your girl 
淀号劫机事件	Hijacking incident 
万历朝鲜之役	Wanli Battle of Korea 
基秦拿	Kitchener 
恩里克一世_(帕尔马)	Enrique I_ (Parma) 
安顺王后	Queen Anshun 
阿莱尼亚·马基航空	Alenia Marki Aviation 
郑西客运专线	Zhengxi Passenger Dedicated Line 
伦敦地铁	London Underground 
邓国威	Deng Guowei 
奥黑尔国际机场	O'Hare International Airport 
bmo球场	bmo court 
hunter×hunter	hunter×hunter 
奥林匹克里昂_(女子足球队)	Olympic Lyon_ (Women's Football Team) 
教宗辛普利修	Pope Simplicio 
和歌山市	Wakayama City 
尚宁王	Shang Ning Wang 
人民协会－金色黎明	People's Association-Golden Dawn 
阿拉维王朝	Allawi Dynasty 
新闻集团_(1979－2013年)	News Corp_(1979-2013) 
花样少年少女_(2011年电视剧)	Boys Over Flowers_ (2011 TV series) 
弗雷德里克_(丹麦王储)	Frederick (Crown Prince of Denmark) 
北京外国语大学	Beijing foreign language university 
新闻集团	News Corp 
pl/i	pl/i 
卡罗琳_(不伦瑞克)	Caroline_ (Brunswick) 
霍尔斯坦-哥托普王朝	Holstein-Gotop Dynasty 
圣占士公园球场	St James' Park Stadium 
明世宗	Meisei sect 
中国中车	CRRC 
伦敦德里郡	Londonderry County 
浦东新区	Pudong New Area 
澳大利亚陆军	Australian Army 
加拿大航空	Air Canada 
澳大利亚首都领地	Australian Capital Territory 
多愁善感的瞬间	Sentimental moment 
安卡拉大学	Ankara University 
famas突击步枪	famas assault rifle 
柯蒂斯-莱特公司	Curtis-Wright Company 
沪昆客运专线	Shanghai-Kunming Passenger Dedicated Line 
孟加拉国家体育场	Bangladesh National Stadium 
阿里郎电视台	Arirang TV 
吴涟序	Wu Lianxu 
阿拉贡的阿方索	Alfonso of Aragon 
第四次十字军东征	The Fourth Crusade 
台湾虎航	Tigerair Taiwan 
福冈市地下铁机场线	Fukuoka City Subway Airport Line 
茱莉亚学院	Juilliard School 
美国网球公开赛	U.S. Open 
联合书院	United College 
我眼中的风景	The landscape in my eyes 
马利布_(加利福尼亚州)	Malibu_ (California) 
伊博语	Igbo 
布林莫尔学院	Bryn Mawr College 
济州特别自治道	Jeju Special Self-Governing Province 
真鹤车站	Manazuru Station 
life～朝著眼前的方向～	life～toward the direction in front of you～ 
越南国防部	Ministry of National Defense 
曼切华公国	Duchy of Mantua 
克莱蒙费朗	Clermont Ferrand 
地狱犬的挽歌_-最终幻想vii-	Elegy of Hellhound_-Final Fantasy vii- 
英格兰和威尔士绿党	Green Party of England and Wales 
花剌子模王朝	Huarazim Dynasty 
白俄罗斯足球超级联赛	Belarusian Premier League 
非裔美国人民权运动	African American Civil Rights Movement 
新巴比伦王国	Kingdom of New Babylon 
平野绫	Hirano Aya 
傅崐萁	Fu Kunqi 
恐龙战队兽连者	Dinosaur Team Beasts 
夏威夷领地	Hawaii Territory 
新南威尔士总督	Governor of New South Wales 
迪娜·宾特·阿博都哈米德	Dina Bint Abduhamid 
老友记_(第五季)	Friends_ (Fifth Season) 
所罗门群岛	Solomon Islands 
艾度亚度·莫他拿	Eduardu Morthanah 
高雄捷运红线	Kaohsiung MRT Red Line 
伊普斯威奇市政府	Ipswich City Council 
东舞鹤车站	Higashimaizuru Station 
邦克山战役	Battle of Bunker Hill 
帕多瓦大学	University of Padua 
韩国棒球委员会	Korea Baseball Committee 
勇敢的心	brave Heart 
楚汉战争	Chu Han War 
克罗库斯平原战役	Battle of Crocus Plains 
南阿尔卑斯市	Minami Alps 
核心危机_-最终幻想vii-	Core Crisis_-Final Fantasy vii- 
泰伊王后	Queen Tai 
吸血鬼猎人巴菲_(第四季)	Buffy the Vampire Slayer_ (Season 4) 
韩国服役奖章	Korea Service Medal 
威尔明顿_(北卡罗来纳州)	Wilmington_ (North Carolina) 
科学战队炸药人	Science Team Dynamite 
东比利牛斯省	Pyrenees-Orientales 
中国星集团	China Star Group 
达喀尔大学	Dakar University 
中国北车	China CNR 
光严天皇	Emperor Kogon 
克利夫兰_(我为喜剧狂)	Cleveland_ (I am a comedy maniac) 
玛丹娜_(玛丹娜专辑)	Madonna_ (Madonna Album) 
巨石强森	Dwayne Johnson 
俄勒冈州立大学	Oregon State University 
彩虹乐团	Rainbow Orchestra 
波兰足球乙级联赛	Polish Football League Two 
高棉帝国	Khmer Empire 
马来西亚甲级足球联赛	Malaysia First Division Football League 
刘俊相	Liu Junxiang 
老友记_(第七季)	Friends_ (Season Seven) 
文定王后	Queen Wending 
波士顿红袜	Boston Red Sox 
豪斯医生	Dr. House 
墨西哥革命	Mexican Revolution 
车臣共和国	Chechen Republic 
泛希腊社会主义运动	Pan-Hellenic Socialist Movement 
杭州东站	Hangzhou East Railway Station 
教宗思伟	Pope Siwei 
英伟达	Nvidia 
超电子生化人	Superelectronic biochemical man 
墨西哥君主列表	List of Mexican monarchs 
明武宗	Ming Wuzong 
不列颠东印度公司	British East India Company 
秋日童话	Autumn Fairy 
加那利大型望远镜	Canary Large Telescope 
第一代萨福克公爵亨利·格雷	Henry Gray, Duke of Suffolk 
小田原站	Odawara Station 
安道尔甲组足球联赛	Andorra First Division Football League 
白发魔女传_(1993年电影)	The White Haired Witch_ (1993 movie) 
凯霍斯鲁二世	Kehoslu II 
叙利亚共和国卫队	Syrian Republic Guard 
戴多禄一世	De Dolu I 
克罗埃西亚社会民主党	Croatian Social Democratic Party 
李宇春	Li Yuchun 
阿方索四世_(莱昂)	Alfonso IV_ (Leon) 
本笃四世	Benedict IV 
郭广昌	Guo Guangchang 
亚斯码头赛道	Yas Marina Circuit 
战斗与浪漫	Battle and romance 
香港警务处	Hong Kong Police Force 
体育西路站	Tiyuxilu Station 
明宪宗	Ming Xianzong 
威廉四世_(卢森堡大公)	William IV_ (Grand Duke of Luxembourg) 
莱齐耶三世	Lezier III 
陶森大学	Towson University 
凯瑟琳·都铎_(1503年)	Catherine Tudor (1503) 
教宗亚加一世	Pope Aga I 
莫舒舒二世	Mossho II 
湘西土家族苗族自治州	Xiangxi Tujia and Miao Autonomous Prefecture 
基利杰阿尔斯兰四世	Kilij Arslan IV 
七张站	Qizhang Station 
爱情游戏	Love game 
拉夫兰_(科罗拉多州)	Loveland_ (Colorado) 
德保罗大学	DePaul University 
亨德里克·卡西米尔二世	Hendrik Casimir II 
会津战争	Aizu War 
结橘未完	Tangerine is not finished 
桥下彻	Hashishita Toru 
fresh光之美少女！	Beautiful girl of fresh light! 
冰·哥罗士比	Ice Glosby 
镰仓幕府	Kamakura Shogunate 
美第奇家族	Medici family 
哈康王储	Crown Prince Haakon 
老友记_(第三季)	Friends_ (Season 3) 
神舟二号	Shenzhou 2 
埃阿喀得斯_(伊庇鲁斯)	Akades_ (Epirus) 
拉多加湖	Ladoga 
interplay娱乐	interplay entertainment 
南部-比利牛斯	Midi-Pyrénées 
芯片音乐	Chip music 
2012年夏季奥林匹克运动会男子400米自由泳比赛	Men's 400m freestyle at the 2012 Summer Olympics 
英国海外航空	British Overseas Airways 
欣子内亲王	Prince Xin Zi Nei 
贾汉吉尔	Jahangir 
阿尔西诺伊四世	Arcinoy IV 
巴林国家足球队	Bahrain National Football Team 
狩猎谷	Hunting valley 
加菲尔德县_(犹他州)	Garfield County_ (Utah) 
钱达尔勒·阿里帕夏	Chandar Ali Pasha 
吸血鬼猎人巴菲_(第三季)	Buffy the Vampire Slayer_ (Season 3) 
亚历山大大帝于巴尔干的征战	Alexander the Great's campaign in the Balkans 
兰辛_(密歇根州)	Lansing_(Michigan) 
阿尔巴尼亚民主党	Albanian Democratic Party 
英叻·钦那瓦	Yingluck Shinawatra 
檀香山国际机场	Honolulu International Airport 
边山大学	Edge Mountain University 
格兰特·巴格拉强	Grant Bagration 
伦敦交通局	Transport for London 
午夜的影子男孩	Shadow boy at midnight 
南非航空	South African Airways 
小事乐团	Little Things Orchestra 
贝尔戈维亚丑闻	Belgovia scandal 
宝石宠物_kira☆deco！	Jewel pet_kira☆deco! 
巴西足球丁级联赛	Brazilian Football League 
阿富汗民主共和国	Democratic Republic of Afghanistan 
高雄捷运橘线	Kaohsiung MRT Orange Line 
大雄的宇宙英雄记	Nobita's Heroes of the Universe 
夏洛特_(摔角手)	Charlotte _ (wrestler) 
特效化妆师大对决_(第二季)	Special Effects Makeup Artist Showdown_ (Season 2) 
库尔德斯坦工人党	Kurdistan Workers' Party 
教宗德吾二世	Pope Dewu II 
无头骑士异闻录_durarara!!	The Headless Horseman _durarara!! 
教宗安日纳二世	Pope Anzhina II 
阿拉伯足球协会联会	Federation of Arab Football Associations 
法国海军	French Navy 
科尔马克·墨菲-奥康纳	Cormac Murphy-O'Connor 
山西汾酒猛龙篮球俱乐部	Shanxi Fenjiu Raptors Basketball Club 
莲花软体	Lotus Software 
宛如处女	Like a virgin 
玻利维亚足球甲级联赛	Bolivia Football League 
查理和巧克力工厂	Charlie and the Chocolate Factory 
巴基斯坦正义运动党	Justice Movement Party of Pakistan 
古宁头战役	Battle of Guningtou 
日暮里站	Nippori Station 
三人征兆	Three Signs 
黑暗时刻	Dark hour 
中国派遣军	Chinese dispatched army 
陶一世	Tao I 
阿拉斯加州众议院	Alaska House of Representatives 
印度空间研究组织	Indian Space Research Organization 
德川吉宗	Tokugawa Yoshizong 
法萨卢斯战役	Battle of Fasalus 
复兴航空	TransAsia Airways 
全美超级模特儿新秀大赛_(第十季)	National Super Model Rookie Contest_ (Season 10) 
阿波罗8号	Apollo 8 
雅赫摩斯一世	Yahemos I 
安托诺夫an-24	Antonov an-24 
亚伯公园赛道	Abel Park Circuit 
战斗的爱尔兰人	Fighting irish 
f-22猛禽战斗机	f-22 Raptor fighter 
星际迷航：暗黑无界	Star Trek Into Darkness 
开云集团	Kering Group 
高本惠	Takamoto 
远东联邦管区	Far Eastern Federal District 
泉佐野市	Izumisano City 
007大战皇家赌场	007 Casino Royale 
南越国	South Vietnam 
有人爱	Someone loves 
悲伤的twilight	Sad twilight 
格林镇区_(俄亥俄州亚当斯县)	Green Township_(Adams County, Ohio) 
未来的博物馆	Museum of the future 
绿蔷薇	Greenbrier 
伊萨山市政府	Mount Isa City Council 
斯洛文尼亚民主党	Democratic Party of Slovenia 
英国航太系统	British Aerospace System 
埃及航空	Egypt Air 
巴西航空工业公司	Embraer 
淡水线_(台北捷运)	Tamsui Line_(Taipei MRT) 
信约：唐山到南洋	Letter of Agreement: Tangshan to Nanyang 
江苏龙肯帝亚篮球俱乐部	Jiangsu Longkendia Basketball Club 
克里夫兰印地安人	Cleveland Indians 
拉脱维亚绿党	Latvian Green Party 
新月危机	Crescent crisis 
白宫群英	White House Heroes 
旧金山州立大学	San Francisco State University 
地球战队五人组	Earth Team Five 
花样少年少女_(2007年电视剧)	Boys Over Flowers_ (2007 TV series) 
芬兰足球超级联赛	Finnish Premier League 
惹兰勿刹体育场	Jalan Besar Stadium 
梅赫拉巴德国际机场	Mehrabad International Airport 
郑州东站	Zhengzhou East Railway Station 
兰新铁路第二双线	Lanxin Railway Second Double Line 
印尼超级联赛	Indonesian Super League 
尖端顶点之上！	Above the apex! 
老爸老妈的浪漫史_(第八季)	How I Met Your Mother_ (Season 8) 
波斯尼亚和黑塞哥维那超级足球联赛	Bosnia and Herzegovina Super League 
塔希提足球代表队	Tahiti National Football Team 
印度-希腊王国	India-Greece 
费尔南多二世_(阿拉贡)	Fernando II_ (Aragon) 
笈多王朝	Gupta Dynasty 
村上天皇	Emperor Murakami 
第三代约克公爵理查·金雀花	Richard Gorse, the third Duke of York 
黑风姥姥	Grandma Heifeng 
肖特兄弟	The Short Brothers 
大战队风镜v	Big Team Goggles v 
马里兰区域通勤铁路	Maryland Regional Commuter Railway 
梨花女子大学	Ewha Womans University 
长者爱德华	Edward the Elder 
摩尔多瓦共和国共产党人党	Communist Party of the Republic of Moldova 
帕鲁郡政府	Paru County Government 
全美超级模特儿新秀大赛_(第十三季)	National Super Model Rookie Contest_ (Season 13) 
愿女人幸福	May women be happy 
爱尔兰超级足球联赛	Irish Premier League 
刘玉章	Liu Yuzhang 
弗里德里希_(霍亨索伦)	Friedrich_ (Hohenzollern) 
柬埔寨救国党	Cambodian National Salvation Party 
第十七代沃里克伯爵爱德华·金雀花	Edward Gorse, 17th Earl of Warwick 
两天一夜	Two days and one night 
金县_(华盛顿州)	King County_(Washington State) 
花莲车站	Hualien Station 
埃里克·哈里斯和迪伦·克莱伯德	Eric Harris and Dylan Klebold 
肯尼思一世	Kenneth I 
瑞士联邦委员会	Swiss Federal Council 
2014年亚洲运动会	2014 Asian Games 
冰岛足球超级联赛	Iceland Premier League 
魏孝文帝	Emperor Wei Xiaowen 
后醍醐天皇	Emperor Godaigo 
比尤特_(蒙大拿州)	Butte_ (Montana) 
中华人民共和国工业和信息化部	Ministry of Industry and Information Technology of the People's Republic of China 
教宗何弥	Pope He Mi 
社会党_(瓦隆)	Socialist Party_ (Wallonia) 
木村kaela	Kimura kaela 
apache软件基金会	apache software foundation 
澳洲皇家海军	Royal Australian Navy 
中野站_(东京都)	Nakano Station_(Tokyo) 
中和新芦线	Zhonghe Xinlu Line 
比利时足球乙级联赛	Belgian Football League Two 
决策无方者埃塞尔雷德	Ethel Redd 
莱奥波尔多·加尔铁里	Leopoldo Galtieri 
后光严天皇	Emperor Houguang Yan 
若阿金·希萨诺	Joaquim Chissano 
迈凯伦汽车	McLaren Automotive 
玩火的女孩	Girl playing with fire 
中国南车	China South Locomotive 
橘郡风云_(第三季)	Orange County Storm_(Season 3) 
高皇后_(东魏孝静帝)	High Queen_(Emperor Xiaojing of the Eastern Wei Dynasty) 
圣诞便便，黄金先生	Christmas poop, Mr. Gold 
费城费城人	Philadelphia Phillies 
鲗鱼涌	Quarry Bay 
北京市地铁运营有限公司	Beijing Subway Operation Co., Ltd. 
香港圣公会	Hong Kong Anglican Church 
章敬王后	Queen Zhang Jing 
后水尾天皇	Emperor Gomizuo 
和谐号crh3型电力动车组	Harmony crh3 electric train set 
方济各会	Franciscans 
萨非王朝	Safavid Dynasty 
欧洲之星	Eurostar 
南苏丹	South Sudan 
老友记_(第八季)	Friends_ (season eight) 
世界房车锦标赛	World Touring Car Championship 
开放弗拉芒自由民主党	Open Flemish Liberal Democratic Party 
大众途观	Volkswagen Tiguan 
马萨诸塞州议会大厦	Massachusetts State Capitol 
后桃园天皇	Emperor Taoyuan 
亚美尼亚共和党	Republican Party of Armenia 
墨西哥总统	President of Mexico 
足利义满	Ashikaga Yoshimitsu 
钦明天皇	Emperor Qin Ming 
女与男的摇篮曲游戏	Lullaby game for women and men 
高仓天皇	Emperor Takakura 
松浦胜人	Matsuura Masato 
海津亮介	Ryousuke Kaizu 
安托万·比内	Antoine Pinay 
控球后卫	Point guard 
足利义昭	Ashikaga Yoshiaki 
中国人民解放军军旗	Flag of the Chinese People's Liberation Army 
乌克兰独立日	Ukraine Independence Day 
berryz工房_特别精选辑_vol.2	berryz Kobo_Special Collection_vol.2 
德国总参谋部	German General Staff 
卡尔路加	Karl Luke 
相信爱	believe in love 
黑龙江省建筑工程学校	Heilongjiang Provincial Construction Engineering School 
渡部恒三	Kozo Watanabe 
fate/zero	fate/zero 
舰首旗	Bow flag 
后宫李氏	Harem Lee 
高桥留美子	Rumiko Takahashi 
前472年	472 years ago 
中野彻	Nakano Toru 
木府风云	Story of Mu Mansion 
utc-6	utc-6 
东核心帝汶语群	East Core Timorese 
国民阵线_(马来西亚)	National Front_(Malaysia) 
阿尔巴尼亚人民议会	Albanian People's Assembly 
私人诊所	Private clinic 
原始迦南字母	Original Canaanite 
格拉茨大学	University of Graz 
第三人称射击游戏	Third-person shooter 
澳大利亚联合党	Australian United Party 
男女纠察队	Men's and women's pickets 
格拉哥里字母	Glagolitic 
十月革命勋章	October Revolution Medal 
华语流行音乐	Chinese pop music 
美国参议员资历	U.S. Senator qualifications 
尼可拉‧伊万诺维奇‧博布里科夫	Nikolai Ivanovich Bobrikov 
孝懿仁皇后	Queen Xiao Yiren 
日本流行音乐	Japanese pop music 
维也纳大学	University of Vienna 
高架车站	Elevated station 
狩魔猎人	Demon Hunter 
市委书记	Party Secretary 
美国国会公墓	United States Capitol Cemetery 
西班牙17岁以下国家足球队	Spain Under-17 National Football Team 
灵魂乐	Soul music 
底比斯，埃及	Thebes, Egypt 
奥林匹亚体育俱乐部	Olympia Sports Club 
埃托利亚同盟	League of Aetolia 
法兰西银行	Bank of France 
博伦法尔门畔默克体育场	Merck Stadium at Bollen Falmen 
北塔山事件	Beita Mountain Incident 
印度标准时间	India Standard Time 
州立大学系统	State University System 
jean-pierre_soisson	jean-pierre_soisson 
拉丁语短语列表_(e字头)	List of Latin phrases _ (e prefix) 
天可汗	Tian Khan 
新传媒春天频道	New Media Spring Channel 
美利坚联盟国总统	President of the Confederate States of America 
单人电子游戏	Single player video game 
比例代表制	Proportional representation 
莫斯科足球俱乐部	Moscow Football Club 
克罗地亚17岁以下国家足球队	Croatian Under-17 National Football Team 
九龙西选区	Kowloon West Constituency 
中华人民共和国国务院秘书长	Secretary General of the State Council of the People's Republic of China 
埃尔朗根-纽伦堡大学	University of Erlangen-Nuremberg 
深圳南岭铁狼足球俱乐部	Shenzhen Nanling Iron Wolf Football Club 
金在阳	Kim Jae Yang 
爱丁堡纳皮尔大学	Edinburgh Napier University 
卡本县_(宾夕法尼亚州)	Carbon County_(Pennsylvania) 
加告兹自治区人民议会主席列表	List of Chairman of the People's Assembly of the Gagauz Autonomous Region 
第一海军大臣	First Secretary of the Navy 
锦湖韩亚集团	Kumho Asiana Group 
副热带季风气候	Subtropical monsoon climate 
珠海学院	Zhuhai University 
英格兰的名誉郡	Honorary County of England 
女王办公室	Queen's Office 
黄公望	Huang Gongwang 
环游世界明星赛	Around the World Star Game 
私立大学	Private university 
首尔艺术大学	Seoul National University 
紧凑型mpv	Compact mpv 
乌克兰海军	Ukrainian Navy 
洛宾纳球场	Robina Stadium 
乌德勒支足球俱乐部	Utrecht Football Club 
伍冠桢	Wu Guanzhen 
葡萄牙20岁以下国家足球队	Portugal Under-20 National Football Team 
高知县旗	Flag of Kochi Prefecture 
中国首都	Capital of China 
西西里和那不勒斯君主列表	List of monarchs of Sicily and Naples 
青年人体育会	Youth Sports Association 
syarhey_vyeramko	syarhey_vyeramko 
世界政区索引	Index of World Political Areas 
音乐影片	Music video 
四川玖玖爱	Sichuan Jiu Jiu Ai 
信义宗	Lutheran 
瓦伦提诺公爵	Duke of Valentino 
法兰克国王列表	List of Frankish Kings 
西班牙波旁王朝	Spanish Bourbon 
中川正春	Masaharu Nakagawa 
国会音乐集团	Congress Music Group 
开放源代码	Open source 
中北美洲及加勒比海足球协会	Central and North American and Caribbean Football Association 
高桥祥平	Takahashi Shohei 
瓦西里·果戈里	Vasily Gogol 
大伦敦	Greater London 
东北易帜	Northeast Change 
上德语	Upper German 
昭和天皇	Showa Emperor 
南京动车运用所	Nanjing EMU 
西班牙众议院议长	Speaker of the Spanish House of Representatives 
甘利正	Gan Lizheng 
专辑制作	Album production 
第三次中东战争	Third Middle East War 
民主社会主义	Democratic socialism 
伦敦大学学院	University College London 
朝鲜民主主义人民共和国政府	Government of the Democratic People's Republic of Korea 
2014年亚洲女子足球锦标赛	2014 Asian Women's Football Championship 
马修·考奇	Matthew Couch 
郑樱纶	Zheng Yinglun 
吉打州务大臣	Minister of State of Kedah 
巾帼枭雄之义海豪情	Heroines of Yihai 
伊朗警察	Iranian police 
权力分立	Separation of powers 
伊拿舒域治	Ina Shuvitch 
吉野之里遗迹	Yoshino Sato Ruins 
格林尼治平时	Greenwich Normal 
英格兰16岁以下足球代表队	England Under-16 Football Team 
斯廷博特斯普林斯_(科罗拉多州)	Steamboat Springs_ (Colorado) 
法国总理列表	List of Prime Ministers of France 
安丽中心	Anli Center 
中间偏左	Center left 
utc-4	utc-4 
苏格兰王位继承人列表	List of Heirs to the Scottish Throne 
马其顿王国	Kingdom of Macedonia 
食人婆游戏	Cannibal game 
迈克尔·加林多	Michael Galindo 
美茵河畔法兰克福	Frankfurt am Main 
贝雷库姆切尔西足球俱乐部	Berekum Chelsea Football Club 
安藤骏介	Shunsuke Ando 
自然历史	Natural history 
伍兆荣	Wu Zhaorong 
卡美哈梅哈五世	Kamehameha V 
唐凤珍	Tang Fengzhen 
中国中央电视台风云音乐频道	China Central Television Fengyun Music Channel 
开始选单	Start menu 
民主党_(大韩民国1955年)	Democratic Party_ (Republic of Korea 1955) 
英利绿色能源控股有限公司	Yingli Green Energy Holdings Limited 
前202年	202 years ago 
区嘉慧	Au Jiahui 
欧洲中部夏令时间	Central European Daylight Time 
早稻田大学	Waseda University 
韩国流行音乐	Korean pop music 
日野时光	Hino Time 
冈崎建哉	Kenya Okazaki 
横尾涉	Yokoo Wataru 
青天白日勋章	Blue Sky and White Sun Medal 
柏林奥林匹克体育场	Berlin Olympic Stadium 
印度对外事务部部长	Minister of External Affairs of India 
佐加顿斯体育会足球队	Zogardens Athletic Club Football Team 
荣轮院殿	Ronglun Temple 
汉纳·普里姆罗斯，罗斯伯里伯爵夫人	Hannah Primrose, Countess of Rothbury 
凯恩与林奇2：伏天	Kane and Lynch 2: Futian 
欧洲中部时间	Central European Time 
罗德学院	Rhodes College 
德永晓人	De Yong Xiaoren 
宍戸胜	Shitokatsu 
华和家四姊妹	The Four Sisters of Huahe Family 
嘻哈音乐	Hip hop music 
北爱尔兰事务大臣	Secretary of State for Northern Ireland 
贝专纳兰保护领	Bechnaland Protection Collar 
明圣王后	Queen Ming Sheng 
尼古拉·范西塔特，第一代贝克斯利男爵	Nicolas Fansitat, first Baron Bexley 
许蕾姆苏丹	Hurem Sultan 
情侣合唱团	Lovers Choir 
比斯拉马语	Bislama 
以色列理工学院	Israel Institute of Technology 
科幻小说	science fiction 
池田繁美	Ikeda Shigemi 
tvb8_(台湾版)	tvb8_ (Taiwan Version) 
宇喜多秀家	Ukita Hideie 
lovelive!	lovelive! 
威斯康辛大学法学院	University of Wisconsin School of Law 
马克·史蒂文斯_(电影剪接师)	Mark Stevens_ (Film Editor) 
索尼电脑娱乐	Sony Computer Entertainment 
一代枭雄	A generation of heroes 
二十世纪福斯家庭娱乐	Twentieth Century Fox Home Entertainment 
音乐制作人	music producer 
浪花伊吕波节	Naniwa Iroha Festival 
科学幻想	Science fiction 
电子游戏机	Electronic game console 
itv2	itv2 
安哥拉中央银行	Central Bank of Angola 
希腊哲学	Greek philosophy 
武汉东风本田足球俱乐部	Wuhan Dongfeng Honda Football Club 
阿图瓦的索菲亚	Sophia of Artois 
爱贝克思	Albex 
马来－波利尼西亚语族	Malay-Polynesian 
国家语言	National language 
暮光之城：暮色	Twilight Saga: Twilight 
新会站	Xinhui Station 
黎耀祥	Li Yaoxiang 
中共中央对外联络部	International Liaison Department of the CPC Central Committee 
安德森包装工	Anderson Packers 
斯德哥尔摩王宫	Stockholm Royal Palace 
联邦众议员	Federal Representative 
英国城市地位	British city status 
中央人民政府人民革命军事委员会	People's Revolutionary Military Committee of the Central People's Government 
越南华人	Vietnamese Chinese 
美国邮政部长	United States Secretary of the Postal Service 
御名部皇女	Princess Minabe 
朝鲜战争	Korean War 
维亚纳亲王	Prince Viana 
康斯坦西雅·加托里斯卡_(1700-1759)	Constantia Gatoriska (1700-1759) 
弗里德里希·弗朗茨二世_(梅克伦堡-什未林)	Friedrich Franz II (Mecklenburg-Schwerin) 
第二次国共内战	The Second Civil War between the Kuomintang and the Communist Party 
皇家学会	Royal Society 
公民民主党	Civic Democratic Party 
大前锋	Power Forward 
鲁弗斯·艾萨克斯，第一代雷丁侯爵	Rufus Isaacs, the first Marquis of Reading 
门罗县_(纽约州)	Monroe County_(New York State) 
贸易委员会主席	Chairman of the Trade Committee 
佩雷斯王朝	Perez Dynasty 
单一管理区	Single management area 
元音附标文字	Vowel subscript 
近畿日本铁道	Kinki Japan Railway 
古典音乐	classical music 
勒芒足球俱乐部	Le Mans Football Club 
妮裳舞部曲-混音精选+新曲	Ni Chang Dance-Mix Selection + New Song 
纽卡素足球俱乐部	Newcastle Football Club 
喀麦隆23岁以下国家足球队	Cameroon U23 National Football Team 
杨熙_(填词人)	Yang Xi_ (Cyclist) 
奥羽越列藩同盟	Ou Yuehan League 
莫斯科中央陆军体育俱乐部	CSKA Moscow Sports Club 
具本能	Instinctive 
公共电视文化事业基金会	Public Television Culture Foundation 
标准列日	Standard Liege 
旁遮普地区	Punjab Region 
苏格兰的伊莎贝拉，(诺福克伯爵夫人)	Isabella of Scotland, (Countess of Norfolk) 
星沙_(消歧义)	Xingsha_ (disambiguation) 
三上真司	Mikami Shinji 
澳大利亚遣加拿大高级专员	Australia sends Canadian High Commissioner 
巴黎第十一大学	University of Paris 11 
默塞德县_(加利福尼亚州)	Merced County_ (California) 
创作歌手	Singer-songwriter 
皇家骑士勋章	Royal Knights Medal 
陈冯富珍	Margaret Chan 
另类金属	Alternative metal 
联邦信息处理标准	Federal Information Processing Standard 
建设公仆党	Public servant party 
博恩哈德一世_(萨克森-迈宁根)	Bornhard I_ (Saxony-Meiningen) 
沂蒙精神	Yimeng Spirit 
越南战争	Vietnam War 
哥伦比亚特区上诉法院	District of Columbia Court of Appeals 
英国国教会	Church of England 
卢森堡基督教社会人民党	Luxembourg Christian Social People's Party 
维托里奥·埃马努埃莱二世	Vittorio Emanuele II 
曼联预备队及青训学院	Manchester United Reserve and Youth Academy 
比勒费尔德阿米尼亚德国体育会	Bielefeld Arminian German Athletic Association 
欧洲联盟历史	European Union history 
时区列表	Time zone list 
标致307	Peugeot 307 
大西洋-刚果语族	Atlantic-Congo 
spotv+	spotv + 
当旺爸爸	Dangwang dad 
德间日本传播	German spread to Japan 
鱼跃在花见	See you in the flowers 
英国国徽	British National Emblem 
美国最高法院大法官	Justice of the U.S. Supreme Court 
独立学院理事会	Independent College Council 
尤柳什·塔尔那瓦-马尔切夫斯基	Yulyush Tarnava-Marchevsky 
最高议会_(乌兹别克斯坦)	Supreme Council_ (Uzbekistan) 
斗牛，要不要	Bullfight, do you want 
阿根廷23岁以下国家足球队	Argentina U23 National Football Team 
陈安丽	Chen Anli 
县市	Counties 
居家兵团	Home Corps 
朋克摇滚	Punk Rock 
北朝鲜劳动党	North Korean Labor Party 
巴西奥运足球队	Brazil Olympic Football Team 
罗素集团	Russell Group 
清水庆记	Qingshui Keiji 
瑞士19岁以下国家足球队	Switzerland under-19 national football team 
距离感应器	Proximity sensor 
塞文欧克斯_(英国国会选区)	Seven Oaks (UK Parliamentary District) 
皇太孙	Emperor grandson 
孟广美	Meng Guangmei 
阿拉伯联合酋长国行政区划	Administrative divisions of the United Arab Emirates 
中国共产主义青年团	Chinese Communist Youth League 
美国圣公会	American Anglican Church 
尹日尚	Yin Rishang 
贝尔直升机公司	Bell Helicopter 
班图语支	Bantu branch 
近畿地方	Kinki area 
枢密院议长	President of the Privy Council 
蒙古语西里尔字母	Mongolian Cyrillic 
湖北各市州地区生产总值列表	List of Gross Domestic Product of Hubei Provinces 
马鲁蒂铃木公司	Maruti Suzuki 
银川贺兰山足球俱乐部	Yinchuan Helan Mountain Football Club 
欧洲西部夏令时间	Western European Summer Time 
白俄罗斯卢布	Belarusian Ruble 
国际民主联盟	International Democratic League 
杜青林	Du Qinglin 
山冈万之助	Yamaoka Manosuke 
台湾高速铁路	Taiwan High Speed Railway 
台视周五优质戏剧	TTV Friday Quality Drama 
中华人民共和国国务院	national assembly of the PRC 
category:唐朝皇后	category:Tang Dynasty Queen 
死亡金属	Death metal 
瑃常在	Always be there 
流行音乐	Pop music 
老爸老妈的浪漫史_(俄罗斯电视剧)	The Romance of Mom and Dad_ (Russian TV Series) 
美国23岁以下国家足球队	U.S. Under-23 National Football Team 
音乐专辑	Music album 
黑田洋介	Yosuke Kuroda 
astro集团	astro group 
霍普金顿_(马萨诸塞州)	Hopkinton_ (Massachusetts) 
人民公正党	People's Justice Party 
类比电视	Analog TV 
德川家光	Tokugawa Iemitsu 
移动电话	mobile phone 
顺子内亲王	Prince of Shunzi Nei 
归正神学	Reformed Theology 
第十一届全国人民代表大会	The Eleventh National People's Congress 
贝里斯中央银行	Central Bank of Belize 
歌词作者	Lyricist 
公立大学	Public universities 
真鹤町	Manazuru Town 
yg娱乐	ygEntertainment 
英国国家格网参考系统	British National Grid Reference System 
中国兵器工业集团	China North Industries Group 
爱尔兰君主列表	List of Irish monarchs 
车正敏	Che Zhengmin 
台大医院站	National Taiwan University Hospital Station 
罗勒_(澳大利亚国会选区)	Basil_ (Australian Parliamentary Constituency) 
汤健萍	Tang Jianping 
木村有希	Kimura Yuki 
马来西亚fam足球联赛	Malaysian fam football league 
西澳大利亚州	Western Australia 
直嶋正行	Masayuki Naoshima 
剑桥大学冈维尔与凯斯学院	Gonville and Case College, Cambridge University 
埃及历史	Egyptian history 
金鵄勋章	Gold Medal 
爱尔兰宪法	Irish Constitution 
实效论	Pragmatism 
小孩大人	Child adult 
国王密使	King's Emissary 
耶路撒冷的阿马尔里克二世	Amalric II of Jerusalem 
巴伐利亚的玛丽亚·安娜_(1551年-1608年)	Maria Anna of Bavaria (1551-1608) 
梁恩东	Liang Endong 
智能手机	smart phone 
流浪者足球俱乐部	Rangers Football Club 
谷轩龙	Gu Xuanlong 
farhampton	farhampton 
苏联外交部	Soviet Ministry of Foreign Affairs 
长尾大	Nagao Dai 
萧智坤	Xiao Zhikun 
赖比瑞亚银行	Liberia 
台语流行音乐	Taiwanese pop music 
冰岛总理列表	List of Prime Ministers of Iceland 
帕尔马公爵	Duke of Palma 
类unix系统	Unix-like system 
博卡字母表	Boca alphabet 
dansband	dance band 
隐蔽类游戏	Hidden games 
香港有线电视	Hong Kong Cable TV 
李成昌	Li Chengchang 
斯科哈里县_(纽约州)	Schohari County_ (New York State) 
阿尔里法体育会	Al Lifa Sports Club 
枭龙战机	Xiaolong Fighter 
彩虹闪耀夏之恋	Rainbow shines summer love 
长江桥隧列表	List of Yangtze River Bridges and Tunnels 
法属印度支那元	French Indochina Dollar 
于卡·内瓦莱尼	Yuka Nevaleni 
高清电视	HDTV 
斯德哥尔摩老城	Stockholm Old Town 
刘顺安	Liu Shunan 
新疆民族语言文字工作委员会	Xinjiang Ethnic Language Working Committee 
摇滚音乐	rock music 
炎黄二帝巨型塑像	Giant statues of Emperor Yan and Huang 
点解阿sir系阿sir	A sir is a sir 
胡雪峰	Hu Xuefeng 
地名信息系统	Geographical Name Information System 
好汉两个半集数列表	Hero two half episode list 
沙地阿拉伯国旗	Saudi Arabia flag 
池部良	Ryo Ikebe 
动画歌曲	Animated song 
井上大辅	Daisuke Inoue 
功勋勋章	Meritorious Medal 
古巴摇滚	Cuban Rock 
北京理工	Beijing Institute of Technology 
黑山公国	Principality of Montenegro 
中非国家银行	Bank of Central Africa 
民主社会党	Democratic Socialist Party 
.ma	.horse 
淡马锡控股	Temasek Holdings 
安徽各地级市地区生产总值列表	List of regional GDP of each city in Anhui 
狄奥多拉_(希腊公主)	Theodora_ (Princess of Greece) 
柯尼斯堡大学	University of Königsberg 
专有软件	Proprietary software 
台湾民族主义	Taiwanese nationalism 
清太祖皇八女	Eight Daughters of the Qing Taizu Emperor 
斯里兰卡总理	Prime Minister of Sri Lanka 
皇权免税	Imperial power exemption 
潘嘉德	Pan Jiade 
录音室专辑	Studio album 
英格兰的菲利普	Philip of England 
安耶巴足球俱乐部	Anyeba Football Club 
段霱	Duan Ji 
.ge	. 
正声广播公司	Zhengsheng Broadcasting Company 
推理小说	Mystery 
创世纪_(电视剧)	Genesis_ (TV series) 
三角测量隐喻	Triangulation metaphor 
猫头鹰出版社	Owl Press 
白狮勋章	White Lion Medal 
黄夫人	Mrs. Huang 
ecma国际	ecma international 
.je	.is 
岩崎琢	Taku Iwasaki 
鞑靼联盟	Tatar League 
弗里德里希·弗朗茨三世_(梅克伦堡-什未林)	Friedrich Franz III (Mecklenburg-Schwerin) 
微积分基本定理	Fundamental Theorem of Calculus 
波旁复辟	Bourbon restoration 
小川贵史	Takashi Ogawa 
文艺复兴	Renaissance 
哈蒙德风琴	Hammond Organ 
贝尔穆多一世_(阿斯图里亚斯)	Belmudo I_ (Asturias) 
点穴篇	Acupuncture 
曼海姆足球俱乐部	Mannheim Football Club 
中央人民政府最高人民检察署	Supreme People's Procuratorate of the Central People's Government 
江苏苏宁	Jiangsu Suning 
服装设计	Fashion Design 
剑桥公爵	Duke of Cambridge 
泊松代数	Poisson Algebra 
褚英	Chu Ying 
嘉峪关南站	Jiayuguan South Station 
希尔德贝尔特一世	Hildebert I 
市民连合	Citizen union 
美国共和党	U.S. Republican Party 
新西兰国旗	New Zealand flag 
瑞常在	Rui Chang is 
基督教民主主义	Christian Democracy 
纳戈尔诺-卡拉巴赫共和国	Nagorno-Karabakh Republic 
坎特伯雷大学	University of Canterbury 
拿玻里足球俱乐部	Napoli Football Club 
军事学校	Military school 
薛定谔方程	Schrodinger equation 
史密森学会	Smithsonian Institution 
格奥尔基·米哈伊洛维奇，布拉索夫伯爵	Georgi Mikhailovich, Count of Brasov 
皇家安特卫普足球俱乐部	Royal Antwerp Football Club 
乌克兰苏维埃社会主义共和国最高苏维埃	Supreme Soviet of the Ukrainian Soviet Socialist Republic 
循道宗	Methodist 
仁心解码ii	Benevolent decoding ii 
特拉华大学	University of Delaware 
阿德南曼德里斯国际机场	Adnan Mandris International Airport 
亚历山大·德·博阿尔内	Alexandre de Boarnet 
12英寸单曲	12 inch single 
宇宙学常数	Cosmological constant 
法兰·朗基拿	Frank Longkina 
七姊妹	Seven Sisters 
萨克森的玛丽·特丽莎公主	Princess Mary Theresa of Saxony 
陆军杰出服役勋章	Army Distinguished Service Medal 
命令提示字元	CMD 
佐野常民	Sano Tsunami 
普度历高夫	Purdul Goff 
九龙湾公园	Kowloon Bay Park 
郑经翰	Zheng Jinghan 
高卢-伊利比语支	Gaul-Iliban 
货币政策	Monetary Policy 
汉语拼音	Chinese Pinyin 
file:dickinson_logo.png	file:dickinson_logo.png 
新房昭之	Xinfang Zhaozhi 
纬来日本台	Wei Lai Japan Taiwan 
伦敦塔	Tower of London 
塔马舍克语支	Tamasek 
志尹南	Zhi Yinnan 
贝塞尔函数	Bessel function 
维也纳会议	Vienna Conference 
加拿大摇滚	Canadian Rock 
旋转磁场	Rotating magnetic field 
陈塘支线铁路	Chentang Branch Railway 
虫奉行	Worm pursuing 
立陶宛统治者列表	List of rulers of Lithuania 
德川将军家	House of General Tokugawa 
.iq	.iq 
高寺成纪	Kosi Seiki 
平板电脑	tablet 
亚历山大·赫塔古里	Alexander Hertaguri 
颜汶羽	Yan Wenyu 
湖南省各市州人口列表	Population list of cities and prefectures in Hunan Province 
laxmikant_parsekar	laxmikant_parsekar 
朝鲜劳动党中央政治局	Central Political Bureau of the Workers' Party of Korea 
今上天皇	Reigning Emperor 
长景市_(华盛顿州)	Changjing City_(Washington State) 
黄灿盛	Huang Cansheng 
政治人物	political figure 
欧洲资讯与数学研究组织	European Information and Mathematics Research Organization 
英语流行音乐	English Pop 
都市自治市	Metropolitan Municipality 
理查·寇松，第二代斯卡斯代尔子爵	Richard Curzon, 2nd Viscount Scarsdale 
瑞典社会民主党	Swedish Social Democratic Party 
3dnow!	3dnow! 
市长-议会制政府	Mayor-Parliamentary Government 
邓智伟	Deng Zhiwei 
首里城	Shuri Castle 
立陶宛社会民主党	Lithuanian Social Democratic Party 
就业事务大臣	Minister of Employment 
国际管理发展学院	International Management Development Institute 
地面车站	Ground station 
保加利亚总统	President of Bulgaria 
吉川贵盛	Yoshikawa Takamori 
周家怡	Zhou Jiayi 
贝特晶格	Bethe lattice 
王君	Wang Jun 
emi音乐日本	emi music japan 
谍影重重系列	Bourne Shadow Heavy Series 
里田舞	Mai Satoda 
前470年	470 years ago 
在职研究生	On-job postgraduate 
上海有线02足球俱乐部	Shanghai Cable 02 Football Club 
原声音乐	Soundtrack 
麦金莱国家纪念堂	McKinley National Memorial 
约旦首相列表	List of Prime Ministers of Jordan 
云端运算	Cloud computing 
万宇衡	Wan Yuheng 
腓特烈·威廉四世	Frederick William IV 
唐乾陵	Tang Qianling 
原型程式设计	Prototype programming 
索马里过渡国家政府	Somalia Transitional Government 
刘永宣	Liu Yongxuan 
土耳其祖国党	Turkish Fatherland Party 
舞蹈流行音乐	Dance pop 
亨利·米勒_(新西兰政治家)	Henry Miller_ (New Zealand politician) 
第八届全国人民代表大会	Eighth National People's Congress 
粤语流行音乐	Cantonese pop music 
威廉·帕尔默，第二代塞尔伯恩伯爵	William Palmer, 2nd Earl of Selborn 
天主教米兰总教区	Catholic Archdiocese of Milan 
联邦资料处理标准	Federal Data Processing Standard 
利奥波德·蒙巴顿勋爵	Lord Leopold Mountbatten 
国民大会	National Assembly 
电子游戏产业	Video game industry 
穆拉德五世	Murad V 
长岛海湾	Long Island Bay 
柿谷曜一朗	Yoichiro Kakitani 
马哈茂德·苏莱曼·马格里比	Mahmoud Suleiman Magribi 
中国民族主义	Chinese nationalism 
泉男产	Izumi 
印尼流行音乐	Indonesian pop music 
中华全国总工会	All-China Federation of Trade Unions 
内蒙古各市盟地区生产总值列表	List of Gross Domestic Product of Inner Mongolia 
xtensa	xtensa 
sääksmäki	Sääksmäki 
格里诺克慕顿足球俱乐部	Greenock Muton Football Club 
免费软体	Free software 
王宝军	Wang Baojun 
排版引擎	Typesetting engine 
韩国外国语大学	Korea University of Foreign Studies 
泰国枢密院	Privy Council of Thailand 
存在女性主义	Existential feminism 
第十个王心凌	The tenth Wang Xinling 
实验摇滚	Experimental rock 
利奥波德二世_(托斯卡纳)	Leopold II_ (Tuscany) 
.om	.if 
兴琴布鲁克郡政府	Hingchenbrook County Government 
捷克斯洛伐克克朗	Czechoslovak Koruna 
朱橚	Zhu X 
辛国斌	Xin Guobin 
意大利足球丙二级联赛	Italian Football League III 
二条齐敬	Nijo Qijing 
动作片演员	Action movie actors 
次紧凑型车	Subcompact car 
莎阿南	Shah Alam 
朱之文_(会计师)	Zhu Zhiwen_ (Accountant) 
奥尔良的亨利_(巴黎伯爵)	Henry of Orleans (Earl of Paris) 
法国20岁以下国家足球队	France under-20 national football team 
克洛泰尔二世	Clotel II 
荣惠皇贵妃	Royal Concubine 
国会议员	Congressman 
绿党－欧洲自由联盟	Green Party-European Freedom League 
安利竞技场	Amway Arena 
数位音乐下载	Digital music download 
desteldonk	desteldonk 
土田御前	Dota Gozen 
又一村	Another village 
奥多尼奥三世_(莱昂)	Odonho III_ (Leon) 
菊池一仁	Kazuhito Kikuchi 
机械工程	Mechanical engineering 
光荣革命	Glorious Revolution 
柬埔寨政府首脑列表	List of Heads of Government of Cambodia 
肯塔基大学	University of Kentucky 
上市公司	Listed company 
新北市第十二选举区_(2008年立法委员)	The 12th Electoral District of New Taipei City_ (2008 Legislative Councillor) 
聪加语	Tsunga 
中泽祥次郎	Shojiro Nakasou 
bsd许可证	bsd license 
斯尼亚和黑塞哥维那党	Snia and Herzegovina Party 
荣寿固伦公主	Princess Rongshou Gulun 
全日空之翼	ANA Wings 
美国铸印局	U.S. Bureau of Engraving and Printing 
环球唱片	Universal Music 
克劳斯-卡西米尔_(奥兰治-拿骚的阿姆斯博格伯爵)	Klaus Casimir_ (Earl of Armsberg of Orange-Nassau) 
土城机厂	Tucheng Machinery Factory 
皇家马德里卡斯蒂利亚足球俱乐部	Real Madrid Castilla Football Club 
苏联部长会议	Soviet Council of Ministers 
大卫·邓达斯_(英国军人)	David Dundas_ (British soldier) 
轩尼诗_(香港总督)	Hennessy_(Governor of Hong Kong) 
戈采代尔切夫足球俱乐部	Gotse Delchev Football Club 
新民主党	New Democratic Party 
砂拉越	Sarawak 
主教座堂	Cathedral 
键盘乐器	Keyboard instrument 
金艺琳_(1999年出生)	Jin Yilin_ (born in 1999) 
克里米亚部长会议主席	Chairman of the Crimea Council of Ministers 
瑞士近卫队	Swiss Guard 
埃蒂安·莫里斯_(热拉尔伯爵)	Etienne Morris_ (Count of Gerard) 
澳大利亚工党	Australian Labor Party 
金边王朝	Phnom Penh Dynasty 
欧洲足球锦标赛	European Football Championship 
自由向导	Free guide 
君主专制	Monarchy 
第一尚氏	Daiichi Shangji 
乌兹别克斯坦国家足球队	Uzbekistan National Football Team 
亚足联u19青年锦标赛	AFC U19 Youth Championship 
北中部	North Central 
叙利亚东正教	Syrian Orthodox Church 
意大利-达尔马提亚语支	Italian-Dalmatian branch 
台湾索尼音乐娱乐	Sony Music Entertainment Taiwan 
姑山里	Mother-in-law 
勒班陀战役	Battle of Lepanto 
曲水镇_(曲水县)	Qushui Town_(Qushui County) 
台北捷运	Taipei MRT 
上海文化广播影视集团	Shanghai Culture, Radio, Film and Television Group 
普查规定居民点	Census required settlements 
苏格兰联赛杯	Scottish League Cup 
旧金山和约	San Francisco Peace Treaty 
波兰战役	Battle of Poland 
法国城市列表	List of cities in France 
国际中间派民主联盟	International centrist democratic alliance 
英国邮区编号	UK postal code 
诺特能源球场	Knott Energy Stadium 
palmyrene字母	palmyrene letters 
altran	altran 
浙江大学	Zhejiang University 
九阴大法	Nine Yin Dafa 
华纳兄弟电视发行公司	Warner Bros. Television Distribution Company 
荷兰国会二院	Second House of the Dutch Parliament 
朱镜祺	Zhu Jingqi 
wikt:洛阳	wikt: Luoyang 
叶夫多基娅·卢基扬诺芙娜	Yevdokya Lukyanovna 
萧姓	Xiao 
纳豆天使	Natto Angel 
锡拉库扎	Syracuse 
埃米利奥·阿奎纳多	Emilio Aguinaldo 
婆罗米系文字	Brahmi script 
社会运动家	Social activist 
南方文学	Southern Literature 
布加勒斯特大学	University of Bucharest 
终极系列	Ultimate series 
霍金辐射	Hawking radiation 
八丁堀站_(东京都)	Hatchobori Station_(Tokyo) 
俄罗斯联邦中央银行	Central Bank of the Russian Federation 
马来西亚摇滚	Malaysian Rock 
冯肇均	Feng Zhaojun 
影子商务、创新及技能大臣	Shadow Minister of Commerce, Innovation and Skills 
魏道武帝	Emperor Wei Daowu 
福田俊介	Shunsuke Fukuda 
林志华	Lin Zhihua 
国家原子能机构	National Atomic Energy Agency 
java虚拟机	java virtual machine 
普罗瑟_(华盛顿州)	Proser_ (Washington State) 
蒙彼利埃足球俱乐部_(女子足球队)	Montpellier Football Club_ (Women's Football Team) 
美西战争	Spanish-American War 
固伦雍穆长公主	Princess Gulun Yongmu 
香港行政会议成员列表	List of members of the Hong Kong Executive Council 
提乌德里克一世	Tiudric I 
半总统制	Semi-presidential system 
重庆三环高速公路	Chongqing Third Ring Expressway 
马基新	Majixin 
冯健身	Feng Fitness 
中间偏右	Center right 
穆扬阿	Muyanga 
欧洲冠军联赛	The UEFA Champions League 
日本华纳音乐	Warner Music Japan 
美乐。加油	Merlot. Come on 
协荣里	Xierongli 
不可知论	agnosticism 
朝鲜银行券	North Korean Bank Notes 
欧盟贸易专员	EU Trade Commissioner 
邮政编码	Postal code 
诺福克_(弗吉尼亚州)	Norfolk_ (Virginia) 
世界摩托车锦标赛	World Motorcycle Championship 
英皇第1龙骑卫队	1st Dragoon Guard 
佐天仁皇后	Queen Satenhi 
权昶勋	Quan Changxun 
守护甜心！	Shugo Chara! 
南非摇滚	South African Rock 
大紫荆勋章	Grand Bauhinia Medal 
中原杏	Central Plains Apricot 
何露欣	He Luxin 
阿里格尔穆斯林大学	Aligarh Muslim University 
美洲足球俱乐部	American football club 
英格兰19岁以下足球代表队	England Under-19 Football Team 
彭美凤	Peng Meifeng 
都江堰凤凰体育场	Dujiangyan Phoenix Stadium 
伊拉克足球超级联赛	Iraq Premier League 
波琴体育会	Bochen Sports Club 
东亚足球协会	East Asian Football Association 
他侬·吉滴卡宗	Thanon Gitikazon 
四轮驱动	four-wheel drive 
挪威国王	King of Norway 
也门总统	President of Yemen 
班卓琴	Banjo 
淑嘉皇贵妃	Emperor Shujia 
美国独立战争	American Revolution 
俄罗斯职业足球联赛	Russian Professional Football League 
圣菲研究所	Santa Fe Institute 
百年战争	Hundred Years War 
特级宗座圣殿	Grand Basilica 
西街少年	West Street Boy 
韩廷和	Han Tinghe 
不丹国庆日	Bhutan National Day 
金民均	Jin Minjun 
奇幻作品	Fantasy works 
英国电影学院奖最佳女主角	British Film Academy Awards for Best Actress 
水原三星蓝翼	Suwon Samsung Blue Wing 
犹他州立大学	Utah State University 
埃曼努埃尔·阿格耶芒-巴度	Emmanuel Agyeman-Bado 
化能生物	Chemical energy 
阿德莱·e·史蒂文森一世	Adlay E. Stevenson I 
土耳其陆军	Turkish Army 
伯克利县_(西弗吉尼亚州)	Berkeley County_ (West Virginia) 
郑咏恩	Zheng Yongen 
比干拿	Bigana 
寺岛忍	Shinobu Terajima 
维格纳分布	Wigner distribution 
蒙古总理	Prime Minister of Mongolia 
网路存取	Internet access 
巴贝多总督	Governor of Barbados 
田安德川家	Tian An Dechuan 
曹永廉	Cao Yonglian 
欧洲大学协会	European University Association 
沙柏高夫	Saber Goff 
汉堡足球俱乐部	Hamburg Football Club 
巴斯和东北萨默塞特	Bath and Northeast Somerset 
香港08	Hong Kong 08 
史达福区_(昆士兰州)	Staford District_(Queensland) 
瑟于特	Soyut 
新加坡樟宜机场	Singapore Changi Airport 
陈博正	Chen Bozheng 
羽住英一郎	Eiichiro Hasumi 
郭建宏_(制作人)	Guo Jianhong_(Producer) 
爱立信球形体育馆	Ericsson Sphere Stadium 
行政机关	Administrative agency 
全国人民代表大会常务委员会副委员长	Vice Chairman of the Standing Committee of the National People's Congress 
汤显明	Tang Xianming 
格拉摩根谷	Glamorgan Valley 
宫冈宽	Miyaoka Hiroshi 
岸间信明	Nobuaki Kishima 
赤松广隆	Akamatsu Hirotaka 
阿敏塔斯四世	Amintas IV 
新西兰勋章	New Zealand Medal 
薰衣草	lavender 
公民足球队	Citizen football team 
朝鲜劳动党中央军事委员会	Central Military Commission of the Workers' Party of Korea 
牵牛花	Morning glory 
kobuleti	kobuleti 
寮王国	Lao Kingdom 
杰出服役十字勋章	Distinguished Service Cross 
下院之父	Father of the House of Commons 
北伊斯灵顿_(英国国会选区)	North Islington_(British Parliamentary District) 
第一次印度支那战争	First Indochina War 
国家航天局	National Space Administration 
关中话	Guanzhong Dialect 
fnc娱乐	fnc entertainment 
孝纯太后	Empress Xiaochun 
突尼斯大学	University of Tunis 
20美元纸币	20 dollars banknotes 
自由软件	Free software 
艾胥森林区_(昆士兰州)	Aixu Forest Area_(Queensland) 
怪物王女	Monster Queen 
互动式娱乐	Interactive entertainment 
地下车站	Underground station 
法国众议院	French House of Representatives 
奥斯曼帝国入侵奥特朗托	The Ottoman Empire invades Otranto 
松村文雄	Fumio Matsumura 
哥辛沙足球会	Kosinsha Football Club 
凯德尔斯顿伯爵	Earl of Kedleston 
通古斯民族	Tunguska 
昭仁公主	Princess Zhaoren 
中华人民共和国最高人民法院院长	President of the Supreme People's Court of the People's Republic of China 
瑞典19岁以下国家足球队	Sweden Under-19 National Football Team 
gp2亚洲系列赛	gp2 Asian Series 
宋长志	Song Changzhi 
布鲁克林桥－市政府/钱伯斯街车站	Brooklyn Bridge-City Hall/Chambers Street Station 
北高加索语族	North Caucasus 
迈阿密大学	University of Miami 
琼·坎宁，第一代坎宁女子爵	Joan Canning, the first generation of Canning ladies 
东京地下铁	Tokyo Metro 
卑尔根大学	University of Bergen 
日本足球协会	Japan Football Association 
西吉贝尔特三世	Sigibert III 
版本控制	version control 
密克罗尼西亚的爱国者	Patriots of Micronesia 
综合性大学自主选拔录取联合考试	Comprehensive university independent selection and admission joint examination 
竹野内丰	Takenouchi 
里达·帕夏·里卡比	Rida Pasha Ricabi 
邹锦安	Zou Jinan 
陈金让	Chen Jinrang 
file:清_佚名_《清宣宗道光皇帝朝服像》.jpg	file:Qing_Anonymous_ "Portrait of Emperor Xuanzong Daoguang's Court Clothes".jpg 
电视明星	TV star 
摩托罗拉移动	Motorola Mobility 
黎家明	Li Jiaming 
青岛鲲鹏足球俱乐部	Qingdao Kunpeng Football Club 
天主教平壤教区	Catholic Diocese of Pyongyang 
欧直as532美洲狮直升机	Eurocopter as532 Cougar helicopter 
议会民主制	Parliamentary democracy 
专有软体	Proprietary software 
犹太战争	Jewish War 
笔记型电脑	Laptop 
浙江各地级市地区生产总值列表	List of Gross Domestic Product of Zhejiang Province 
中华文化	Chinese culture 
伊拉克中央银行	Central Bank of Iraq 
总统自由勋章	Presidential Medal of Freedom 
菲林根-施文宁根	Villingen-Schwenningen 
延平王	King Yanping 
logo语言	logo language 
阿联酋航空	Emirates 
钱颖芝	Qian Yingzhi 
朝日电视台	TV Asahi 
布里斯班狮吼	Brisbane Roar 
吉布提法郎	Djiboutian Franc 
印度总司令	Commander-in-chief of india 
罗科·萨尔洛莫内	Rocco Sallomone 
奥斯曼帝国大维齐尔列表	List of the Great Vizier of the Ottoman Empire 
潘毅成	Pan Yicheng 
喀布尔大学	Kabul University 
影子工作及退休金大臣	Shadow work and pension minister 
贸易保护主义	Trade protectionism 
黄志芳	Huang Zhifang 
民主共和党	Democratic Republican Party 
终极一班2	Ultimate Class 2 
曾山	Zeng Shan 
第五届全国人民代表大会	Fifth National People's Congress 
日本行政区划	Administrative divisions of Japan 
加拿大联邦化	Canadian Federalization 
命中注定我爱你	Destined to love you 
美国西部	Western America 
乌尔巴诺七世	Urbano VII 
苏联元帅列表	List of Soviet marshals 
驻日盟军总司令	Commander-in-chief of allied forces in japan 
位移电流	Displacement current 
可米国际影视	Komi International Television 
卢森堡首相	Prime Minister of Luxembourg 
斯妲特拉二世	Stella II 
清洲城	Kiyosu Castle 
堀越高等学校	Hori Higher School 
竞赛俱乐部	Competition club 
非洲金融共同体法郎	CFA franc 
.fr	.fr 
中国共产党第十六届中央委员会	The 16th Central Committee of the Communist Party of China 
西北赛区	Northwest Division 
南雄太	Yuta Minami 
苏霍伊航空集团	Sukhoi Aviation Group 
游戏引擎	Game Engine 
电影监制	Film producer 
经济自由主义	Economic liberalism 
生物化学	Biochemistry 
前苏格拉底哲学	Pre-Socratic philosophy 
s:中华人民共和国刑事诉讼法	s: Criminal Procedure Law of the People's Republic of China 
摩洛哥皇家足球协会	Royal Moroccan Football Association 
中途岛号航空母舰	USS Midway 
以色列独立宣言	Israel Declaration of Independence 
帕尔马足球俱乐部	Parma Football Club 
中国共产党北京市委员会	Beijing Municipal Committee of the Communist Party of China 
塞尔维亚第纳尔	Serbian Dinar 
三宅一德	Miyake Yide 
二宫和也	Kazunari Ninomiya 
契丹小字	Khitan small print 
反恐战争	War on terror 
四川音乐学院	Sichuan Music College 
比利时国庆日	Belgium National Day 
中国共产党云南省委员会	Yunnan Provincial Committee of the Communist Party of China 
都留市	Tsuru City 
藤谷太辅	Taisuke Fujigaya 
国防部杰出服役勋章	Department of Defense Distinguished Service Medal 
租借法案	Lease Act 
梁丝韵	Liang Siyun 
竹本升	Noboru Takemoto 
噪音摇滚	Noise rock 
西方哲学	Western philosophy 
阿达纳足球俱乐部	Adana Football Club 
金久保彩	Kinkubo Aya 
哈拉和林	Hara and Lin 
哈珀斯费里_(西弗吉尼亚州)	Harpers Ferry_ (West Virginia) 
英国空军上将	British Air Force Admiral 
政治统一	Political unity 
芝加哥白袜	Chicago White Sox 
不列颠哥伦比亚大学	University of British Columbia 
泊松分布	Poisson distribution 
多人电子游戏	Multiplayer video games 
杨辉三角形	Yang Hui triangle 
光速兔崽子	Lightspeed Harp 
平安时代	Heian era 
特日内茨足球俱乐部	Trinetz Football Club 
平城天皇	Emperor Heizei 
文艺复兴哲学	Renaissance philosophy 
元气少女缘结神	Vitality girl 
近接传感器	Proximity sensor 
中华人民共和国国防部发言人	Spokesperson of the Ministry of National Defense of the People's Republic of China 
公共选择理论	Public choice theory 
巴鲁埃里体育俱乐部	Barueri Sports Club 
nh90直升机	nh90 helicopter 
爱荷华州州长	Governor of Iowa 
多重编程范式	Multiple programming paradigms 
冯潇霆	Feng Xiaoting 
里瓦德德瓦	Ribaddeva 
义大利天主教民主党	Catholic Democratic Party of Italy 
马格里布阿拉伯语	Maghreb Arabic 
大勋位菊花章	Grand Order Chrysanthemum Medal 
国务院组成部门	Departments of the State Council 
一般国道	General national highway 
北京官话	Beijing Mandarin 
立宪政友会	Rikken Seiyukai 
维珍唱片公司	Virgin Records 
天津南港工业区	Tianjin Nangang Industrial Zone 
海峡唱片	Channel Records 
幸田直子	Naoko Kouda 
智利守安息日者	Chilean Sabbathkeeper 
没有你活不下去	Can't live without you 
乾隆帝长女	The eldest daughter of Emperor Qianlong 
富山县旗	Toyama Prefecture Flag 
三立电视戏剧节目列表	Sanli TV Drama Program List 
精神哲学	Spiritual philosophy 
非结构化程式设计	Unstructured programming 
萨索罗足球俱乐部	Sassuolo Football Club 
圣保罗足球俱乐部	Sao Paulo Football Club 
马里安·热格塔-亚努沙伊提斯	Marian Rageta-Yanushaytis 
北美中部时区	North America Central Time Zone 
语言哲学	Philosophy of language 
老街市	Lao Cai 
宗国英	Sogoku Hide 
阿肯色州司法部长	Attorney General of Arkansas 
爱德华八世	Edward VIII 
尼古拉·特鲁别茨柯伊	Nikolai Trubetskoy 
醉后决定爱上你	Decided to fall in love with you after being drunk 
leça_f.c.	leça_f.c. 
吴正世	Wu Zhengshi 
民主就是自由－雏菊	Democracy is freedom-daisy 
阮福保（阝恩）	Nguyen Phuc Po (Tian En) 
向忠发	Xiang Zhongfa 
古怒田健志	Kenji Konuta 
功绩奖章	Merit Medal 
列比高	Liebiga 
罗马尼亚环境与森林部	Romanian Ministry of Environment and Forests 
中共最高人民法院党组	Party Group of the Supreme People's Court of the Communist Party of China 
宋子文	Song Ziwen 
利比亚地理	Geography of Libya 
叙利亚内战	Syrian Civil War 
挪威摇滚	Norwegian rock 
关皓月	Guan Haoyue 
世袭王子宫	Hereditary womb 
尹常在	Yin Changzai 
松浦拓弥	Matsuura Takuya 
胡窕容	Hu Tirong 
热带及亚热带湿热阔叶林带	Tropical and subtropical humid and hot broad-leaved forest belt 
社会党国际	Socialist International 
乌兹别克斯坦共和国中央银行	Central Bank of the Republic of Uzbekistan 
美墨战争	American-Mexico war 
阿基坦的威廉十世	William X of Aquitaine 
漫威电视	Marvel TV 
北非洲足球协会联会	North African Football Association Federation 
rom卡带	rom cassette 
埃及空军	Egyptian Air Force 
西班牙首相列表	List of Prime Ministers of Spain 
山东省立实验剧院	Shandong Provincial Experimental Theater 
斯科普里	Skopje 
精神分析学	Psychoanalysis 
蒙特内哥罗社会主义者民主党	Montenegro Socialist Democratic Party 
穆罕默德贾瓦德·巴霍纳尔	Mohamed Jawad Bahonar 
光冈美游人	Mitsuoka Miyou 
程香里	Cheng Xiangli 
新奥尔巴尼_(印第安纳州)	New Albany_ (Indiana) 
罗马尼亚东正教	Romanian Orthodox Church 
慕尼斯帕尔体育会	Munispal Sports Club 
柬埔寨参议院议长列表	List of Speakers of the Cambodian Senate 
波兰省份	Polish provinces 
大学教育资助委员会	University Grants Committee 
摩尔多瓦国家银行	National Bank of Moldova 
民主党执行部	Democratic Executive Department 
平田增宗	Hirata Masumune 
笑吧！东海	Laugh! East China Sea 
银星勋章	Silver Star Medal 
尾木制作	Ogi production 
军事修会	Military order 
客家民系	Hakka people 
韩国23岁以下国家足球队	Korea Under-23 National Football Team 
张晓彬_(1993年出生)	Zhang Xiaobin_ (born in 1993) 
另类摇滚年表	Alternative Rock Chronology 
突尼西亚战役	Battle of Tunisia 
波斯尼亚和黑塞哥维那社会民主党	Social Democratic Party of Bosnia and Herzegovina 
托勒密二世	Ptolemy II 
轻爵士乐	Light jazz 
庇护八世	Pius VIII 
奄美群岛	Amami Islands 
海绵宝宝	SpongeBob 
超自然现象	Supernatural 
全国人民代表大会常务委员会	Standing Committee of the National People's Congress 
混合内核	Hybrid kernel 
东方电影公司	Oriental Film Company 
无伴奏合唱	A cappella 
特摄片	Special film 
那贵人	That nobleman 
塔尔齐西奥·贝尔托内	Tarzisio Bertone 
运输安全委员会	Transportation Safety Committee 
侠客唱片	Knight record 
李微微	Li Weiwei 
吉姆·福布斯_(澳大利亚政治家)	Jim Forbes_ (Australian politician) 
东马来-玻里尼西亚语群	East Malay-Polynesian group 
日本树莺	Japanese Tree Warbler 
大众媒体	Social media 
中欧标准时间	Central European Standard Time 
杜比数字	Dolby Digital 
奇幻文学	Fantasy Literature 
波罗地-芬兰语支	Baltic-Finnish 
英宝格	Infogrames 
工党总干事	Labour Party Director-General 
芬达爵士电贝斯	Sir Fanta Electric Bass 
广州恒大	Guangzhou Hengda 
虹彩六号	Rainbow Six 
菊冈拓朗	Kikuoka Takuro 
华盛顿杜勒斯国际机场	Washington Dulles International Airport 
自治地方	Autonomous place 
布立吞亚支	Briton Subch 
贾坎德高等法院	Jharkhand High Court 
普鲁士公园体育场	Prussian Park Stadium 
第一次世界大战	The first world war 
波兰国家科学院	Polish National Academy of Sciences 
第三条道路	The third way 
爱尔兰航空	Aer Lingus 
分析哲学	Analytical philosophy 
小安的列斯群岛	Lesser Antilles 
电脑游戏	Computer Games 
ios版本历史	ios version history 
太平洋时区	Pacific Time Zone 
藤本康太	Kota Fujimoto 
英国电影学院奖最佳女配角	British Film Academy Awards for Best Supporting Actress 
高木万平	Takagi Manpei 
深宫谍影	accrued 
utc-5	utc-5 
前333年	333 years before 
金球奖最佳戏剧类电影男主角	Golden Globe Award for Best Actor in a Drama Series 
费拉拉公国	Principality of Ferrara 
民主国民党	Democratic National Party 
图形用户界面	GUI 
帕斯托体育	Pastor Sports 
北京首都机场公司	Beijing Capital Airport Company 
后博普乐	Post-bople 
柬埔寨皇家空军	Royal Cambodian Air Force 
鲁道夫_(奥匈帝国皇太子)	Rudolf_ (Prince of Austro-Hungary) 
10欧元纸币	10 euro banknote 
集成开发环境	Integrated Development Environment 
奥利弗·坦博国际机场	Oliver Tambo International Airport 
牛津大学贝利奥尔学院	Belliol College, Oxford University 
国庆日	National Day 
台湾国语	Taiwanese Mandarin 
开放世界	Open world 
欧洲教会会大会	European Church Conference 
村井慎二	Shinji Murai 
新吴区	Xinwu District 
影视点制作有限公司	Movie Point Production Co., Ltd. 
映画传播	Film spread 
中央人民政府政务院	Central People's Government Administration Council 
那卜星	Nabu Star 
欧洲议会	European Parliament 
常胜七勇士	Seven Warriors 
科莫足球俱乐部	Como Football Club 
英国共和主义	British Republicanism 
李秋源	Li Qiuyuan 
英格兰君主列表	List of monarchs of England 
查克拉瓦尔蒂·拉贾戈巴拉查理	Chakravarti Rajagobara Charlie 
丹麦自由党	Danish Liberal Party 
学术委员会	Academic Committee 
罗马尼亚总理	Prime Minister of Romania 
博杜安国王体育场	King Baudouin Stadium 
希腊总理列表	List of Prime Ministers of Greece 
美国学院与大学协会	American Association of Colleges and Universities 
印度财政部	Ministry of Finance of India 
fc磁碟机	fc drive 
翻唱专辑	Cover album 
雷艾维斯球场	Rayavis Stadium 
马来西亚上议院	Malaysian House of Lords 
美国军功勋章	American Medal of Merit 
日本传统音乐	Japanese traditional music 
开尔文环流定理	Kelvin circulation theorem 
函数程式语言	Functional programming language 
奥尔德尼子爵	Alderney 
莫隆比球场	Morumbi Stadium 
中国工农红军	Chinese Workers and Peasants Red Army 
爱尔兰省份	Irish provinces 
银川贺兰山	Yinchuan Helan Mountain 
香港特别行政区全国人民代表大会代表	Representative of the National People's Congress of the Hong Kong Special Administrative Region 
江原足球俱乐部	Gangwon Football Club 
东孟加拉足球俱乐部	East Bengal Football Club 
中法大学	Sino-French University 
青铜中期文化时期字母	Mid-Bronze Cultural Period Letters 
仁敬王后	Queen Renjing 
医学博士	Medical PhD 
想拥抱你_(mr.children单曲)	I want to hug you_(mr.children single) 
公共汽车	bus 
坂上之云	Sakagami Cloud 
沃特福德_(芒斯特省)	Waterford_ (Munster) 
延吉市新体育场	Yanji New Stadium 
波特兰州立大学	Portland State University 
加拿大联合党	Canadian coalition party 
异教黑金属	Pagan Black Metal 
苏州吴中中元	Suzhou Wuzhong Zhongyuan 
超级黄蜂式直升机	Super Hornet helicopter 
美国海军战争学院院长	Dean of U.S. Naval War College 
韩昌柱	Han Changzhu 
第二次世界大战胜利奖章	Victory Medal of World War II 
芬威球场	Fenway Park 
精神三变	Three changes of spirit 
贝努埃-刚果语支	Benue-Congo branch 
日林斯基足球俱乐部	Zilinsky Football Club 
农业经济学	Agricultural economics 
松尾直人	Matsuo Naoto 
探险活宝各集列表	List of Adventure Time with Finn and Jake 
韩马利	Han Mali 
寿恩固伦公主	Princess Shouen Gulun 
脚本语言	Scripting language 
瑞典外交大臣	Minister of Foreign Affairs of Sweden 
希腊正教会	Greek Orthodox Church 
天命真女	Destiny 
标准画质电视	Standard picture quality TV 
查塔姆县_(北卡罗莱纳州)	Chatham County_ (North Carolina) 
斯大林奖	Stalin Prize 
韩国民主党	Democratic Party of Korea 
冬季战争	Winter war 
techland	techland 
中国中车集团公司	CRRC Corporation 
欧洲民族运动联盟	European National Movement League 
美国参谋长联席会议	United States Joint Chiefs of Staff 
中央区_(设拉子郡)	Central District_(Shiraz County) 
第二次布尔战争	Second Boer War 
意大利丙级足球联赛	Italian Football League C 
铁十字勋章	Iron Cross 
宁悫妃	Concubine Ning 
崔载烈	Choi Jae Yeol 
庄濠全	Zhuang Haoquan 
日本陆军大将列表	List of Japanese generals 
弓削皇子	Prince Yuge 
香港电台	Radio Hong Kong 
一百年电影有限公司	Centennial Film Co., Ltd. 
西蒙与舒斯特	Simon and Schuster 
基层政权	Grassroots government 
日光东照宫	Nikko Toshogu 
刘懿娴	Liu Yixian 
南京工业大学	Nanjing University of Technology 
β衰变	beta decay 
超级星光大道_(第三届)	Super Avenue of Stars_ (3rd) 
锺国斌	Zhong Guobin 
海外华人	Overseas Chinese 
皮埃尔·玛丽·(德·圣-乔治)	Pierre Marie (de Saint-Georges) 
瑞士17岁以下国家足球队	Switzerland under-17 national football team 
ons编码系统	ons coding system 
.mr	.mr 
伊朗总理列表	List of Prime Ministers of Iran 
越南共产党中央军事委员会	Central military committee of the communist party of vietnam 
亨利·洛赫，第一代洛赫男爵	Henry Loch, the first Baron Loch 
洛仑兹奖章	Lorentz Medal 
veho	veho 
比利时君主列表	List of Belgian monarchs 
王汉基	Wang Hanji 
曾宪义	Zeng Xianyi 
武汉宏兴	Wuhan Hongxing 
大南	Onami 
松平齐	Songping Qi 
欧洲歌唱大赛	Eurovision Song Contest 
地中海运动会	Mediterranean Games 
文武王_(新罗)	King Munmu_ (Silla) 
阿联酋总理列表	List of Prime Ministers of the UAE 
缔造者体育场	Creators Stadium 
唱片骑师	Disc jockey 
广东各地级市人口列表	Population list of cities in Guangdong 
正东唱片	Zhengdong Records 
美国各州	U.S. states 
韦廷王朝	Weiting Dynasty 
冈比西斯一世	Cambyses I 
加拿大原住民	Native Canadian 
斯特凡八世	Stefan VIII 
台湾语言音标方案	Taiwanese phonetic transcription scheme 
丹麦首相列表	List of Prime Ministers of Denmark 
北极海鹦	Arctic Puffin 
铁路车辆	Railway vehicle 
波斯尼亚和黑塞哥维那主席团	Bureau of Bosnia and Herzegovina 
前189年	189 years ago 
伊斯兰复兴运动	Islamic Revival Movement 
曼达字母	Manda 
中国人民政治协商会议全国委员会	National Committee of the Chinese People's Political Consultative Conference 
查比迪阿里	Chabidi Ali 
江苏舜天足球俱乐部	Jiangsu Sainty Football Club 
哈萨克斯坦共和国国家银行	National Bank of the Republic of Kazakhstan 
约克郡北瑞丁卷宗掌官	Head of the North Riding Archives, Yorkshire 
罗马礼	Roman ceremony 
北方山水画派	Northern Landscape Painting School 
液晶显示器	LCD Monitor 
广西体育中心	Guangxi Sports Center 
聊斋_(1996年电视剧)	Liao Zhai_ (1996 TV series) 
五户町	Gohecho 
奥兰治县_(纽约州)	Orange County_(New York State) 
张京育	Zhang Jingyu 
日本职业女子足球联赛	Japan Women's Professional Football League 
低地日耳曼语	Low Germanic 
香港c队	Hong Kong Team C 
印度官方语言列表	List of official languages in India 
元大都	Yuan Dadu 
interlisp	interlisp 
关凤珊	Guan Fengshan 
天空体育	Sky Sports 
独立日	independence Day 
巫觋宗教	Witch religion 
摩尔多瓦总统	President of Moldova 
路德维希四世_(黑森大公)	Ludwig IV_ (Grand Duke of Hessen) 
罗云芳	Luo Yunfang 
中央音乐学院	Central Conservatory of Music 
伊斯兰极权主义	Islamic totalitarianism 
怀俄明州单一国会选区	Single congressional district of Wyoming 
维吾尔字母	Uyghur alphabet 
debjit_majumder	debjit_majumder 
塞尔维特足球俱乐部	Servet Football Club 
土耳其共和国中央银行	Central Bank of the Republic of Turkey 
卡罗尔·皮尤特施密特	Carol Pietschmidt 
西班牙行政区划	Administrative divisions of Spain 
罗马尼亚外交部	Romanian Ministry of Foreign Affairs 
dgc唱片	dgc record 
印度人口	Indian population 
file:key-visualarts-logo.png	file:key-visualarts-logo.png 
城市猎人	City hunter 
祈理士	Clifford 
交通大臣	Minister of Transportation 
百慕大百户邑战役	Battle of Bermuda 
阿布哈兹总统	President of Abkhazia 
中华职业棒球大联盟	China Major League Baseball 
助理裁判员	Assistant referee 
中国民间信仰	Chinese folk beliefs 
卡那封_(英国国会选区)	Carnarvon_(British Parliamentary District) 
jtbc金土连续剧	jtbc golden earth series 
前原一辉	Kazuki Maehara 
巴黎综合理工学院	Ecole Polytechnique de Paris 
内务大臣	Minister of the Interior 
中国共产党中央监察委员会	Central Supervisory Committee of the Communist Party of China 
甜姐儿_(电视节目)	Sweet Sister_(TV show) 
新闻主播	News anchor 
电子游戏	Electronic games 
山东省立第二师范学校	Shandong Provincial Second Normal School 
即时战略游戏	Real-time strategy game 
新加坡外交部长	Minister of Foreign Affairs of Singapore 
拉昂的贝特拉达	Betrada 
民主社会主义运动	Democratic socialist movement 
圣何塞_(加利福尼亚州)	San Jose_ (California) 
蜂须贺孝治	Koji Hachiko 
狭义相对论	Special relativity 
中川昭一	Shoichi Nakagawa 
罗伯特·奥弗利·阿什伯顿·克鲁-米尔恩斯，第一代克鲁侯爵	Robert Overly Ashburton Crew-Milnes, the first Marquis of Crew 
李喜明	Li Ximing 
.ps	.ps 
突尼西亚总理	Prime Minister of Tunisia 
陶大宇	Tao Dayu 
星洲之夜	Star Night 
日本民主党	Democratic Party of Japan 
brăila	Braila 
volhard–erdmann环化反应	volhard–erdmann cyclization reaction 
世新大学	Shih Hsin University 
上野城	Ueno Castle 
布特勒贾	Butreca 
俞鸿	Yu Hong 
青年民建联	Youth DAB 
织田秀孝	Oda Hidetaka 
面向对象程序设计	Object-oriented programming 
绝对达令_(台湾电视剧)	Absolute Darling_ (Taiwan TV Series) 
广东名峰足球俱乐部	Guangdong Mingfeng Football Club 
荣县话	Rongxian Dialect 
菲律宾语言委员会	Philippine Language Council 
马肇均	Ma Zhaojun 
德意志统一	German Unity 
鄂霍次克海	Sea of Okhotsk 
维京音乐	Viking Music 
欧陆哲学	European philosophy 
加贺殿	Kagaden 
贝斯吉他	Bass guitar 
阿联酋空军	UAE Air Force 
首席执行官	Chief Executive Officer 
向雪怀	Xiang Xuehuai 
收复失地运动	Regain lost ground 
让·巴蒂斯特·加伊_(马蒂尼亚克子爵)	Jean Baptiste Gaï_ (Viscount Matignac) 
洪金泼	Hong Jinpo 
声良鸡	Shengliang Chicken 
美国战争部长	U.S. Secretary of War 
贸工大臣	Minister of Trade and Industry 
中国抗日战争	Chinese Anti-Japanese War 
鲁中南行政区	Luzhongnan Administrative Region 
申应均	Shen Yingjun 
岩美町	Iwami Town 
翡翠恋曲	Emerald Love Song 
官方语言	official language 
法国16岁以下国家足球队	France under-16 national football team 
世界音乐	World music 
斯洛伐克21岁以下国家足球队	Slovakia Under-21 National Football Team 
河床足球俱乐部	River Plate Football Club 
盖恩斯维尔_(佛罗里达州)	Gainesville_ (Florida) 
上座部佛教	Theravada Buddhism 
英属维尔京群岛总理	Prime Minister of the British Virgin Islands 
kanko球场	kanko stadium 
布拉加体育会b队	Braga Sports Club B Team 
郭海盛	Guo Haisheng 
饶舌核	Rap nucleus 
美国州份	U.S. State 
奥斯曼帝国皇位继承顺序	Ottoman succession order 
英国国旗	British flag 
郑升和	Zheng Shenghe 
陈琪_(消歧义)	Chen Qi_ (disambiguation) 
红星大奖2010	Red Star Awards 2010 
世界粮食奖	World Food Award 
光速大冒险pipopa	Lightspeed Adventure pipopa 
高卢-伊比利亚语	Gaul-Iberian 
东北大学	Northeastern University 
川澄奈穗美	Nahomi Kawasumi 
格勒诺布尔足球俱乐部	Grenoble Football Club 
张同祖	Zhang Tongzu 
华学佳	Hua Xuejia 
乌克兰19岁以下国家足球队	Ukraine Under-19 National Football Team 
中国共产党第十五届中央委员会	The 15th Central Committee of the Communist Party of China 
冰岛足球甲级联赛	Iceland Football League 
越南政治	Vietnam politics 
祖先崇拜	Ancestor worship 
xd-bit	xd-bit 
柳京守战车厂	Liujing Shou Chariot Factory 
eaj-pnv	eaj-pnv 
纳沙泰尔足球俱乐部	Neuchatel Football Club 
.kw	.kw 
阿尔巴塞特足球俱乐部	Albacete Football Club 
中华民国陆军军官学校	Army Officer School of the Republic of China 
梁廷轩	Liang Tingxuan 
张盛和	Zhang Shenghe 
鸭宫车站	Kamiya Station 
斐济总统	President of Fiji 
土耳其总统列表	List of Presidents of Turkey 
原始解释	Original explanation 
劳工运动北欧合作委员会	Nordic cooperation committee of labor movement 
拿坡里足球俱乐部	Naples Football Club 
弗朗索瓦-泽维耶·奥托利	Francois-Zevier Ottoli 
千叶市原	Chiba Ichihara 
泛民会议	Pan People Conference 
莱比锡大学	University of Leipzig 
超级制作人剧集列表	List of super producer episodes 
英基巴库	Inki Baku 
希伯尼安足球俱乐部	Hibernian Football Club 
烟台莱山机场	Yantai Laishan Airport 
埼玉西武狮	Saitama Seibu Lions 
法夫公爵	Duke of Fife 
约克郡-亨伯	Yorkshire-Humber 
海州区_(连云港市)	Haizhou District_(Lianyungang City) 
宇文护	Yuwenhu 
仁藤萌乃	Moeno Nito 
八一足球俱乐部	Bayi Football Club 
大都会艺术博物馆	Metropolitan Museum of Art 
布列塔尼统治者列表	List of rulers of Brittany 
离子风暴	Ion storm 
香槟沙隆	Champagne Chalon 
天与地_(无线电视剧)	Heaven and Earth_ (Wireless TV series) 
多斯特·穆罕默德汗	Dost Muhammad Khan 
加尔各答市政法团	Calcutta Municipal Corporation 
多可町	Tokocho 
北美东部时区	North America Eastern Time Zone 
东卡罗莱那大学	East carolina university 
大连湾足球俱乐部	Dalian Bay Football Club 
中山市人民代表大会常务委员会	Standing Committee of Zhongshan People's Congress 
秀岛敏行	Toshiyuki Hideshima 
福气又安康	Blessed and well-being 
爵士鼓	Jazz drum 
前4世纪	4th century BC 
渡部高志	Takashi Watanabe 
比利时首相列表	List of Prime Ministers of Belgium 
市议会	City Council 
近藤元次	Motoji Kondo 
卢塞恩足球俱乐部	Lucerne Football Club 
郑嘉民	Zheng Jiamin 
贝尔212	Bell 212 
星光少女_极光之梦	Star Girl_Aurora Dream 
爱·回家_(第二辑)	Love Home_(Second Series) 
阿尔加维球场	Algarve Stadium 
泰国总理列表	List of Prime Ministers of Thailand 
羽生英之	Hideyuki Hanyu 
音节文字	Syllable text 
黄大仙天主教小学	Wong Tai Sin Catholic Primary School 
杭长客运专线	Hangzhou-Changzhou Passenger Dedicated Line 
海峡群岛	Channel Islands 
洛阳龙门站	Luoyang Longmen Station 
新十津川町	Shintotsukawa Town 
董事会主席	Chairman of the Board 
步兵第20联队	Infantry 20th Wing 
世界银行行长	President of the World Bank 
aearu	Meet 
五十铃	Isuzu 
曼德马尔斯球场	Mandemars Stadium 
施明德	Shi Mingde 
新庄机厂	Xinzhuang Machinery Factory 
广州锐克	Guangzhou Rui Ke 
自由-保守党	Liberal-Conservative Party 
西德尼·巴克斯顿，第一代巴克斯顿伯爵	Sidney Buxton, the first Earl of Buxton 
杨成武	Yang Chengwu 
天梯	Ladder 
王晨_(政治人物)	Wang Chen_(Politician) 
音乐孩子王	King of Music Kids 
日高壮之丞	Hidaka Sonojo 
渡边喜美	Watanabe Kimi 
中少动漫	Middle school animation 
韦尔索内	Versone 
团结公民委员会	Solidarity Citizens Committee 
东国大学	Dongguk University 
共享原始码	Shared source code 
东映エージェンシー	Toei Agency 
头与头发	Head and hair 
欧洲中央银行行长	President of the European Central Bank 
字母系统	Alphabet 
芬戈郡	Fingal County 
无机化学	inorganic chemistry 
街头庞克	Street punk 
室町时代	Muromachi period 
奥运六星	Olympic six stars 
窄体飞机	Narrow body aircraft 
.us	.us 
非洲联盟主席	President of the African Union 
宪慈宣圣皇后	Xianci Xuansheng Queen 
白玫瑰大学联盟	White Rose University Alliance 
杜鹃花属	Rhododendron 
宾索万	Bin Sovan 
阿部拓马	Takuma Abe 
区加乐	Ou Jiale 
天主教圣但尼教区	Catholic Diocese of Saint Denis 
刘伟强_(马来西亚)	Liu Weiqiang_(Malaysia) 
乡村摇滚	Country rock 
莱什琴斯基王室	Leszczynski Royal Family 
泊濑部皇女	Princess Hatsusebe 
国家革新联盟	National Innovation Alliance 
民主即自由-菊花党	Democracy is Freedom-Daisy Party 
与谢野晶子	Yosano Akiko 
京畿大学	Gyeonggi University 
荷兰摇滚	Dutch Rock 
小城故事	Small town story 
比杜尔巴	Vidulba 
中部国际机场	Central Japan International Airport 
斯里兰卡佛教	Sri Lankan Buddhism 
山东各地级市地区生产总值列表	List of regional GDP of each city in Shandong 
井脚里	In the foot of the well 
中国联通	China Unicom 
鲛岛彩	Kojima Aya 
文伟鸿	Wen Weihong 
威特尼_(英国国会选区)	Witney_(British Parliamentary District) 
托勒密王朝	Ptolemy 
江户时代	Edo period 
私立复旦大学	Private Fudan University 
天主教格罗宁根-吕伐登教区	Catholic Diocese of Groningen-Leeuwarden 
那波帕拉萨尔	Parasar 
葡萄牙人竞技俱乐部	Portuguese Athletic Club 
构成国	Constituent country 
第一代克拉伦斯公爵乔治·金雀花	George Gorse, Duke of Clarence 
大田体彩女子足球俱乐部	Datian Sports Lottery Women's Football Club 
欧洲怀疑主义	Euroscepticism 
中南大学	Central South University 
斯图亚特王朝	Stuart Dynasty 
阿雅皇女	Queen Aya 
森岛康仁	Yasuhito Morishima 
氛围音乐	Ambient music 
美国海军作战部长	Secretary of Naval Operations 
静海军节度使	Static navy 
法国国家信息与自动化研究所	French National Institute of Information and Automation 
世界遗产	World Heritage 
谭剑伟	Tan Jianwei 
英伦摇滚	British Rock 
格拉茨ak足球俱乐部	Graz ak Football Club 
欧洲白蜡	European white wax 
亨利·佩勒姆-柯林顿，第四代雷姆河畔纽卡斯尔公爵	Henry Pelham-Clinton, 4th Duke of Newcastle upon Reme 
偏锋杂志	Pioneer Magazine 
丕平四世	Piping IV 
马尔代夫副总统	Vice President of Maldives 
金左根	Jin Zuogen 
康斯坦丁·勒杜列斯库博士球场	Dr. Constantine Ledulescu Stadium 
上海申花足球学校	Shanghai Shenhua Football School 
联美	United States 
美国中央大学	Central University 
hal研究所	hal institute 
托勒密十三世	Ptolemy XIII 
张闾玗	Zhang Luyi 
韩先楚	Han Xianchu 
亲欧洲主义	Pro-Europeanism 
英格兰联赛杯	English League Cup 
土耳其总理列表	List of Prime Ministers of Turkey 
德川英子	Tokugawa Eiko 
石器时代女王	Queen of the Stone Age 
昌江黎族自治县	Changjiang Li Autonomous County 
山口将司	Shoji Yamaguchi 
中文维基百科	Chinese Wikipedia 
青木翔大	Aoki Shoda 
麦克拉伦汽车公司	McLaren Motor Company 
张国强_(香港演员)	Zhang Guoqiang_ (Hong Kong actor) 
美国行政区划	U.S. administrative divisions 
切塞纳足球俱乐部	Cesena Football Club 
北荷兰省女王专员列表	List of Queen's Commissioners of North Holland Province 
科学奇幻	Science fantasy 
南通支云足球俱乐部	Nantong Zhiyun Football Club 
红河哈尼族彝族自治州	Honghe Hani and Yi Autonomous Prefecture 
karşıyaka_s.k.	facia_s.k. 
美国邮政编码	U.S. Postal Code 
中共中央政法委员会	Political and Law Committee of the CPC Central Committee 
鹿特丹伊拉斯姆斯大学	Erasmus University Rotterdam 
伏伊伏丁那	Vojvodina 
孟菲斯大学	University of Memphis 
nba总决赛最有价值球员	nba finals most valuable player 
意难忘_(2004年电视剧)	Unforgettable_(2004 TV series) 
麦克唐纳-道格拉斯公司	Macdonald-Douglas 
实验音乐	Experimental music 
捷克社会民主党	Czech Social Democratic Party 
掌上游戏机	hand-held gaming device 
秦基伟	Qin Jiwei 
穆罕默德-礼萨·希克马特	Muhammad-Reza Hikmat 
急症群英	Acute illness 
田秋堇	Tian Qiujin 
中华人民共和国元帅	Marshal of the People's Republic of China 
电子舞曲	Electronic dance music 
高木雄也	Yuya Takaki 
中影集团	China Film Group 
保加利亚总理列表	List of Prime Ministers of Bulgaria 
社会自由主义	Social liberalism 
巴托里家族	Batori family 
吴冠宇	Wu Guanyu 
合田雅吏	Masashi Goda 
春日山田皇女	Princess Kasuga Yamada 
伊拉克代表委员会	Iraqi Representative Committee 
北海道第9区	Hokkaido 9th district 
马芜铜城市群	Mawu Copper City Group 
争取欧洲自由人士和民主人士联盟党	League for Freedoms and Democrats in Europe 
吉野恭平	Kyohei Yoshino 
电影行销	Movie marketing 
瑞典自治市	Swedish municipalities 
浸礼宗	Baptist 
贞明皇后	Queen Zhenming 
结构主义	Structuralism 
泰卢固语	Telugu 
塔什干棉农足球俱乐部	Tashkent Cotton Farmers Football Club 
奥斯纳贝克体育会	Osnabek Sports Club 
伦敦大学	University of London 
陆军足球会	Army Football Club 
青年漫画	Youth Comics 
维尔茨堡大学	University of Wurzburg 
李薛基	Li Xueji 
大东会议	Dadong Conference 
庶妃那拉氏	Concubine Nara 
台湾综合大学系统	Taiwan University System 
英国海军部	British Admiralty 
儒略-克劳狄王朝	Julian-Claudian Dynasty 
尾野実信	Minobu Ono 
中世纪哲学	Medieval philosophy 
非营利组织	Non-profit organizations 
大温哥华区域局	Greater Vancouver Regional Bureau 
正田修	Osamu Shoda 
正田富美子	Fumiko Shoda 
押谷祐树	Hitoshi Oshitani 
德累斯顿足球俱乐部	Dresden Football Club 
印度军方荣誉奖	Indian Military Honor Award 
共同民主党	Common Democratic Party 
北平特别市	Peking Special City 
济南话	Jinan dialect 
澳门回归	Return of Macau 
哥伦比亚号帆船_(1792年)	Sailing Ship Columbia_ (1792) 
内田昂辅	Kosuke Uchida 
南冈山站	Nangangshan Station 
马自达929	Mazda 929 
芝加哥烈焰	Chicago Flames 
阮文决	Nguyen Van Juet 
平板手机	Tablet phone 
庄献世子	Zhuang Xianshizi 
香港一千元纸币	Hong Kong One Thousand Dollar Notes 
傅诗涌	Fu Shiyong 
瑞安球场	Ryan Stadium 
朱建荣	Zhu Jianrong 
乔治·桑塔亚那	George Santayana 
亨利·佩蒂-菲茨莫里斯，第五代兰斯多恩侯爵	Henry Petty-Fitzmorris, the fifth Marquis of Lansdowne 
西班牙18岁以下国家足球队	Spain Under-18 National Football Team 
甘拉雅妮塔娜公主	Princess Ganrayana 
北德内语支	North German Inner Language Branch 
a&r	a&r 
达罗毗荼人	Dravidians 
金球奖最佳戏剧类电影女主角	Golden Globe Award for Best Actress in a Drama Series 
杨国强_(台湾军事人物)	Yang Guoqiang_ (Taiwan military figure) 
圣彼得堡国立大学	Saint Petersburg State University 
侠盗猎魔2	Grand Theft Auto 2 
古巴革命	Cuban Revolution 
联合作战司令部	Joint Operations Command 
伍立光	Wu Liguang 
医生冠军	Doctor Champion 
刘计超	Liu Jichao 
科克市长	Mayor of Cork 
达美航空	Delta Airlines 
角川书店	Kadokawa Bookstore 
意大利王国	Kingdom of Italy 
汉莎罗斯托克足球俱乐部	Lufthansa Rostock Football Club 
圣剑传说系列	Holy Sword Legend Series 
教宗额我略十六世	Pope Gregory XVI 
爱在暴风的日子	Love on a stormy day 
全北现代	Jeonbuk Hyundai 
全国民主联盟	National League for Democracy 
阿姆斯特丹市长	Mayor of Amsterdam 
广州恒大足球俱乐部	Guangzhou Hengda Football Club 
巴伦西亚语言学院	Valencian Language Institute 
太平洋战争	Pacific War 
灼眼的夏娜角色列表	Shakugan's Shana Character List 
台北捷运公司	Taipei MRT Corporation 
等一个人咖啡	Waiting for someone for coffee 
维克弗斯特大学	Wake Forest University 
尾张旭市	Owari Asahi City 
军需大臣	Minister of quarters 
何世杰	He Shijie 
城市乡村乐	City Country Music 
打击乐器	percussion 
中华民国宪法增修条文	Amendments to the Constitution of the Republic of China 
哈密尔顿_(安大略省)	Hamilton_(Ontario) 
神圣罗马帝国皇帝列表	List of Emperors of the Holy Roman Empire 
伊朗立宪党	Iranian Constitutional Party 
义安理工学院	Ngee Ann Polytechnic 
马其顿内部革命组织－马其顿民族统一民主党	Macedonian internal revolutionary organization-Macedonian National Unity Democratic Party 
第二次世界大战	Second World War 
比达奥	Bidao 
山地马里语	Mountain Mali 
秋元阳太	Shota Akimoto 
瓦兹河谷省	Oise Valley 
雷恩县_(俄勒冈州)	Lane County_ (Oregon) 
维尔福软件公司	Villefort Software 
突厥语族	Turkic 
曼城音乐	Manchester City Music 
爆丸机械波涛	Bakugan Machinery Wave 
电脑键盘	keyboard 
潮州怒汉	Chaozhou Angry Man 
山口那津男	Natsuo Yamaguchi 
芝加哥号重巡洋舰_(ca-14)	USS Chicago_(ca-14) 
下洛林的查理	Charlie of Lower Lorraine 
软件工程师	software engineer 
国家游泳中心	National Aquatics Center 
惠灵顿大区	Wellington Region 
神圣罗马帝国	Holy Roman Empire 
墨西哥毒品战争	Mexican Drug War 
奔宁山脉	Pennine Mountains 
都筑区	Tsuzuki District 
大汉天子	Dahan emperor 
多镜头模式	Multi-camera mode 
太空辅助学院	Space Aid Academy 
硬派音乐	Hardcore music 
罗马皇帝	Roman emperor 
奥韦斯霍尔姆体育俱乐部	Ovesholm Sports Club 
吸血鬼猎人巴菲_(第二季)	Buffy the Vampire Slayer_ (Season 2) 
夜明前的琉璃色	The color of glaze before night 
香蕉蛞蝓	Banana slug 
以色列银行	Bank of Israel 
箱馆战争	Hakodate War 
动态类型	Dynamic typing 
人中之龙0_誓言的场所	Dragon among people 0_the place of vows 
人类性别比例	Human sex ratio 
区议会（第二）功能界别	District Council (second) functional constituency 
保治靴拿	Protective boots 
市长议会制	Mayor Council 
北美中部时间	North America Central Time 
郡山车站_(福岛县)	Koriyama Station_(Fukushima Prefecture) 
林茨体育会	Linz Sports Association 
可伦坡市政局	Colombo City Council 
路易西安纳州	Louisiana 
狄亚曼提娜郡政府	Diamantina County Government 
埃米利亚-罗马涅语	Emilia-Romagna 
电子音乐	electronic music 
洛林-布拉班特王朝	Lorraine-Brabant Dynasty 
马克西米利安一世_(巴伐利亚国王)	Maximilian I_ (King of Bavaria) 
多谢款待	thanks for treatment 
当代r&b	Contemporary r&b 
野崎阳介	Ryosuke Nozaki 
法国宇航sa_330美洲狮直升机	French Aerospace sa_330 Cougar helicopter 
至上人生	Supreme life 
.no	.no 
市原健一	Kenichi Ichihara 
起辇谷	Valley 
不良笑花	Bad smile 
锺恺晴	Zhong Kaiqing 
马德里康普顿斯大学	Complutense University of Madrid 
命运之爱	Destiny love 
克莱县_(密苏里州)	Clay County_(Missouri) 
马来西亚国会反对党领袖	Leader of the Opposition in the Malaysian Parliament 
狄俄倪索斯	Dionysus 
罗伯特·史蒂文生·霍恩，第一代霍恩子爵	Robert Stevenson Horn, the first Viscount Horn 
瑞典信义会	Swedish Lutheran Church 
达卡大学	University of Dhaka 
木尔威郡政府	Mulway County Government 
九阴真经	Nine Yin Scriptures 
东京防御总督部	Ministry of Defense of Tokyo 
威尔士亲王	Prince of Wales 
苏丹阿拉伯语	Sudanese Arabic 
桃花小妹	Peach blossom sister 
易鹏飞	Yi Pengfei 
苏格兰长老会	Scottish Presbyterian Church 
旧金山湾区	San Francisco Bay Area 
中国人民政治协商会议	Chinese People's Political Consultative Conference 
天津国际邮轮母港	Tianjin International Cruise Home Port 
载货汽车	truck 
北条守时	Hojo punctuality 
民主党_(大韩民国1995年)	Democratic Party_ (Republic of Korea 1995) 
jp:藤原教通	jp: Fujiwara Kōdō 
美国人文科学基金会	American Liberal Arts Foundation 
箱根花	Hakone Flower 
凤凰卫视中文台	Phoenix TV Chinese Channel 
文化研究	culture Research 
君士坦丁四世	Constantine IV 
高路甸	Gaoludian 
中华人民共和国国家新闻出版广电总局	State Administration of Press, Publication, Radio, Film and Television of the People's Republic of China 
恩尼加法索	Eniga Faso 
胡家斌	Hu Jiabin 
尼泊尔卢比	Nepalese Rupee 
柏林国际电影节	Berlin International Film Festival 
小林哲也	Tetsuya Kobayashi 
波恩大学	University of Bonn 
高棉国家军队	Khmer National Army 
极右政党	Extreme right party 
巽他-苏拉威西语群	Sundanese-Sulawesi Group 
法国社会党	French Socialist Party 
里奥艾维	Rio Ivey 
维旺迪娱乐	Vivendi Entertainment 
特瓦里	Tevari 
漫画改编的电视剧列表	List of TV series adapted from comics 
玩偶国孩子乐团	Doll Country Children's Orchestra 
新加坡副总理	Deputy Prime Minister of Singapore 
美津浓	Mizuno 
广东各地级市地区生产总值列表	List of regional GDP of each city in Guangdong 
中国、四国地方	China, Shikoku 
黯然销魂掌	Depressed Palm 
刘震理	Liu Zhenli 
山下芳生	Yoshio Yamashita 
美国教育部长	U.S. Secretary of Education 
地下丝绒	Velvet Underground 
上海联城足球俱乐部	Shanghai Liancheng Football Club 
琅琊榆	Langya elm 
中苏友谊万岁勋章	Long Live China-Soviet Friendship Medal 
旭区_(横滨市)	Asahi Ward_(Yokohama City) 
斐济君主	Monarch of Fiji 
挪威君主列表	List of Norwegian monarchs 
北泰恩河畔纽卡斯尔_(英国议会选区)	Newcastle upon Tyne North_(British Parliamentary District) 
香港理工大学	Hong Kong Polytechnic University 
萨米特镇区_(堪萨斯州马里昂县)	Summit Township_ (Marion County, Kansas) 
刺客信条：叛变	Assassin's Creed: Mutiny 
大学学院中学	University school junior high school 
徐乐思	Xu Lesi 
罗素大学集团	Russell University Group 
首席法官	Chief judge 
nba东南赛区	NBA Southeast Division 
俄罗斯卢布	Russian ruble 
速水直道	Hayami straight 
法国外交部	French Ministry of Foreign Affairs 
维琴察足球俱乐部	Vicenza Football Club 
我们的乌克兰	Our Ukraine 
英格兰足球南部联赛超联组	English Football Southern League Super League 
山内智裕	Tomohiro Yamauchi 
中国共产党章程	Constitution of the Communist Party of China 
古埃及第十七王朝	Seventeenth Dynasty of Ancient Egypt 
恐怖谷_(福尔摩斯)	Uncanny Valley_ (Holmes) 
游戏主机	Game host 
stklos	stklos 
透纳广播公司	Turner Broadcasting Company 
非洲国家杯	Africa Cup of Nations 
一美和成	Yimeihecheng 
接近传感器	Proximity sensor 
寿康太妃	Toffee Shou Kang 
安条克一世	Antioch I 
西部蓝调	Western blues 
香港贸易发展局	Hong Kong Trade Development Council 
关西电视台	Kansai TV 
郭伟星	Guo Weixing 
社会主义者和民主人士进步联盟	Progressive Alliance of Socialists and Democrats 
新世纪论坛	New Century Forum 
巴贝什·博尧依大学	Babes Boyai University 
尹俊（国军将领）	Yin Jun (General of the National Army) 
香港足球会球场	Hong Kong Football Club Stadium 
雪铁龙zx	Citroen zx 
马克斯·普朗克量子光学研究所	Max Planck Institute for Quantum Optics 
弗吉尼亚大学	University of Virginia 
美丽胡枝子	Beautiful Lespedeza 
卡尔斯鲁厄体育俱乐部	Karlsruhe Sports Club 
独立监察警方处理投诉委员会	Independent Police Complaint Handling Committee 
经院哲学	Scholastic philosophy 
肯塔基州州长列表	List of Governors of Kentucky 
施纯仁	Shi Chunren 
卢梅扎内足球俱乐部	Lumezzane Football Club 
古叙利亚字母	Ancient Syriac alphabet 
山本保	Yamamoto 
哥廷根大学	University of Göttingen 
云南各市州地区生产总值列表	List of GDP of each city, prefecture and region in Yunnan 
新加坡华人	Singapore Chinese 
汉诺威王国	Kingdom of Hanover 
曾庆珏	Zeng Qingjue 
当奴华加斯	Donovagas 
哈尔滨西站	Harbin West Railway Station 
京师大学堂分科大学旧址	The former site of Jingshi University Hall Branch University 
怀俄明大学	University of Wyoming 
林和西站	Linhexi Station 
unlingen	unling 
京西联络线	Beijing West Link 
蓬塔德尔加达	Ponta Delgada 
爱达荷州州长	Governor of Idaho 
驹井善成	Komai Zensari 
法国议会	French Parliament 
藏传佛教	Tibetan Buddhism 
张志成	Zhang Zhicheng 
澳门特别行政区终审法院	Macau Special Administrative Region Court of Final Appeal 
黑色幽默	dark humor 
西米德兰兹郡	West Midlands 
玛丽-路易丝·弗兰丝	Marie-Louise France 
朴海美	Park Hae Mi 
un/locode	a / locode 
纽约州参议院多数党领袖	New York State Senate Majority Leader 
时完	End of time 
石渡康浩	Yasuhiro Ishiwatari 
于默奥大学	University of Umeå 
爱情两好三坏	Love is two good and three bad 
独立人士	Independent 
太平洋沿岸阿萨巴斯卡语支	Pacific Coast Athabasca 
南港机厂	Nangang Machinery Factory 
共产党和工人党国际会议	International Conference of Communist and Workers' Parties 
template:元朝皇后	template: Queen of Yuan Dynasty 
金丸佳史	Yoshifumi Kanamaru 
藤原诠子	Fujiwara Tsutsuko 
松平广忠	Matsudaira Hirotada 
巴赛克县	Basec County 
帖撒罗妮加	Thessaloniki 
中国人民解放军上将	General of the Chinese People's Liberation Army 
千早赤阪村	Chihayaakasaka Village 
高架电缆	Overhead cable 
冈田麿里	Okada Kori 
哈萨克苏维埃社会主义共和国国歌	National Anthem of the Kazakh Soviet Socialist Republic 
梅克伦堡-施特雷利茨大公国	Grand Duchy of Mecklenburg-Strelitz 
富士电视台周二晚间九点连续剧	Fuji TV series on Tuesday night at 9 o'clock 
新横滨站	Shin-Yokohama Station 
何塞.米格尔.阿罗约	Jose Miguel Arroyo 
共和世代	Republican generation 
法国联赛杯	French League Cup 
郭家禧	Guo Jiaxi 
格伦代尔_(加利福尼亚州)	Glendale_ (California) 
德国电信	Germany Telecom 
小中肇	Hajime Konaka 
挪威克朗	Norwegian Krone 
巴贝拉球场	Barbera Stadium 
塔克和符咒的神力	The power of Tucker and the spell 
米古历	Miguli 
勒·茅斯托瓦球场	Le Moustois Stadium 
苏格兰启蒙运动	Scottish Enlightenment 
托马斯·马德森-米格达尔	Thomas Madsen-Migdal 
皮奥里亚_(伊利诺伊州)	Peoria_ (Illinois) 
孝哀悊皇后	Queen of Filial Piety 
元朝君主列表	List of Yuan Dynasty Monarchs 
自由及开放源代码软件	Free and open source software 
创作型歌手	Singer-songwriter 
瓦氏效应	Waldorf Effect 
细川悦子	Etsuko Hogawa 
开轮式赛车	Open-wheel racing 
古巴国务委员会主席	President of the Cuban Council of State 
韦尔芒杜瓦的比阿特丽斯	Beatrice of Vermanduis 
胡伟林	Hu Weilin 
全真剑法	True Swordsmanship 
斯里兰卡自由党	Sri Lanka Liberal Party 
荷兰皇家海军	Royal Dutch Navy 
斯波特兰球场	Portland Stadium 
欧洲东部时间	EET 
伊拉克第纳尔	Iraqi Dinar 
中国商用飞机	Commercial Aircraft of China 
马拉维总统	President of Malawi 
坂本刚二	Goji Sakamoto 
德国摇滚	German rock 
耶稣会学院和大学联合会	Federation of Jesuit Colleges and Universities 
沙皇专制制度	Tsarist autocracy 
石原立也	Ishihara Tatsuya 
龟川_谅史	Kamekawa_Ryoushi 
香港男子木球队	Hong Kong Men's Wooden Team 
舛成孝二	Kosei Koji 
海上保安厅	Coast Guard 
花舞少女	Flower Dance Girl 
最后誓言	Final vow 
t.m.史蒂文斯	t.m. Stevens 
苹果软件更新	Apple software update 
曾之乔	Zeng Zhiqiao 
华视综合娱乐台	Huashi Integrated Entertainment Channel 
中华民国中央行政机关	Central Administration of the Republic of China 
路德维希·恩斯特·安德烈阿斯_(黑森-达姆施塔特)	Ludwig Ernst Andreas (Hesse-Darmstadt) 
提亚公主	Princess Tia 
1848年革命	Revolution of 1848 
康宁大学台北校区	Corning University Taipei Campus 
多核心处理器	Multi-core processor 
福田健介	Fukuda Kensuke 
爱尔兰行政区划	Administrative divisions of Ireland 
可携式媒体播放器	Portable media player 
苏联英雄	Hero of the Soviet Union 
杨知元	Yang Zhiyuan 
伊尔库茨克机场	Irkutsk Airport 
马克斯·普朗克奖章	Max Planck Medal 
亚代尔县_(肯塔基州)	Adair County_(Kentucky) 
主权国家	Sovereign state 
还珠格格_(2011年电视剧)	Huan Zhu Ge Ge_ (2011 TV series) 
尖端出版	Cutting-edge publishing 
福阿德一世	Fuad I 
西科斯基飞机公司	Sikorsky Aircraft Company 
怡和体育会	Jardine Sports Club 
阿尔巴尼亚国家元首列表	List of heads of state of Albania 
高山成孝	Takayama Chengxiao 
ufmg	ufmg 
oplenac	oplenac 
美利坚联盟国陆军	Confederate States Army 
坦佩雷	Tampere 
cbs唱片	cbs record 
赵树海	Zhao Shuhai 
缸中之脑	Brain in the Tank 
第二回合我爱你	Second round i love you 
比利·布蓝拿	Billy Brunner 
国共内战	Civil war 
么教	What education 
伍子龙	Wu Zilong 
帕森设计学院	Parsons School of Design 
凯霍斯鲁三世	Kehoslu III 
亚当·韦斯特_(居家男人)	Adam West_ (House Man) 
大西洋沿岸联盟	Atlantic Coast Alliance 
北京大学办公楼	Peking University Office Building 
通用移动通讯系统	Universal Mobile Communication System 
三川町	Mikawa Town 
上海铁路局	Shanghai Railway Administration 
大洋洲语言	Oceanian languages 
松浦雅也	Masaya Matsuura 
长荣警备保全	Evergreen Security 
大韩民国国防部	Ministry of National Defense of the Republic of Korea 
猴岛小英雄系列	Monkey Island Little Hero Series 
三平和司	Sanpei and Division 
社会理论	Social theory 
库基-钦-那加语言	Kuki-chin-Naga language 
台北市立景美女子高级中学	Taipei City Jingmei Girls High School 
以色列行政区划	Administrative divisions of Israel 
金庸笔下武功列表	Jin Yong's list of martial arts 
东京国际机场	Tokyo International Airport 
东南英格兰	South east england 
南方共同市场	Southern Common Market 
迦太基共和国	Carthage Republic 
居家男人角色列表	Family man role list 
丁吉利·班达·维杰通加	Dingili Banda Vijaytonga 
室田瑞希	Mizuki Murota 
科幻狗	Sci-Fi Dog 
我是熊	I am a bear 
手冢卓志	Tatsushi Tezuka 
澳门立法会	Macau Legislative Council 
张云川	Zhang Yunchuan 
鹤见区_(横滨市)	Tsurumi Ward_(Yokohama City) 
格洛斯特公爵	Duke of Gloucester 
吉芬唱片	Giffen Records 
翁贝托一世	Umberto I 
多重乐器演奏家	Multi-instrumentalist 
利比亚政府首脑列表	List of heads of government of Libya 
张苏洲	Zhang Suzhou 
马拉维君主	Monarch of Malawi 
秘鲁恩卡杯	Peru Enca Cup 
铁马少年	Iron Horse Boy 
arterivo和歌山	arterivo wakayama 
都营地下铁	Toei Subway 
奥尔良王朝	Orleans Dynasty 
丹麦19岁以下国家足球队	Denmark Under-19 National Football Team 
西南英格兰_(欧洲议会选区)	South West England_(European Parliament constituency) 
懿淑公主	Princess Yishu 
简美施	Jane Mesch 
现实主义文学	Realistic literature 
佐里巴竞技俱乐部	Zoliba Athletic Club 
锦织一清	Nishikori Issei 
立陶宛总理	Prime Minister of Lithuania 
大国丰臣	Toyotomi 
格奥尔格二世_(萨克森-迈宁根)	Georg II_ (Saxony-Meiningen) 
月刊少女野崎同学	Monthly Girls' Nozaki School 
中国人民大学	Renmin University of China 
法国国家u17国家足球队	French national u17 national football team 
广府方言	Cantonese dialect 
蓝令翎	Lan Lingling 
西岛隆弘	Takahiro Nishijima 
美国参议院农业、营养、及林业委员会	U.S. Senate Agriculture, Nutrition, and Forestry Committee 
路德维希三世_(黑森大公)	Ludwig III_ (Grand Duke of Hessen) 
谏义里佩西克足球俱乐部	Ishigiri Pesik Football Club 
共和国民主人士联盟	Union of Democrats of the Republic 
可米国际影视事业股份有限公司	Comi International Film & Television Co., Ltd. 
富兰克林奖章	Franklin Medal 
类型系统	Type system 
议会共和制	Parliamentary republic 
玻色–爱因斯坦凝聚	Bose-Einstein Condensation 
乾隆帝皇五女	The Five Daughters of Emperor Qianlong 
前庞克	Pre-punk 
詹姆斯·“索耶”·福特	James "Sawyer" Ford 
美国宪法	the U.S. constitution 
星岛体育会	Sing Tao Sports Club 
潘伟源	Pan Weiyuan 
坎特伯雷大主教	Archbishop of Canterbury 
卢布尔雅那	Ljubljana 
加藤守启	Kato Moriki 
莱克县_(俄勒冈州)	Lake County_ (Oregon) 
大众集团	Volkswagen Group 
加布里埃尔王子_(比利时)	Prince Gabriel_(Belgium) 
梁凯纶	Liang Kailun 
亚洲足协杯	Asian Football Association Cup 
朱利叶斯贝格尔足球俱乐部	Julius Berger Football Club 
徐增寿	Xu Zengshou 
秘鲁中央储备银行	Central Reserve Bank of Peru 
武田博行	Hiroyuki Takeda 
工作及退休金大臣	Minister of Work and Pensions 
希腊陆军	Greek Army 
党和国家领导人	Party and state leaders 
电子蓝调	Electronic blues 
ニトロプラス	Nitroplus 
青木和彦	Kazuhiko Aoki 
美国陆军参谋长	Chief of Staff of the U.S. Army 
大韩民国第2军	2nd Army of the Republic of Korea 
派桑杜体育俱乐部	Passando Sports Club 
.cu	.with 
皮埃尔·瓦尔德克-卢梭	Pierre Waldeck-Rousseau 
阿曼委员会	Oman Committee 
动作冒险游戏	Action adventure game 
女人的色彩	Woman's color 
雅赫摩斯-荷努特塔梅胡	Yakhmos-Hnuttamehu 
奥伦治-拿索王朝	Orange-Nassau Dynasty 
费拉里斯球场	Ferraris Stadium 
天香百合	Tianxiang Lily 
第一次国共内战	The first civil war between the Kuomintang and the Communist Party 
张云正	Zhang Yunzheng 
丸森町	Marumori Town 
捷克布杰约维采足球俱乐部	Ceske Budejovice Football Club 
米兰2	Milan 2 
旧金山巨人	San Francisco Giants 
国际盟友足球会	International Allies Football Club 
wii频道	wii channel 
本尤德科体育场	Benyudko Stadium 
gsm增强数据率演进	gsm enhanced data rate evolution 
自由民主党副总裁	Vice President of the Liberal Democratic Party 
樱井弘明	Sakurai Hiroaki 
南斯拉夫内战	Civil War in Yugoslavia 
拉沙朴波域	Lassabo 
符腾堡统治者列表	List of rulers of Württemberg 
检察官公主	Prosecutor Princess 
艺术许可协议	Art License Agreement 
卡尤加县_(纽约州)	Cayuga County_(New York State) 
日本游戏大奖	Japan Game Awards 
阿尔韦卡足球俱乐部	Alveca Football Club 
南亚语系	South Asian Languages 
行政院大陆委员会	Continental Committee of the Executive Yuan 
大庄里	Dazhuangli 
胡贝图斯_(萨克森-科堡-哥达)	Hubertus_(Saxony-Coburg-Gotha) 
笠缝皇女	Princess Kasanui 
川村敏江	Toshie Kawamura 
越南君主列表	List of Vietnamese monarchs 
施瓦茨堡统治者列表	List of rulers of Schwarzburg 
组织学	Histology 
联合国难民署事务高级专员	United Nations High Commissioner for Refugees 
国立台湾体育运动大学	National Taiwan Sports University 
日本古伦美亚	Kurumia 
卢美云	Lu Meiyun 
英国贵族	British nobility 
尚丰王	Shang Feng Wang 
量子引力	Quantum gravity 
标致306	Peugeot 306 
根特大学	Ghent University 
宁嫔金氏	Ning Bi Jin 
自由民主党总裁	President of the Liberal Democratic Party 
先军政治	Songun Politics 
花千骨	Hua Qiangu 
吴家乐	Wu Jiale 
澳大利亚元	Australian Dollar 
中国共产党第十三届中央委员会	The 13th Central Committee of the Communist Party of China 
克莱门森大学	Clemson University 
拿斯·尼路臣	Nass Niluchen 
辽南京	Liaoning 
战术射击游戏	Tactical shooting game 
江津中学	Ezu Junior High School 
印度行政区划	Administrative divisions of India 
岐阜羽岛车站	Gifu Hashima Station 
韩进集团	Hanjin Group 
关东地方	Kanto area 
胡镇埔	Hu Zhenpu 
埃曼努尔_(比利时王子)	Emmanuel (Prince of Belgium) 
卡塔尔航空	Qatar Airways 
普鲁士国家代理官	State Agent of Prussia 
荷兰众议院	Dutch House of Representatives 
酒神与太阳神	Bacchus and Sun God 
罗保铭	Luo Baoming 
李玉全	Li Yuquan 
孙浩浩	Sun Haohao 
北美中部夏令时间	Central Daylight Time 
地理标准时间	Geographic Standard Time 
笹木野站	Sasakino Station 
河南话	Henan dialect 
直布罗陀海峡	Strait of gibraltar 
中华人民共和国国徽	National Emblem of the People's Republic of China 
关西国际机场	Kansai International Airport 
nba选秀状元列表	NBA draft pick list 
唐崔利·威利斯	Don Trely Willis 
迪士尼邮轮	Disney Cruise Line 
双头鹰	Double-headed eagle 
余慧文	Huiwen 
w:dance-punk	w:dance-punk 
东方亚述教会	Eastern Assyrian Church 
团结工联	Solidarity 
意大利半岛	Italian Peninsula 
蒙古国总理	Prime Minister of Mongolia 
微软研究院	Microsoft Research 
劲歌金曲	popular songs 
jp:アダイウトン・ドス・サントス・ダ・シルバ	jp: Adaiuton dos Santos da Silva 
戸田铃音	Todarin Pharmacy 
关爱华	Guan Aihua 
南奎里	South querie 
吴越国	Wu Yueguo 
光州广域市	Gwangju Metropolitan City 
中间派民主国际	Centrist democratic international 
不伦瑞克公爵	Duke of Brunswick 
布拉干萨王朝	Bragança 
费奥多拉公主_(萨克森-迈宁根)	Princess Feodora_ (Saxony-Meiningen) 
刀剑神域	Sword Art Online 
三立电视	Sanli TV 
海法马卡比足球俱乐部	Maccabi Haifa 
奥地利人	Austrian 
陈燊龄	Chen Shenling 
寿峰里	Shoufengli 
空中客车a320neo系列	Airbus a320neo series 
动作角色扮演游戏	Action RPG 
新加坡足球总会	Singapore Football Association 
明日への赞歌	A song for tomorrow 
aim-9响尾蛇飞弹	aim-9 rattlesnake missile 
海老名市	Ebina City 
信性入道亲王	Prince of Faithful Entry 
民俗摇滚	Folk rock 
中国共产党河北省委员会	Hebei Provincial Committee of the Communist Party of China 
太空梭外储箱	Space Shuttle Outer Tank 
旺格努伊_(新西兰选区)	Whanganui_(New Zealand constituency) 
勃艮第的玛蒂尔德	Mathilde of Burgundy 
本笃八世	Benedict VIII 
爱知川	Aichigawa 
白俄罗斯人	Belarusian 
威廉一世_(符腾堡)	William I_ (Wuerttemberg) 
政治哲学	Political philosophy 
克丽奥佩脱拉六世	Cleopatra VI 
国家科学奖章	National Science Medal 
中国人民解放军空军司令员	Commander of the Chinese People's Liberation Army Air Force 
邓高域	Deng Gaoyu 
尼尔球场	Neal Stadium 
西班牙语美洲独立战争	Spanish American War of Independence 
哥伦比亚大学法学院	Columbia University School of Law 
朝鲜半岛	Korean Peninsula 
伊东纯也	Ito Junya 
美国总统继任顺序	Succession order of U.S. presidents 
青春纪行	Youth Journey 
加拿大圣公会	Canadian Anglican Church 
彭冲	Peng Chong 
潘漫红	Pan Manhong 
犯罪小说	Crime fiction 
北义大利	Northern Italy 
瑞典省份	Swedish provinces 
费尔蒙特_(西弗吉尼亚州)	Fairmont_ (West Virginia) 
福尔摩斯_(2009年电影)	Sherlock Holmes_ (2009 movie) 
济州联	Jeju United 
微观经济学	Microeconomics 
仁川广域市	Incheon Metropolitan City 
安蒂特姆战役	Battle of Antietam 
潘乔维拉远征	Pancho Villa Expedition 
奥塔哥大学	University of Otago 
混合核心	Hybrid core 
宗教哲学	Religious philosophy 
马来西亚副首相	Deputy Prime Minister of Malaysia 
聂辰席	Nie Chenxi 
城田优	Shirota Yu 
松风雅也	Song Feng Ya 
古书堂事件手帖	Handbook of Gushutang Incident 
花花足球会	Huahua Football Club 
大日本帝国陆军	Imperial Japanese Army 
雷纳尔多·比尼奥内	Reinaldo Binnone 
苏州东吴足球俱乐部	Suzhou Soochow Football Club 
劝修寺晴子	Kunshuji Haruko 
朝鲜定宗	Joseon Jeongjong 
费德里科·路易吉_(梅纳布雷亚伯爵)	Federico Luigi_ (Earl Menabrea) 
wikt:袁世凯	wikt: Yuan Shikai 
乔治·本廷克勋爵	Lord George Bentinck 
西班牙19岁以下国家足球队	Spain Under-19 National Football Team 
瓦尔代高地	Valdai Heights 
哥斯大黎加总统	President of Costa Rica 
那维勋	Na Weixun 
庞多雷湖	Lake Pondore 
融合爵士乐	Fusion jazz 
utc-7	utc-7 
巴克莱中心	Barclays Center 
cnn中心	cnn center 
古时音乐	Ancient music 
泰国摇滚	Thai rock 
摄氏温标	Celsius temperature scale 
俏皮类音乐	Playful music 
吴诗萍	Wu Shiping 
马俊萦	Ma Junying 
搜寻地外文明计划	Search for Extraterrestrial Civilization Project 
拉脱维亚总理	Prime Minister of Latvia 
红土市政府	Hongtu City Government 
穆尔帕克_(加利福尼亚州)	Moore Park_ (California) 
庶出子女	Concubine 
孟加拉国总理	Prime Minister of Bangladesh 
柬埔寨人民革命党	Cambodian People's Revolutionary Party 
水力发电	Hydropower 
大平透	Dapingtou 
乌兰布通之战	Battle of Ulan Butong 
华贝拿	Waberna 
地方分权	Decentralization 
克雷研究奖	Cray Research Award 
昆明南站	Kunming South Railway Station 
中华民国长途电话区号表	Republic of China long-distance telephone area code table 
古墓派	Tomb School 
衣索比亚中央银行	Central Bank of Ethiopia 
欧洲盟军最高司令	Supreme Commander of the European Allied Forces 
俄罗斯战略火箭军	Russian Strategic Rocket Force 
湾流四号	Gulfstream Four 
朝鲜族人名	Korean names 
库铁乌阿剌里	Kutiewu Arali 
博雷尔空间	Borel Space 
澳洲体育学院	Australian Institute of Sport 
杉本健勇	Kenyu Sugimoto 
成都谢菲联	Chengdu Sheffield United 
东福岛车站	Tofukushima Station 
塞勒姆_(俄勒冈州)	Salem_ (Oregon) 
科恰班巴	Cochabamba 
因葵	Inkui 
美国-墨西哥音乐	American-Mexican Music 
弗罗西洛内	Frosilone 
维吾尔—葛逻禄语组	Uyghur-Glulu Group 
拿斯·维比	Nass Vibe 
格吕克斯堡王朝	Glücksburg Dynasty 
阿拉贡的伊莱奥诺拉	Eleonora of Aragon 
日本电视台	Japan Television 
橙色拿索秩序勋章	Orange Nassau Order of Order 
仁川祟义足球场	Incheon Chungui Football Stadium 
莫比尔县	Mobile County 
柏林赫塔足球俱乐部	Hertha Berlin Football Club 
拉美加勒比政党常设会议	Standing Conference of Latin American and Caribbean Political Parties 
坦桑尼亚银行	Bank of Tanzania 
上海嘉定城发足球俱乐部	Shanghai Jiading Chengfa Football Club 
.su	.his 
赵善意	Zhao Shanyi 
大学运动联盟	University Sports League 
全音素文字	Whole phoneme 
白仓伸一郎	Shinichiro Shirahiro 
发行光碟	Release disc 
梅因斯05第一足球与体育俱乐部	Mains 05 First Football and Sports Club 
中部地方	Central region 
沿海闽语	Coastal Min 
荷兰的路易丝	Louise of the Netherlands 
丹麦大区	Region of Denmark 
epic唱片	epic record 
中国电影集团	China Film Group 
正义联盟成员列表	List of Justice League Members 
龙目里	Lombok 
太平洋法郎	CFP franc 
制作委员会	Production Committee 
大桥惠	Ohashi 
横相乙儿之地	Land of Hengxiang Yier 
甘肃省_(中华民国)	Gansu Province_(Republic of China) 
麦加谢里夫	Mecca Sharif 
经典蒙古语	Classic Mongolian 
新寮国国家体育场	New Laos National Stadium 
肯扬学院	Kenyon College 
基辅奥波隆足球俱乐部	Kyiv Opolon Football Club 
美国邮区编号	U.S. ZIP Code 
富士电视台	Fuji Television 
地方自治主义	Local autonomy 
公正俄罗斯	Just Russia 
武汉体育中心	Wuhan Sports Center 
中国工农红军大学	China Red Army University of Industry and Agriculture 
康诺特和斯特拉森公爵	Connaught and the Duke of Strathson 
容子棋	Rong Ziqi 
太平洋标准时间	PST 
俄罗斯航空	Russia Airlines 
沙漠风暴行动	Operation Desert Storm 
出神音乐	Trance music 
艾历治	Alrich 
岩手町	Iwate Town 
极左翼	Extreme left 
吉布地市	Djibouti City 
nbc环球电电视发行公司	nbc universal television distribution company 
河南各地级市地区生产总值列表	List of Gross Regional Product of Henan Province 
欧洲右派_(1989–1994)	European Right_ (1989–1994) 
本杰明·a·史密斯二世	Benjamin A. Smith II 
釜山亚运会主竞技场	Busan Asian Games Main Arena 
济南遥墙国际机场	Jinan Yaoqiang International Airport 
克罗地亚19岁以下国家足球队	Croatia Under-19 National Football Team 
英国各地区区划	Regions in the UK 
彤贵妃	Concubine Tong 
vatteluttu字母	vatteluttu letters 
德国总理府_(1871年—1945年)	German Chancellery_ (1871-1945) 
唐卡斯特	Doncaster 
赠地大学	Land-grant university 
加拿大议会	Canadian Parliament 
杨振斌	Yang Zhenbin 
叶企孙	Ye Qisun 
征婚启事_(电视剧)	Marriage Notice_(TV Series) 
巴拉圭足球协会	Paraguay Football Association 
杰图高	Jetugao 
忠孝敦化站	Zhongxiao Dunhua Station 
古巴部长会议主席	President of the Cuban Council of Ministers 
佩鲁贾足球会	Perugia Football Club 
纳瓦拉君主列表	List of Monarchs of Navarre 
虚构兵器列表	List of fictional weapons 
可缩放向量图形	Scalable vector graphics 
麦贯之	Mai Guanzhi 
美国众议院议长	Speaker of the U.S. House of Representatives 
gilgit–baltistan	gilgit–baltistan 
国家政治保卫局	National Political Security Bureau 
苏南硕放国际机场	Sunan Shuofang International Airport 
国际电信联盟电信标准化部门	International Telecommunication Union Telecommunication Standardization Department 
松下电器	Matsushita Electric 
s:教育部国语推行委员会组织条例	s:Organization Regulations of the National Language Promotion Committee of the Ministry of Education 
埃克巴坦那	Ekbatana 
英国王位继承	British succession 
教宗若望七世	Pope John VII 
东方卫视	Dragon TV 
纯明孝皇后	Pure Queen of Filial Piety 
锺汉良	Zhong Hanliang 
法学博士	JD 
乔治·菲普斯，第二代诺曼比侯爵	George Phipps, the second Marquis of Normanby 
美国职棒大联盟三振王	Major League Baseball strikeout king 
师范学校	Normal school 
纽约大学法学院	New York University School of Law 
德川宗尹	Tokugawa Zongyin 
香港丁组足球联赛队伍	Hong Kong Division D Football League teams 
大冬瓜_(电视剧)	Big Winter Melon_ (TV Series) 
中国共产党中央军事委员会纪律检查委员会	Commission for Discipline Inspection of the Central Military Commission of the Communist Party of China 
民主党	Democratic Party 
各拉丹冬峰	Gola Dandong 
忠孝新生站	Zhongxiao Xinsheng Station 
威尔士_(澳大利亚国会选区)	Wales_(Australian Parliamentary Constituency) 
通用串行总线	Universal Serial Bus 
阿提哈德学院	Etihad College 
周伯通	Zhou Botong 
欧洲联合左翼/北欧绿色左翼	European Union Left/Nordic Green Left 
沙田体育会足球队	Sha Tin Sports Association Football Team 
帕尔马公爵列表	List of Duke of Palma 
土耳其民主党	Turkish Democratic Party 
巴塞罗那竞技俱乐部	Atletico Barcelona 
陈美琪	Chen Meiqi 
马里兰州众议院	Maryland House of Representatives 
鄂图曼土耳其语字母	Ottoman Turkish alphabet 
社会契约论	Social Contract Theory 
西班牙参议院	Spanish Senate 
普莱森特镇区_(哈维县)	Pleasant Township_(Harvey County) 
刺客任务：密约浮影	Assassin Mission: Secret Floating Shadow 
苏联最高苏维埃主席团	Presidium of the Supreme Soviet of the USSR 
大寮机厂	Daliao machine factory 
索菲_(普鲁士公主)	Sophie_ (Princess of Prussia) 
戴北方	Dai Beibei 
.lv	BGN 
立陶宛国民议会	National Assembly of Lithuania 
彭罗斯－霍金奇点定理	Penrose-Hawking Singularity Theorem 
一片石之战	Battle of a piece of stone 
以色列新谢克尔	Israeli New Shekel 
新柏拉图主义	Neo-Platonism 
罗马尼亚足球乙级联赛	Romanian Football League 
宋照肃	Song Zhaosu 
扎因皇后	Queen Zain 
卡卢加	Kaluga 
钢之炼金术师	Fullmetal Alchemist 
东莞南城体育中心	Dongguan Nancheng Sports Center 
威廉明妮公主_（普鲁士）	Princess William Minnie_ (Prussia) 
l-39信天翁	l-39 Albatross 
九里东九陵	Jiuli East Jiuling 
意大利内政部长	Italian Minister of the Interior 
张海鸽	Zhang Haige 
文字处理器	Word processor 
中国省份	Chinese provinces 
全球定位系统	Global Positioning System 
长春科技大学	Changchun University of Science and Technology 
欧洲自由联盟	European Freedom Union 
拉脱维亚农民联盟	Latvian Farmers Union 
jp:フェリペ・デ・オリヴェイラ・バロス	jp: Felipe de Oliveira Barros 
日本黑松	Japanese black pine 
明道加斯	Mindaugas 
勃朗特三姊妹	The Three Bronte Sisters 
张美贤	Zhang Meixian 
曾颖诗	Zeng Yingshi 
后垃圾摇滚	Post grunge 
田锅陵太	Tian Guo Lingtai 
康乐及文化事务署	Leisure and Cultural Services Department 
黄大洲	Huang Dazhou 
孝钦显皇后	Queen Xiaoqin 
东北官话	Northeast Mandarin 
柏林大学	University of Berlin 
竹内利光	Toshimitsu Takeuchi 
布吉国际机场	Phuket International Airport 
布鲁日足球俱乐部	Bruges Football Club 
财政大臣	Minister of Finance 
东方石油体育俱乐部	Eastern Petroleum Sports Club 
吉森大学	University of Giessen 
忧郁的共鸣	Melancholic resonance 
冒险游戏	Adventure game 
元昭宗	Yuan Zhaozong 
虹吸记录器	Siphon recorder 
郡司彰	Akira Gunji 
纽韦尔老男孩竞技俱乐部	Newell Old Boys Athletic Club 
圣罗莎_(加利福尼亚州)	Santa Rosa_ (California) 
加勒比海盗3：世界的尽头	Pirates of the Caribbean 3: End of the World 
危机边缘_(第四季)	Edge of Crisis_ (Fourth Season) 
民谣摇滚	Folk rock 
童冰玉	Tong Bingyu 
西班牙自治区	Spanish Autonomous Community 
江苏各地级市地区生产总值列表	List of Regional GDP of Jiangsu Province 
多民族	Multi-ethnic 
本田足球会	Honda Football Club 
詹姆斯·哈里斯三世	James Harris III 
科布雷罗阿体育俱乐部	Cobreroa Sports Club 
猪仔馆人家	Piggy House 
亚欧混血	Asian and European mixed 
烈火雄心_(电视剧)	Fire Ambition_ (TV series) 
金海国际机场	Gimhae International Airport 
sokode	Therefore 
宠物反斗星	Pets Anti Star 
香港国际主题乐园有限公司	Hong Kong International Theme Park Co., Ltd. 
皎克西县	Kyauksi County 
冯凯筠	Feng Kaijun 
鹭山京子	Kyoko Kyoyama 
吉阿吉阿语	Gia Gia 
w:de:deutsche_fußballnationalmannschaft_(u-18-junioren)	w: de: deutsche_fußballnationalmannschaft_ (u-18 junior) 
圣玛尔大之家	Saint Mart's House 
美国商务部	U.S. Department of Commerce 
n8集团	n8 group 
科学小飞侠crowds	Science Peter Pan crowds 
索美塞区政府	Somerset District Government 
亚历山大一世_(伊庇鲁斯)	Alexander I_ (Epirus) 
东波罗的语支	East Baltic languages 
科乐美	Konami 
双线线圈	Two-wire coil 
超级星光大道_(第六届)	Super Avenue of Stars_ (6th) 
托尼霍克的职业滑板	Tony Hawk's professional skateboarding 
沪汉蓉快速客运通道	Shanghai-Hanrong Express Passenger Transport Corridor 
玛丽·阿黛拉伊德_(卢森堡大公)	Marie Adelaide_ (Grand Duke of Luxembourg) 
台语民族	Taiwanese people 
固伦纯禧公主	Princess Gulun Pure Jubilee 
cd单曲	cd single 
海伦娜公主_(拿骚)	Princess Helena_ (Nassau) 
六·一八宣言	June 18 Declaration 
基督教圣人	Christian saints 
巴伐利亚的朱迪丝_(死于843年)	Judith of Bavaria (died 843) 
旭日章	Sunburst 
永芳卓磨	Yongfang Zhuomo 
育碧软体	Ubisoft 
崇实大学	Soongsil University 
欧洲绿党	European Green Party 
64位元	64 bit 
君士坦斯一世	Constantine I 
北尾一人	Kitao alone 
贝尔格勒红星	Belgrade Red Star 
交往行为	Communicative behavior 
生本直毅	Naoki Ikumoto 
恋爱模拟游戏	Love simulation game 
统一国民党	United national party 
蓝音符唱片	Blue Note Record 
市川三乡町	Ichikawamisato Town 
埃尔普河畔阿韦讷	Avennes-sur-elp 
巴哈马元	Bahamian Dollar 
宋旻淳	Song Min Soon 
本间幸司	Koji Homma 
撒旦坑	Satanic Pit 
巴奇_(漫威漫画)	Buggy_ (Marvel Comics) 
绀野朝美	Konno Asami 
苏联加盟共和国	Soviet Union 
小米手机1s	Mi mobile phone 1s 
全国人民代表大会会议主席团	Bureau of the National People's Congress 
b2m娱乐	b2m entertainment 
碧血盐枭	Jade Blood Salt Owl 
jp:藤原义子	jp: Fujiwara Yoshiko 
事件驱动程式设计	Event-driven programming 
马萨里克大学	Masaryk University 
哲学人类学	Philosophical anthropology 
李俊_(足球裁判)	Li Jun_ (Football Referee) 
郑锡元	Zheng Xiyuan 
海军上将	Admiral 
林欣彤	Lin Xintong 
英皇书院	King's College 
warmen	to warm 
拿武斯	Navus 
北池袋站	Kita Ikebukuro Station 
崇德里_(田寮区)	Chongdli_(Tianliao District) 
电钢琴	Electric piano 
射雕英雄传角色列表	Legend of the Condor Heroes Character List 
桑德赫斯特皇家军事学院	Royal Military Academy Sandhurst 
黄军政	Huang Junzheng 
地方议会	Local council 
苏格兰君主列表	List of Scottish monarchs 
竞赛之日	Race day 
安塔利亚足球俱乐部	Antalya Football Club 
法国预算部长	French Minister of Budget 
新潟天鹅女子队	Niigata Swan Women's Team 
巴黎高等师范学校	Ecole Normale de Paris 
曾保华	Zeng Baohua 
吴国桢	Wu Guozhen 
工业音乐	Industrial music 
认知心理学	Cognitive psychology 
香港戏剧协会	Hong Kong Theatre Association 
马其顿的阿尔西诺伊	Arsinoy of Macedonia 
国际足联联合会杯	FIFA Confederations Cup 
私人公司	private company 
常宁公主	Princess Changning 
2016年夏季奥林匹克运动会	2016 Summer Olympics 
贵阳北站	Guiyang North Railway Station 
博雷尔矛盾	Borel contradiction 
实践大学	Practice university 
大连北站	Dalian North Railway Station 
德雷森男爵保罗·德雷森	Paul Drayson, Baron Drayson 
宪政民主联盟	Constitutional Democratic Alliance 
华顶宫博信王	King Boxin of Huading Palace 
罗德西亚总统	President of Rhodesia 
加利福尼亚州各县列表	List of counties in California 
吴学谦	Wu Xueqian 
反法西斯主义	Anti-fascism 
自由保守主义	Liberal conservatism 
郑成功攻台之役	Zheng Chenggong's attack on Taiwan 
.nl	.NL 
哥伦比亚法学院	Columbia Law School 
伊藤优汰	Ito Yutai 
秩父宫雍仁亲王	Prince Yohito of Chichibu Palace 
热那亚足球俱乐部	Genoa Football Club 
叙利亚行政区划	Administrative divisions of Syria 
gnu宽通用公共许可证	GNU Lesser General Public License 
匹兹堡海盗	Pirates of Pittsburgh 
东京体育场	Tokyo Stadium 
.mw	.mw 
华盛顿向邦联议会	Washington to Confederate Assembly 
青岛鲲鹏	Qingdao Kunpeng 
白大炯	Bai Dajiong 
丁尼生男爵	Baron Tennyson 
牛津大学赫特福德学院	Oxford University Hertford College 
达德拉和纳加尔哈维利	Dadra and Nagar Haveli 
高桥夏树	Takahashi Natsuki 
(黏黏)²	(Sticky)² 
布拉索夫足球俱乐部	Brasov Football Club 
费尔菲尔德雄鹿	Fairfield Bucks 
玛丽亚·劳拉公主	Princess maria laura 
格兰德艾兰_(内布拉斯加州)	Grand Island_ (Nebraska) 
数学哲学	Mathematical philosophy 
itv4	itv4 
纽西兰二级行政区划	New Zealand Second Administrative Division 
蔚山现代	Ulsan Hyundai 
成人抒情	Adult lyric 
亨利·德雷伯奖章	Henry Draper Medal 
华研国际音乐	Huayan International Music 
锺正龙	Zhong Zhenglong 
经济增长	Economic Growth 
威廉·怀特洛，第一代怀特洛子爵	William Whitelow, the first Viscount Whitelow 
电脑科学家	Computer scientist 
真坦拿	True Tanner 
长州藩	Changzhou Fan 
袁伟豪	Yuan Weihao 
乌尔姆足球俱乐部	Ulm Football Club 
case-shiller房价指数	case-shiller house price index 
中国移动多媒体广播	China Mobile Multimedia Broadcasting 
乌拉尔猫头鹰	Ural Owl 
月球科学	Lunar science 
张伯仁	Zhang Boren 
仲川遥香	Haruka Nakagawa 
孔有德	Kong Youde 
阿尔马格罗圣罗伦素体育会	Almagro San Lorenzo Sports Club 
贝尔格莱德大学	University of Belgrade 
程可为	Cheng Kewei 
羽村英	Ei Hamura 
加文·纽森	Gavin Newson 
瑞士国庆日	Swiss National Day 
スパイスミュージック	Spice music 
乌克兰最高拉达	Verkhovna Rada of Ukraine 
动作游戏	Action game 
三井财阀	Mitsui Chaebol 
新门芳	Xinmenfang 
军舰旗	Warship flag 
凯恩和林奇	Kane and Lynch 
理亲王	Prince Li 
邦阿西楠语	Pangasinan 
拉韦松—莫利安	Flights from Laveson to Morian 
佐佐木莉佳子	Sasaki Rikako 
清太祖元妃	Lady Tunggiya 
冼燕芳	Xian Yanfang 
苏联共产党中央政治局	Politburo of the Communist Party of the Soviet Union 
英爱条约	Anglo-Irish Treaty 
funkerman	funkerman 
美国开国元勋	Founding Fathers of the United States 
上木则安	Shangmu Zean 
高夫巴	Goffba 
美国海军部长	Secretary of the Navy 
雷克斯汉姆足球俱乐部	Wrexham Football Club 
图尔的埃芒加德	Emangard of Tours 
西班牙电话号码	Spain phone number 
乐乐精选	Lele Featured 
天地豪情	World pride 
反对党领袖	Opposition leader 
宇称不守恒	Parity is not conserved 
卡洛斯二世	Carlos II 
投资银行	investment bank 
汉口北湖文体中心	Hankou Beihu Cultural and Sports Center 
哥斯达黎加科朗	Costa Rican Colon 
精英政治	Elite politics 
张举能	Zhang Juneng 
bagpipes_(how_i_met_your_mother)	bagpipes_(how_i_met_your_mother) 
广义相对论	General relativity 
沙特阿拉伯王储	Crown Prince of Saudi Arabia 
igorot	igorot 
撒丁统治者列表	List of rulers of Sardinia 
洛克伦足球俱乐部	Lokeren Football Club 
科维良足球俱乐部	Covilha Football Club 
军队主计长	Army controller 
孤恋花_(2005年电视剧)	Lonely Love Flower_ (2005 TV series) 
新村信	Xincun Letter 
一剑化三清	One sword transforms three clears 
冼翠贞	Xian Cuizhen 
英国广播公司娱乐台	BBC Entertainment 
孙瑞彬	Sun Ruibin 
杨百翰大学	Brigham Young University 
词曲作家	Songwriter 
托勒密十一世	Ptolemy XI 
甲信越地方	Koshinetsu region 
alamodome	alamodome 
姜大声	Jiang Loudly 
德川家正	Tokugawa Ie Masa 
美国雕刻与印刷局	U.S. Bureau of Engraving and Printing 
威尔士亲王查尔斯	Charles, Prince of Wales 
神奇宝贝xy	Pokémon xy 
拉塞福模型	Rutherford Model 
阿伦足球俱乐部	Allen Football Club 
印第安纳大学麦肯尼法学院	Indiana University McKinney School of Law 
马日丹那	Martanna 
at&t	at&t 
广州大学城中心区体育场	Guangzhou University Town Central Stadium 
尹荣善	Yin Rongshan 
幻影迷宫	Phantom Labyrinth 
埃因霍温足球俱乐部	Eindhoven Football Club 
香港演艺学院	Hong Kong Academy for Performing Arts 
利留卡拉尼女王	Queen Liliukarani 
黑森统治者列表	List of rulers of Hesse 
空中巴士a330neo	Airbus a330neo 
huskvarna	huskvarna 
少年漫画	Boy comics 
黄传芳	Huang Chuanfang 
环绕音效	Surround sound 
土耳其篮球协会	Turkish Basketball Association 
夏洛特公主_(威尔斯)	Princess Charlotte_ (Wales) 
南安里	Nan'anli 
圣塔克鲁兹县_(加利福尼亚州)	Santa Cruz County_(California) 
大帐篷	Big tent 
李juno	Lee juno 
年吞	Year swallow 
有线电视	Cable TV 
portlaoise	portlaoise 
综合大学	Comprehensive University 
斯里兰卡行政区划	Administrative divisions of Sri Lanka 
匈牙利共和国	The Republic of Hungary 
丹尼尔·里卡多	Daniel Ricardo 
波士尼亚和黑塞哥维那21岁以下国家足球队	Bosnia and Herzegovina Under-21 National Football Team 
足利义诠	Ashikaga Yoshiakira 
前田雅文	Masafumi Maeda 
罗佩清	Luo Peiqing 
呼和浩特白塔国际机场	Hohhot Baita International Airport 
中国外交部长列表	List of Chinese Foreign Ministers 
叙利亚内战对黎巴嫩的影响	The impact of the Syrian civil war on Lebanon 
荣安固伦公主	Princess Rongan Gulun 
威斯康星大学麦迪逊分校	University of Wisconsin-Madison 
日本扁柏	Japanese cypress 
韩国联合通讯社	Yonhap News Agency 
桑德豪森体育俱乐部	Sandhausen Sports Club 
秘鲁阿普拉党	Peruvian Apula Party 
张都暎	Zhang Duying 
梁卓伟	Liang Zhuowei 
波罗的-斯拉夫语族	Baltic-Slavic 
巴塞隆纳足球俱乐部	Barcelona FC 
保大_(阮福晪)	Bao Da_ (Nguyen Phuc Tho) 
李懿凌	Li Yiling 
gnome计划	gnome plan 
at&t中心	at&t center 
.sk	.sk 
古川雅典	Furukawa Athens 
冈比亚总统	President of The Gambia 
我的公主	my princess 
中共滁州市委书记	Secretary of the CPC Chuzhou Municipal Committee 
中星9号	China Star 9 
菲律宾海	Philippine Sea 
福永嫮生	Fuyong Misheng 
西汉普斯特	West Hampster 
底特律老虎	Detroit Tigers 
美国国土安全部	U.S. Department of Homeland Security 
鸠山幸	Miyuki Hatoyama 
莫斯科东方大学	Moscow Oriental University 
中国共产党第十七届中央委员会	The 17th Central Committee of the Communist Party of China 
印度次大陆	Indian subcontinent 
池田长吉	Ikeda Nagayoshi 
加利福尼亚州议会	California State Assembly 
塞拉利昂总统	President of Sierra Leone 
近藤彻志	Kondo Tetsushi 
伊利沙伯医院	Queen Elizabeth Hospital 
安平镇_(明郑)	Anping Town_(Mingzheng) 
中央精神文明建设指导委员会	Central Mental Civilization Construction Steering Committee 
巴基斯坦语言	Pakistani language 
弗朗索瓦-塞尔坦·康罗贝尔	Francois-Seltan Conrobel 
列卡度	Lekadu 
民间宗教	Folk religion 
私立学校	private school 
简单认证与安全层	Simple authentication and security layer 
巴兰基亚足球俱乐部	Barranquilla Football Club 
印度国大党	Indian National Congress 
西高地省_(巴布亚纽几内亚)	Western Highlands Province_ (Papua New Guinea) 
贝尔太空科技公司	Bell Space Technology 
中欧会战	China-Europe War 
水嶋斐吕	Mizushima Hiro 
利奥波德二世_(神圣罗马帝国)	Leopold II_ (Holy Roman Empire) 
中国航空工业集团	Aviation Industry Corporation of China 
巴塞隆纳足球会	FC Barcelona 
杉本大地	Daichi Sugimoto 
沟通理性	Communication rationality 
中国共产党第十八届中央委员会	The 18th Central Committee of the Communist Party of China 
张至成	Zhang Zhicheng 
ups航空	ups aviation 
澳门有线电视	Macau Cable TV 
民主党_(韩国_1955年)	Democratic Party_ (Korea_1955) 
朝鲜海峡	Korea Strait 
香港终审法院	Hong Kong Court of Final Appeal 
比耶利纳	Bielina 
琼中黎族苗族自治县	Qiongzhong Li and Miao Autonomous County 
南奄美-冲绳语支	South Amami-Okinawa branch 
神奈川条约	Kanagawa Treaty 
闽赣语	Hokkien 
阿基坦国王	King of Aquitaine 
泰迪·赖利_(制作人)	Teddy Reilly_ (producer) 
k.will	k.will 
李贵富	Li Guifu 
马凯雷雷大学	Makerere University 
少年四大名捕_(2008年电视剧)	Four famous young arrests_ (2008 TV series) 
南非总督	Governor of South Africa 
伊什特万一世	Istwan I 
维森特足球俱乐部	Vicente Football Club 
立宪共和制	Constitutional republic 
边后卫	Full back 
莱特航空	Wright Airlines 
福茂唱片	Fumao Records 
斐济总督	Governor of Fiji 
兰开夏	Lancashire 
每个人都讨厌赫里	Everyone hates Heri 
狂热普通话	Fanatic Mandarin 
教宗华伦亭	Pope Valentin 
威廉·卡文迪许-斯科特-本廷克，第五代波特兰公爵	William Cavendish-Scott Bentinck, the fifth Duke of Portland 
魏蔓	Wei Man 
吉村洋文	Hirofumi Yoshimura 
维克托二世	Victor II 
俄罗斯米格航空器集团	MiG Aircraft Group 
卡洛林王朝	Carolingian Dynasty 
得分后卫	Shooting guard 
安那托利亚摇滚	Anatolian Rock 
塔尔珀传媒控股	Talper Media Holdings 
盖尔曼–劳定理	Gellman--Raw Theorem 
金田一少年之事件簿_(电视剧)	Kindaichi Boys' Case Book_ (TV Series) 
羽过天晴	Yu Guo Tian Qing 
玩具总动员：遗忘的时光	Toy Story: Forgotten Time 
波罗的-芬兰语支	Baltic-Finnish 
最快圈速	Fastest lap 
森麻实郡议会	Morimashi County Council 
芜湖话	Wuhu dialect 
希腊德拉克马	Greek drachma 
布加勒斯特理工大学	Bucharest University of Technology 
菲施巴赫城堡	Fischbach Castle 
拉姆齐的厨房噩梦	Ramsey's kitchen nightmare 
保加利亚总理	Prime Minister of Bulgaria 
大众捷达	Volkswagen Jetta 
click入黄金屋	click into the golden house 
亚西西的圣方济各圣殿	Basilica of St. Francis of Assisi 
加拿大官方反对党领袖	Official Canadian Opposition Leader 
八打灵再也	Petaling Jaya 
保加利亚独立日	Bulgaria Independence Day 
辅音音素文字	Consonant phoneme text 
民营企业	Private Enterprise 
中条比纱也	Hisaya Nakajo 
教宗若望二世	Pope John II 
自然发生	Naturally occurring 
奥林匹亚丝	Olympias 
和田洋一	Yoichi Wada 
单声道	Mono 
保加利亚第二帝国	Second Bulgarian Empire 
香港09	Hong Kong 09 
世界体系理论	World system theory 
教会之母隐修院	Monastery of the Mother of the Church 
沃金厄姆_(英国国会选区)	Wokingham_(British Parliamentary District) 
列宁格勒战役	Battle of Leningrad 
约克王朝	York Dynasty 
.sh	.sh 
捷克21岁以下国家足球队	Czech Under-21 National Football Team 
日本联赛杯	Japan League Cup 
格鲁吉亚议会	Georgian Parliament 
后结构主义	Post-structuralism 
俄罗斯人民友谊大学	People's Friendship University of Russia 
皇家利亚斯体育会	Real Leas Athletic Club 
巴基斯坦总理	Prime Minister of Pakistan 
民航飞机	Civil Aviation Aircraft 
南哈德利_(马萨诸塞州)	South Hadley_ (Massachusetts) 
北方集团军	Northern Army 
越南共和国军	Army of the Republic of Vietnam 
美国第5骑兵团	U.S. 5th Cavalry Regiment 
肯塔基州立大学	Kentucky State University 
蒙得维的亚流浪者足球俱乐部	Montevideo Rangers Football Club 
何雪丽	He Xueli 
滨海阿雷尼斯	Arenis de Mar 
经济计算问题	Economic calculation problem 
加拿大行政区划	Canadian administrative divisions 
威廉·昂斯洛，第四代昂斯洛伯爵	William Onslow, the fourth Earl of Onslow 
大众集团a平台	Volkswagen Group a platform 
路易斯·玛格丽特公主_(康诺特公爵夫人)	Princess Louis Margaret_ (Duchess of Connaught) 
林湘萍	Lin Xiangping 
占士·当拿治	James Donald 
欧盟外交和安全政策高级代表	High Representative for EU Foreign and Security Policy 
活页乐谱	Sheet music 
交响金属l	Symphonic Metall 
东京大学	University of Tokyo 
德克萨斯州农工大学	Texas A&M University 
里卡尔多·米萨西	Riccardo Misassi 
迷惑摇滚	Confusing rock 
行星学会	Planetary Society 
首都圈新都市铁道	Metropolitan Metropolitan Railway 
杰尼斯娱乐	Genesis Entertainment 
新宿西口站	Shinjuku West Exit Station 
浦和车站	Urawa Station 
维戈塞尔塔足球俱乐部	Celta Vigo 
韩光徽	Han Guanghui 
野口啄木鸟	Wildmouth Woodpecker 
adjaria	adjaria 
多许可	Multi-license 
于莉芝	Yu Lizhi 
朝鲜人民军最高司令官	Supreme Commander of the Korean People's Army 
法兰克福大学	University of Frankfurt 
中华人民共和国财政部	Ministry of Finance of the People's Republic of China 
香港甲组联赛	Hong Kong League One 
加拿大元	Canadian Dollar 
舍人皇女	The Empress 
非洲足球协会	African Football Association 
赫利孔唱片	Helicon Records 
金武映	Jin Wuying 
波旁公爵	Duke of Bourbon 
小米手机2s	Mi mobile phone 2s 
克莱丽莎·史宾塞-邱吉尔	Clarissa Spencer-Churchill 
克罗地亚总统	President of Croatia 
欧洲质量改善系统	European Quality Improvement System 
奥古路比	Augusto 
右派民粹主义	Right populism 
戈登.英格兰	Gordon. England 
巴西23岁以下国家足球队	Brazil Under-23 National Football Team 
小野清子	Kiyoko Ono 
新世纪音乐	New Century Music 
花月佳期_(电视剧)	Flower Moon Festival_ (TV series) 
香港体育学院	Hong Kong Sports Institute 
应用物理学实验室	Applied Physics Laboratory 
完颜阿骨打	Wanyan A Gu Da 
京田诚一	Seiichi Kyoda 
邵玉铭	Shao Yuming 
番町政策研究所	Bancho Policy Research Institute 
路易-马修·莫莱	Louis-Matthew Morley 
朝鲜国家奥运足球队	North Korea National Olympic Football Team 
西门子铁路系统	Siemens Railway System 
苏联国防部长	Soviet defense minister 
大畑晃一	Koichi Ohata 
sonthi_boonyaratglin	sonthi_boonyaratglin 
苏格兰议会	Scottish Parliament 
国语流行音乐	Mandarin Pop 
中央大学_(汪精卫政权)	Central University_ (Wang Jingwei regime) 
华谊兄弟	Huayi Brothers 
冰岛福音路德教会	Evangelical Lutheran Church of Iceland 
主题公园	theme park 
德川家继	Tokugawa Ieji 
李文舜	Li Wenshun 
让-路易·博洛	Jean-Louis Bollot 
吉林各市州地区生产总值列表	List of GDP of each city, prefecture and region in Jilin 
英皇集团	Emperor Group 
李梓枞	Li Zizong 
神山健治	Kenji Kamiyama 
东姑莫哈末依斯迈	Tunku Mohd Ismail 
路易·皮埃尔·德·沙塔内，皮伊塞居伯爵	Louis Pierre de Chatane, Count of Pieségu 
アップフロントエージェンシー	Upfront agency 
散粒噪声	Shot noise 
赫尔市议会	Hull City Council 
步步惊心_(桐华小说)	Startling Every Step_(Tonghua Novels) 
比托尔·康斯坦西奥	Bitor Constantio 
选举君主制	Elective monarchy 
由起圭	Yuki Kyu 
奥古斯塔公主_(萨克森-哥达)	Princess Augusta_ (Saxony-Gotha) 
大元帅	Grand Marshal 
哈佛商学院	Harvard Business School 
东德领导人列表	List of East German leaders 
科索沃战争	Kosovo War 
洪乙心	Hong Yixin 
多哥国庆日	Togo National Day 
斯里兰卡总统	President of Sri Lanka 
乔治亲王_(剑桥公爵)	Prince George_ (Duke of Cambridge) 
数字发行	Digital distribution 
70号州际公路	Interstate 70 
塞尔维亚总统	President of Serbia 
秦煌	Qin Huang 
麦觉理大学	Macquarie University 
soshy	Sore 
角色扮演游戏	role playing game 
真实行动点数系统	Real Action Point System 
1867年奥匈折衷方案	Austro-Hungarian compromise in 1867 
多布里察·乔西奇	Dobrica Josic 
国立清华大学	National Tsinghua University 
斯劳_(英国国会选区)	Slough_(British Parliamentary District) 
白俄罗斯共和国国家银行	National Bank of the Republic of Belarus 
最终幻想ii	Final Fantasy II 
美国陆军工兵队	U.S. Army Corps of Engineers 
偏远地区社会发展托管地	Social Development Trust in Remote Areas 
杨雄_(1953年)	Yang Xiong_ (1953) 
梁君彦	Liang Junyan 
马耳他总理	Prime Minister of Malta 
福尔孔王朝	Forcon Dynasty 
新加坡国防部	Singapore Ministry of Defense 
高延寿	Gao Yanshou 
香蕉战争	Banana war 
瑞士23岁以下国家足球队	Switzerland Under-23 National Football Team 
刘枝华	Liu Zhihua 
15&	15& 
大阪狭山市	Sayama City, Osaka 
共构与共站	Co-construction and co-site 
巴勒斯坦解放人民阵线总司令部	Palestine Liberation People's Front Headquarters 
中岛爱	Ai Nakajima 
大学共同利用机关法人	University Common Utilization Institution Legal Person 
史诗唱片日本	Epic Records Japan 
李天翔	Li Tianxiang 
张珪	Zhang Gui 
上比利牛斯省	Haute Pyrenees 
国籍标志	Nationality sign 
崔荣喜	Cui Rongxi 
柳州远道	Liuzhou Yuandao 
卧龙岗市_(新南威尔士州)	Wollongong_(New South Wales) 
马路天使	Road angel 
冰岛社会事务和社会保障部	Ministry of Social Affairs and Social Security of Iceland 
浙江艺术职业学院	Zhejiang Vocational College of Art 
阿瑟王子_(康诺和斯特拉森公爵)	Prince Arthur_ (Duke of Connaught and Strathson) 
超级战队系列	Super Team Series 
索菲_(符腾堡)	Sophie_(Wuerttemberg) 
日本索尼音乐娱乐	Sony Music Entertainment Japan 
2014年至2015年德国足球甲级联赛	2014-2015 German Football League 
皇权球场	King Power Stadium 
高登_(企业家)	Gordon_ (Entrepreneur) 
巴西副总统	Vice President of Brazil 
郑国江	Zheng Guojiang 
三好康児	Koji Miyoshi 
拉特朗圣若望大殿	Basilica of Saint John Lateran 
肝付兼笃	With a liver 
cospicua	conspicuous 
派珀角	Piper Point 
芬马克郡	Finnmark 
盐崎雄二	Shiozaki Yuji 
符合方法	Compliance method 
中国共产党中央军事委员会	Central Military Commission of the Communist Party of China 
台湾基督长老教会	Taiwan Presbyterian Church 
迪查保	Dichabao 
青岛海牛	Qingdao Manatee 
士郎正宗	Masamune Shirow 
前进伊高斯	Forward Igos 
社区学院	community College 
菊地洋子	Yoko Kikuchi 
玉村町	Tamamura Town 
综艺节目	variety show 
竹后里	Takehouli 
新加坡财政部	Singapore Ministry of Finance 
弗朗西斯·罗顿-哈斯丁斯，第一代哈斯丁斯侯爵	Francis Roton-Hastings, the first Marquis of Hastings 
北京铁路局	Beijing Railway Bureau 
神圣怪物们	Holy monsters 
墨西哥国立自治大学	National Autonomous University of Mexico 
夏健伦	Xia Jianlun 
美属维京群岛总督列表	List of Governors of the U.S. Virgin Islands 
基辅大学	Kiev University 
私立惠比寿中学	Private Ebisu Middle School 
德国统一社会党	German Unity Socialist Party 
.vi	.we 
马拉维储备银行	Reserve Bank of Malawi 
法国行政区划	French administrative divisions 
伏伊伏丁那足球俱乐部	Vojvodina Football Club 
茶岛雄介	Teashima Yusuke 
真仓翔	Masura Sho 
前230年	230 years ago 
digital+	digital+ 
老表，你好hea！	Old watch, hello hea! 
叱奴太后	The queen mother 
圣地亚哥-德孔波斯特拉	Santiago de Compostela 
公立学校	public school 
杨松柏	Yang Songbai 
凯渥模特儿经纪公司	Kaiwo Model Agency 
波特兰公爵	Duke of Portland 
澳大利亚国防部	Australian Ministry of Defence 
为人民服务	Serve the people 
第二届全国人民代表大会	The Second National People's Congress 
贴古迭儿	Tie Gudie 
ダイヤレディー	Diamond Lady 
法国科学院	French Academy of Sciences 
罗慕路斯·奥古斯都	Romulus Augustus 
刘淇	Liu Qi 
美南浸信会	Southern Baptist Church 
东映动画	Toei Animation 
良妃_(康熙帝)	Concubine_(Kangxi Emperor) 
喜马拉雅山脉	Himalayas 
卫拉特-喀尔喀分支	Oirat-Karkha branch 
北美英军总司令	Commander-in-chief of the british army in north america 
阿尔巴尼亚东正教	Albanian Orthodox Church 
玻利维亚足球乙级联赛	Bolivia Football League Two 
巴基斯坦外交事务国务部长	Minister of State for Foreign Affairs of Pakistan 
幸福摩天轮	Happy Ferris Wheel 
黑斯廷斯战役	Battle of Hastings 
核心马来-波利尼西亚语群	Core Malay-Polynesian group 
法国18岁以下国家足球队	France under-18 national football team 
小石川后乐园	Koishikawa Korakuen 
越南民族主义	Vietnamese nationalism 
美国国家科学奖章	National Medal of Science 
英苏入侵伊朗	British and Soviet invasion of Iran 
女人天下	Woman world 
崔秀宗	Cui Xiuzong 
菲律宾自治领	Dominion of the Philippines 
a&m/octone	a&m/octone 
派桑杜	Passando 
鸟山明	Toriyama Akira 
杜德印	Du Deyin 
母音附标文字	Vowel superscript 
巴基斯坦县份	Pakistani counties 
次马来语群	Sub-Malay group 
吉尔伯特·艾略特-默里-基宁蒙德，第一代明托伯爵	Gilbert Eliot-Murray-Kiningmund, the first Earl of Minto 
动物横町	Animal Yokocho 
阿提哈德航空	Etihad Airways 
燃气涡轮发动机	Gas turbine engine 
国家情报总监	Director of National Intelligence 
伊朗君主列表	List of Iranian monarchs 
意大利总统	President of Italy 
国家电网	State Grid 
高久进	Gao Jiujin 
历史上未被国际普遍承认国家列表	List of countries not generally recognized in history 
格拉斯哥卡思卡特_(苏格兰议会选区)	Glasgow Cascade_ (Scottish Parliament constituency) 
marlango	marlango 
中华人民共和国宪法	Constitution of People's Republic of China 
hc3	Hsh 
巴利阿里群岛	Balearic Islands 
克莱夫·欧文	Clive Owen 
山东鲁能泰山	Shandong Luneng Mount Tai 
益城町	Mashiki Town 
于克勒	Uccle 
马德里竞技足球俱乐部	Atletico Madrid Football Club 
arvanitika	arvanitika 
京兆地方	Jingzhao place 
萨丁尼亚里拉	Sardinian Lira 
首席库政	Chief Treasurer 
济州海峡	Jeju Strait 
前99年	99 years ago 
俄罗斯外交部	Russian Ministry of Foreign Affairs 
伊丽莎白公主_(黑森和莱茵)	Princess Elizabeth_(Hesse and Rhine) 
塞席尔卢比	Seychellois Rupee 
苏联卢布	Soviet ruble 
now宽频电视	now Broadband TV 
大阪维新会	Osaka Restoration 
shabwah	shabwah 
五学院联盟	Five College Alliance 
和硕科技	Pegatron 
大日本航空	Imperial Japanese Airways 
江西理工大学	Jiangxi University of Science and Technology 
幼王亨利	Young King Henry 
马来西亚金杯	Malaysia Gold Cup 
梁柏坚_(填词人)	Liang Baijian_(Cylist) 
阿根廷青年	Argentine Youth 
甄志鹏	Zhen Zhipeng 
荷兰国会第一院	First House of the Dutch Parliament 
古山千惠	Furuyama Chie 
哈尔滨会展中心体育场	Harbin Convention and Exhibition Center Stadium 
四川隆发	Sichuan Longfa 
俄勒冈州各县列表	List of counties in Oregon 
达特茅斯学院	Dartmouth College 
爱丽珊德拉_(汉诺威公主)	Alexandra_ (Princess of Hanover) 
壮侗语族	Zhuang-Dong Languages 
关炳洪	Guan Binghong 
铜星勋章	Bronze Star 
城市建造游戏	City building game 
中华民国国务院	State Council of the Republic of China 
弗雷德里克九世	Frederick IX 
早安少女组。	Morning Musume Group. 
奥腾斯泰因	Altstein 
大安的列斯群岛	Great Antilles 
所俊克	So Junke 
计算机科学	computer science 
英国枢密院	Privy Council 
圣詹姆士公园	St. James's Park 
古市古坟群	Ancient Tomb Group 
约翰·威廉·弗里索_(拿骚-迪茨)	John William Friso_ (Nassau-Dietz) 
克赖斯特彻奇国际机场	Christchurch International Airport 
大阪市交通局	Osaka City Transportation Bureau 
罗丝玛丽的婴儿_(我为喜剧狂)	Rosemary's baby_ (I am crazy for comedy) 
拿督斯里	Datuk Seri 
统一俄罗斯党	United russia party 
美国航空球场	American Airlines Stadium 
东久迩成子	Shigeko Higashiku 
三菱扶桑卡客车	Mitsubishi Fuso Truck and Bus 
约翰·理查森_(新西兰政治家)	John Richardson_ (New Zealand politician) 
罗马尼亚文	Romanian 
弗里德里希·威廉三世_(萨克森-阿尔滕堡)	Friedrich Wilhelm III (Saxony-Altenburg) 
牙买加勋章	Order of Jamaica 
捷克共和国议会参议院	Senate of the Parliament of the Czech Republic 
大正野球娘。	Taisho baseball girl. 
意大利21岁以下国家足球队	Italy Under-21 National Football Team 
烹饪三角	Cooking triangle 
反资本主义	Anti-capitalism 
希拉尔足球俱乐部	Hillar Football Club 
上海申迪集团	Shanghai Shendi Group 
德山秀典	Hidenori Tokuyama 
嫁阪翔太	Shota Yomesaka 
刘志远_(香港音乐人)	Liu Zhiyuan_ (Hong Kong Musician) 
logrolling	logrolling 
伍世文	Wu Shiwen 
等候英女皇发落	Waiting for the Queen of England 
制作委员会方式	Production committee method 
威拉德·冯·奥曼·蒯因	Willard von Oman Quine 
韩承勋	Han Chengxun 
明定国是诏	Ming Ding Guo is an edict 
法国大区	French region 
瑞典君主列表	List of Swedish monarchs 
于豪章	Yu Haozhang 
首席技术官	Chief Technology Officer 
宾夕法尼亚州众议院	Pennsylvania House of Representatives 
流行电音	Popular Electronic Music 
国家广播电影电视总局	State Administration of Radio, Film and Television 
哥罗布导师	Grob Mentor 
中国人民解放军总政治部	General Political Department of the Chinese People's Liberation Army 
威讯中心	Verizon Center 
石人金属	Stone man metal 
千叶县旗	Chiba Prefecture Flag 
中华民国政府	Government of the Republic of China 
李致林	Li Zhilin 
胡启恒	Hu Qiheng 
罗斯托克大学	University of Rostock 
荷兰丙级足球联赛	Dutch Football League 
圣保罗论坛	Sao Paulo Forum 
天主教勃生教区	Catholic Diocese of Pathein 
瑞利准则	Rayleigh criterion 
王信贵	Wang Xingui 
开元通宝_(闽太祖)	Kaiyuan Tongbao_(Min Taizu) 
进步联盟	Progressive Alliance 
lg集团	lg group 
湖南第一师范学院	Hunan First Normal University 
阿尔吉克语系	Aljik language family 
里岚狂热	Lilan Fanatic 
崔文锡	Cui Wenxi 
韩国20岁以下国家足球队	South Korea Under-20 National Football Team 
第一人称射击游戏	First-person shooter 
海军大臣	Secretary of the Navy 
亚美尼亚独立日	Armenia Independence Day 
英国的构成国	British constituent countries 
衣索比亚比尔	Ethiopian Birr 
电脑成像	Computer imaging 
迪米特利巴哈	Dimitri Baja 
功子内亲王	Prince Gongzi 
谍报小说	Espionage novel 
摇滚乐演奏者列表	List of Rock Music Players 
塞尔维亚行政区划	Administrative divisions of Serbia 
罗一秀	Luo Yixiu 
.dk	.dk 
.ly	.glass 
厄倪俄	Enyo 
乔伟光	Qiao Weiguang 
王老虎抢亲_(电视剧)	King Tiger Snatches Kiss_ (TV Series) 
星和都会台	Star and Metropolis 
旗舰大学	Flagship University 
法兰西岛区域铁路	Île-de-France Regional Railway 
中华人民共和国中央人民政府_(1949–1954)	The Central People's Government of the People's Republic of China_(1949–1954) 
超级星光大道	Super Avenue of Stars 
夏威夷传统宗教	Hawaiian traditional religion 
骚莎音乐	Saosa Music 
会川升	Aikawa Masu 
德奥合并	German and Austrian merger 
婆罗-菲律宾语群	Borneo-Filipino group 
.tz	.tz 
明朝藩王列表_(宪宗、孝宗及睿宗系)	List of Ming Dynasty Kings_ (Xianzong, Xiaozong and Ruizong lines) 
凯德尔斯顿的寇松男爵	Baron Curzon of Kedleston 
近场通讯	Near Field Communication 
火车头体育中心	Lokomotiv Sports Center 
埃维昂协议	Evian Agreement 
持久自由军事行动	Operation Enduring Freedom 
波斯尼亚和黑塞哥维纳州份	Regions of Bosnia and Herzegovina 
梅贻琦	Mei Yiqi 
保生大帝	Emperor Baosheng 
加斯东_(奥尔良公爵)	Gaston_ (Duke of Orleans) 
北京稻草熊影视	Beijing Straw Bear Film and Television 
广州站	Guangzhou Station 
苏黎世联邦理工学院	ETH Zurich 
平面媒体	Print Media 
小池百合子	Yuriko Koike 
中央电视台彩色电视中心	CCTV Color Television Center 
苏菲女大公	Grand Duke Sophie 
美洲原住民神话	Native American Mythology 
1878年柏林条约	Treaty of Berlin of 1878 
乡村音乐种类列表	Country music category list 
程朱理学	Cheng Zhu Li 
香港基本法起草委员会	Hong Kong Basic Law Drafting Committee 
桶狭间之战	Battle of Tokahaza 
邪派秃鹰乐团	Evil Vulture Band 
阿尔贝·德·布罗伊，第四代布罗伊公爵	Albert de Broy, the fourth Duke of Broy 
谢秀能	Xie Xiuneng 
圣迭戈县_(加利福尼亚州)	San Diego County_(California) 
类刚果语支	Congolese 
中华体育会	Chinese Sports Association 
小手鼓	Tambourine 
共享源代码	Shared source code 
勃兰登堡的玛利亚·伊丽欧诺拉	Maria Ilionora of Brandenburg 
北美大平原	Great Plains of North America 
吴美仙	Wu Meixian 
委内瑞拉足球协会	Venezuelan Football Association 
基隆迪语	Kirundi 
流行说唱	Pop rap 
加泰罗尼亚研究学院	Catalan Research Institute 
温带大陆性季风气候	Temperate continental monsoon climate 
轻装步兵	Light infantry 
凯泽斯劳滕足球俱乐部	Kaiserslautern Football Club 
贝登堡男爵	Baron Badenburg 
杜伊斯堡足球俱乐部	Duisburg Football Club 
比拉马尔克桑特	Vilamarxant 
法国抵抗运动	French Resistance 
恐惧的总和	The sum of fear 
英国电影学院奖最佳男主角	British Film Academy Awards for Best Actor 
华伦西亚足球俱乐部	Valencia Football Club 
东江本地话	Dongjiang Local Dialect 
你们我们他们	You us them 
龟井善之	Kamei Yoshiyuki 
六户町	Roohe Town 
关麟征	Guan Linzheng 
file:pti_poster.jpg	friend: πτι_πόστερ.ξπγ 
达高域	Dagofield 
塞席尔中央银行	Seychelles Central Bank 
捷克总理	Prime Minister of the Czech Republic 
阿尔巴尼亚议会	Albanian Parliament 
吸血鬼猎人巴菲_(第五季)	Buffy the Vampire Slayer_ (Season 5) 
万鄂湘	Wan Exiang 
情报机构	Intelligence agency 
大杉涟	Osugi Ren 
护花危情	Flower care 
奥羽本线	Ou Line 
希腊17岁以下国家足球队	Greece Under-17 National Football Team 
苏联红军学校	Soviet Red Army School 
幸运女神	Goddess of luck 
欧洲东部夏令时间	Eastern European Daylight Time 
尾张德川家	Owari Tokugawa 
圣路易斯球场	St. Louis Stadium 
胡安娜_(卡斯蒂利亚)	Juana_ (Castile) 
墨西哥众议院	Mexican House of Representatives 
山口庆	Yamaguchi 
快乐联盟	Happy union 
源头奖	Source Award 
何永年	He Yongnian 
鹊华秋色图	Magpie Hua Autumn Colors 
马斯奥·比斯高	Masio Bisko 
南达科塔大学	University of South Dakota 
白脸山雀	White-faced tit 
林比足球俱乐部	Limby Football Club 
黎巴嫩内战	Lebanese Civil War 
中国共产党中央委员会	Central Committee of the Communist Party of China 
霹雳-12导弹	Thunderbolt-12 missile 
静冈県立清水东高等学校	Shizuoka Prefecture Shimizu East High School 
桦山久高	Hisataka Kabayama 
乌克兰行政区划	Administrative divisions of Ukraine 
索菲亚火车头足球俱乐部	Sofia Lokomotiv Football Club 
贝尔429直升机	Bell 429 helicopter 
唐立真	Tang Lizhen 
川崎重工业	Kawasaki Heavy Industries 
京都大学	Kyoto University 
大内里	Ouchi 
孝静毅皇后	Queen Xiaojingyi 
acornsoft	acornsoft 
爱情合约	Love contract 
英国邮政编号	British postal code 
天空体育f1台	Sky Sports F1 
中国共产党第十四届中央委员会	The 14th Central Committee of the Communist Party of China 
铭传大学	Ming Chuan University 
西班牙国王杯	Copa del Rey 
雷可福磊斯	Reich Forrest 
英国文化	British Culture 
亚历山大·霍尔-鲁斯文，第一代高里伯爵	Alexander Hall-Ruthven, the first Earl of Gorry 
李璟荣	Li Jingrong 
芝加哥经济学派	Chicago School of Economics 
迪德朗日足球俱乐部	Dudelange Football Club 
等等力_(世田谷区)	Waiting Force_ (Setagaya Ward) 
校园漫画	Campus comics 
.me	.me 
护国战争	National Defence War 
墨西哥足球协会	Mexican Football Association 
男女同校	Coeducation 
埃德蒙顿国际机场	Edmonton International Airport 
印度语言	Indian language 
圣公会基孝中学	SKH Kei Hau Secondary School 
意大利足球协会	Italian Football Association 
内杰代特·卡拉巴巴	Nejdet Karababa 
兰开斯特王朝	Lancaster Dynasty 
电子游戏机历史_(第六世代)	History of electronic game consoles_ (sixth generation) 
开尔文变换	Kelvin transformation 
梁咏梅	Liang Yongmei 
费城国际	Philadelphia International 
东加勒比中央银行	Eastern Caribbean Central Bank 
启蒙时代	Age of Enlightenment 
挪威语言委员会	Norwegian Language Council 
马江_(登嘉楼)	Ma Jiang_(Terengganu) 
克莱孟十二世	Clement XII 
加州大学伯克利分校法学院	University of California, Berkeley School of Law 
2011年西班牙地方选举	2011 Spanish local elections 
耶路撒冷高等法院	Jerusalem High Court 
陈汉玮	Chen Hanwei 
莫济里	Moziri 
意大利总理列表	List of Prime Ministers of Italy 
科英布拉集团	Coimbra Group 
中国共产党中央顾问委员会	Central Advisory Committee of the Communist Party of China 
君士坦丁一世_(罗马帝国)	Constantine I_ (Roman Empire) 
四川力达士足球俱乐部	Sichuan Lidas Football Club 
自由思想	Free thinking 
育碧阿纳西工作室	Ubisoft Annecy Studio 
联邦制国家成员	Member of a federal state 
特效化妆师大对决_(第三季)	Special Effects Makeup Artist Showdown_ (Season 3) 
javascript引擎	javascript engine 
知识管理	Knowledge management 
md5	Smokey 
干线客机	Mainline airliner 
潘玲玲	Pan Lingling 
北韩足球协会	North Korea Football Association 
拿骚的索菲亚	Sophia of Nassau 
巴西社会民主党	Brazilian Social Democratic Party 
音频文件格式	Audio file format 
橙县_(加利福尼亚州)	Orange County_(California) 
爱尔兰自由邦议会	Irish Free State Assembly 
喜多村英梨	Eri Kitamura 
明英宗	Ming Hidemune 
大洗町	Oarai Town 
沃尔夫奖	Wolf Prize 
内藤信成	Naito Shincheng 
湖北武汉职业足球俱乐部	Hubei Wuhan Professional Football Club 
阿拉斯加州议会	Alaska State Assembly 
费奥伦西奥·索拉球场	Fiorencio Sola Stadium 
副部级大学	Vice-ministerial university 
海军兵学校	Naval Academy 
摩利拿	Morina 
法兰西学院	French Academy 
邱国正	Qiu Guozheng 
门诺会	Mennonite 
汉普斯特得	Hampstead 
国家烟草专卖局	State Tobacco Monopoly Administration 
顾绮慧	Gu Qihui 
赵必立	Zhao Bili 
帕迪亚_(考卡省)	Padia_ (Cauca Province) 
jp:藤原元子	jp: Fujiwara Motoko 
越南足球协会	Vietnam Football Association 
陈宝华	Chen Baohua 
布雷蔻坦波区政府	Braco Tambo District Government 
松山研一	Matsuyama Kenichi 
新自由主义	Neo-liberalism 
孟菲斯国际机场	Memphis International Airport 
诺曼底王朝	Norman Dynasty 
东柴郡议会	East Cheshire Council 
梦幻游戏	Fantasy game 
联合学院	Union College 
饭纲町	Iizuna Town 
杨铁心	Yang Tiexin 
温莎城堡	Windsor Castle 
俄罗斯科学院	Russian Academy of Sciences 
何礼文	What a thank you 
强者罗贝尔	Robel the Strong 
韩国银行	Bank of Korea 
普利兹克建筑奖	Pritzker Architecture Prize 
高燕珊	Gao Yanshan 
bad世界巡回演唱会	bad world tour 
泰国北部地区	Northern Thailand 
梅赛德斯-奔驰银行	Mercedes-Benz Bank 
莫德斯托_(加利福尼亚州)	Modesto_ (California) 
加拿大航空中心	Air Canada Centre 
王采玉	Wang Caiyu 
喜悦乐团	Joy Orchestra 
徐金成	Xu Jincheng 
底特律活塞	Detroit Pistons 
木曾町	Kiso Town 
议会-经理制政府	Parliament-manager government 
小星头啄木鸟	Little star-headed woodpecker 
丹麦社会民主党	Danish Social Democratic Party 
sorrento足球会	sorrento football club 
古德命名法	Good Nomenclature 
布宜诺斯艾利斯大学	University of Buenos Aires 
执行董事	executive director 
比尔森胜利	Pilsen victory 
英国卫生部	Department of Health 
jp:罗诚洙	jp: Na Seung-soo 
华仔天地	Huazi Tiandi 
李石保	Li Shibao 
唱片监制	Record producer 
亚历山大·温莎_(阿尔斯特伯爵)	Alexander Windsor_ (Earl of Ulster) 
泰国众议院	Thai House of Representatives 
千里达和多巴哥总统	President of Trinidad and Tobago 
神雕侠侣_(1982年电影)	Condor Heroes_(1982 movie) 
当代节奏蓝调	Contemporary rhythm and blues 
前347年	347 years ago 
朝鲜明宗	Mingjong 
今城尚子	Naoko Imajo 
苏我远智姬	Su Wo Yuan Zhi Hee 
美国驻墨西哥大使	U.S. Ambassador to Mexico 
东京都会电视台	Tokyo Metropolitan Television 
永历通宝	Yongli Tongbao 
澳大利亚国家党	Australian National Party 
韦根体育足球俱乐部	Wigan Sports Football Club 
utc-3	utc-3 
佐治亚理工学院	Georgia Institute of Technology 
提比略_(君士坦斯二世之子)	Tiberius_ (son of Constantine II) 
上田康太	Kota Ueda 
剑桥大学彭布罗克学院	Pembroke College, Cambridge University 
黄志华	Huang Zhihua 
新墨西哥州行政区划	Administrative divisions of New Mexico 
紫钗奇缘	Purple Hairpin 
百事中心球馆	Pepsi Center Arena 
巴黎地铁	Paris Metro 
天主教新西兰军中教长区	Catholic District of the New Zealand Army 
佐法尔叛乱	Dhofar Rebellion 
超级星光大道_星光传奇赛	Super Avenue of Stars_Starlight Legend Tournament 
猎杀红色十月号	Hunting for the Red October 
东京水产大学	Tokyo Fisheries University 
巴库国立大学	Baku State University 
马来西亚第12届国会议员列表	List of Members of the 12th Parliament of Malaysia 
通讯装置	Communication device 
梁明帝	Emperor Liang Ming 
威廉·j·布朗_(印第安纳州)	William J. Brown_ (Indiana) 
海岸边最可爱的女孩！	The cutest girl on the coast! 
匈牙利君主列表	List of Hungarian monarchs 
殖民地大臣	Colonial minister 
保守自由主义	Conservative liberalism 
朱拉春高皇家军事学院	Royal Military Academy Chulachungao 
忏悔者爱德华	Edward the Confessor 
大公陵	Grand Duke Tomb 
奥斯卡一世	Oscar I 
寰宇国际	Universe International 
方骏钊	Fang Junzhao 
廖允杰	Liao Yunjie 
雷阿尔城	Ciudad Real 
萨斯索罗足球体育会	Sassuolo Football Club 
c开头的那个词	the word beginning with c 
青沼英二	Eiji Aonuma 
法兰克王国皇帝列表	List of Emperors of the Frankish Kingdom 
亨利·福斯特，第一代福斯特男爵	Henry Foster, the first Baron Foster 
静冈县旗	Shizuoka Prefecture Flag 
托勒密十四世	Ptolemy XIV 
安敦尼王朝	Antonius 
加勒比地区	Caribbean 
格罗宁根足球俱乐部	Groningen Football Club 
南斯拉夫第纳尔	Yugoslavian Dinar 
爱尔兰甲级足球联赛	Irish Football League 
不速之约	Unexpected appointment 
日产汽车	Nissan Motor 
铃木将也	Masaya Suzuki 
大冢翔太	Otsuka Shota 
长期演进技术	Long-term evolution technology 
米歇尔·多尔纳诺球场	Michelle Donano Stadium 
美国辉格党	American Whig Party 
hh-60铺路鹰	hh-60 Paving Eagle 
列支敦士登国庆日	Liechtenstein National Day 
玛丽亚·特蕾西亚_(奥地利大公)	Maria Theresia_ (Archduke of Austria) 
道仓康介	Dokura Kosuke 
宪政会	Constitutional Council 
台北市立大学天母校区	Taipei City University Tianmu Campus 
假面舞会_(少年队单曲)	Masquerade_(Single for Junior Team) 
爱达荷奔腾	Idaho Pentium 
仙台市地下铁南北线	Sendai City Subway Namboku Line 
社会建构主义	Social constructivism 
农场足球俱乐部	Farm Football Club 
新圣人足球俱乐部	New Saints Football Club 
荣妃_(康熙帝)	Rongfei_(Kangxi Emperor) 
封闭源代码	Closed source code 
中国列车控制系统	China Train Control System 
圣墓教堂	Church of the Holy Sepulchre 
单机游戏	Stand-alone game 
奥地利摇滚	Austrian Rock 
鹳形目	Stork 
湖南省人民政府	Hunan Provincial People's Government 
阿部寿一	Juichi Abe 
芬兰-彼尔姆语族	Finnish-Permian 
吴荣义	Wu Rongyi 
乌克兰足球总会	Ukrainian Football Association 
尚稷王	King Shang Ji 
冈睦之	Okamuki 
西突厥语支	West Turkic 
尹姓	Yin Surname 
曾其祥	Zeng Qixiang 
墨尔本机场	Melbourne Airport 
埃芒加德的博蒙特	Beaumont of Emmangarde 
八一富邦火箭篮球俱乐部	Bayi Fubon Rocket Basketball Club 
布莱克本-达温	Blackburn-Daven 
姜涛_(足球运动员)	Jiang Tao_ (football player) 
自由民主党政务调查会	Liberal Democratic Party Council 
月球正面	Front of the moon 
格雷特霍夫体育会	Grethof Athletic Association 
伦敦市长	Mayor of London 
标清电视	SDTV 
王位觊觎者	Throne Pretender 
法尔科克足球俱乐部	Falkirk Football Club 
金日成军事综合大学	Kim Il Sung Military University 
mi-24雌鹿直升机	mi-24 doe helicopter 
按人口排列的美国城市列表	List of U.S. cities by population 
关静雯	Guan Jingwen 
大红帽与小野狼	Red Riding Hood and Little Wolf 
双线铁路	Double track railway 
乌尔都字母	Urdu alphabet 
阿塞拜疆民主共和国	Democratic Republic of Azerbaijan 
巴克纳与贾西亚	Buckner and Garcia 
歌德奖	Goethe Prize 
联合县_(新泽西州)	Union County_(New Jersey) 
连山大学	Lianshan University 
怒火街头	Angry street 
边前卫	Full-back 
妖夜寻狼之魔间叛徒	Traitor among the demons 
狄奥多西一世	Theodosius I 
file:胡宇威in3rddf.jpg	file:Hu Yuwei in3rddf.jpg 
松桥优	Matsuhashi Yu 
中华人民共和国人民警察警徽	People's Police of the People's Republic of China 
俄罗斯财政部长	Minister of Finance of Russia 
流行庞克乐团列表	List of popular punk bands 
刘易斯_(东萨塞克斯郡)	Lewis_(East Sussex) 
真的真的吗!	Really really! 
再生制动	Regenerative braking 
东非时间	East Africa Time 
商业足球会	Commercial Football Club 
藤木寿子	Toshiko Fujiki 
地拉拿足球会	Tirana Football Club 
元中都遗址	Yuanzhongdu Site 
狄尔斯–阿尔德反应	Diels–Alder reaction 
图瓦卢独立日	Tuvalu Independence Day 
阿布贾条约	Abuja Treaty 
英格兰东南	South east england 
伊莲娜_(希腊和丹麦)	Jelena_ (Greece and Denmark) 
研究型大学	Research Universities 
人均地区生产总值过万美元地级市列表	List of prefecture-level cities with per capita GDP exceeding US$10,000 
j2	j2 
同情唱片	Sympathy record 
人民代表大会制度	People's Congress System 
伊吹文明	Ibuki civilization 
苏联人民委员会	Soviet People's Committee 
克里米亚鞑靼人	Crimean Tatars 
欲戴王冠，必承其重－继承者们	If you want to wear the crown, you must bear its weight-heirs 
山本优	Yamamoto Yu 
曾生	Zeng Sheng 
ka-25直升机	ka-25 helicopter 
荷兰首相	Prime Minister of the Netherlands 
广东体彩女子足球俱乐部	Guangdong Sports Lottery Women's Football Club 
客运专线	Passenger Line 
空军大臣	Secretary of the Air Force 
欧力士野牛	Orix Bison 
各国议会联盟	Inter-Parliamentary Union 
神圣罗马帝国皇帝	Holy Roman Emperor 
枢机红	Cardinal Red 
战士联盟帮	Warrior League Gang 
波音综合国防系统集团	Boeing Integrated Defense Systems Group 
鼓打贝斯唱片公司	Drums and Bass Records 
马来西亚皇家空军	Royal Malaysian Air Force 
朱塞佩一世_(帕尔马)	Giuseppe I_ (Parma) 
香港商业电台	Hong Kong Commercial Radio 
泰晤士河畔京士顿	Kingston upon Thames 
大马士革艾瓦达体育会	Damascus Awada Sports Club 
小池武久	Takehisa Koike 
沙尔克04二队	Schalke 04 Second Team 
宋沛言	Song Peiyan 
台湾宏观电视	Taiwan Macro Television 
file:好心作怪.jpg	file: Good intentions.jpg 
奥历治拿	Austrian 
秘鲁超级杯	Peru Super Cup 
glynis_breakwell	glynis breakwell 
mtk布达佩斯足球俱乐部	mtk budapest football club 
正亲町雅子	Masako Masako 
基沙普县_(华盛顿州)	Kishap County_ (Washington State) 
大田世界杯竞技场	Daejeon World Cup Stadium 
皇家比华伦体育会	Royal Beveren Sports Club 
圣保罗男女中学	St. Paul's Co-educational School 
itv3	Help 
国际足联金球奖	FIFA Golden Globe Awards 
磁阻效应	Magnetoresistance effect 
日本社会党	Japan Socialist Party 
斯里兰卡共产党	Communist Party of Sri Lanka 
广汇集团	Guanghui Group 
王之_(王震之子)	Wang Zhi_ (son of Wang Zhen) 
林纯华	Lin Chunhua 
爱尔兰自由邦行政会议主席	Chairman of the Executive Council of the Irish Free State 
型别安全	Type safety 
郑洪然	Zheng Hongran 
国际大学协会	International University Association 
白发魔女2	The White Haired Witch 2 
亚述海	Assyrian Sea 
马拉博新体育场	New Stadium in Malabo 
北美山区时区	North American Mountain Time Zone 
蒲岗村道公园	Po Kong Village Road Park 
微笑pasta	Smile pasta 
中国共产党第十六次全国代表大会	The 16th National Congress of the Communist Party of China 
列塞庇护十世村	Les Pius X Village 
外交部常务次官	Deputy Deputy Minister of Foreign Affairs 
荷兰的露易莎	Louisa 
世宗特别自治市	Sejong Special Self-Governing City 
马龙尼礼教会	Maronite Church 
圣米伦足球俱乐部	St. Mirren Football Club 
利亚拿	Liana 
水谷拓磨	Takuma Mizutani 
勃兰登堡选帝侯	Elector of Brandenburg 
圣约翰主教座堂_(弗雷斯诺)	St. John's Cathedral_ (Fresno) 
崇明学宫	Chongming Academy 
尼瓦塔隆·汶颂派讪	Niwa Talon Von Son Pai San 
北爱尔兰问题	Northern Ireland question 
沃尔夫物理学奖	Wolf Prize in Physics 
马以	Ma Yi 
50美元纸币	50 dollars banknotes 
强型别	Strong type 
乌金学院	Ugin College 
佛蒙特大学	University of Vermont 
乡村灵魂	Country Soul 
海润影视集团	Hairun Film Group 
美国领土	U.S. territory 
西沙海战	Battle of Xisha 
柏林工业大学	Technical University of Berlin 
荒野拓马	Wilderness Tama 
mbk娱乐	mbk entertainment 
苏丹巴德利沙	Sultan Badlisha 
巴勒斯坦货币	Palestine currency 
东方白鹳	Oriental White Stork 
东魏孝静帝	Emperor Xiaojing of the Eastern Wei Dynasty 
at&t_u-verse	at&t u-verse 
file:清_佚名_《清穆宗同治皇帝朝服像》.jpg	file:Qing _ Anonymous_ "Portrait of Emperor Muzong Tongzhi in the Court Clothes".jpg 
福特哈尔斯大学	Fort Halls University 
日本气象厅	Japan Meteorological Agency 
中国东北地区	Northeast China 
文北里	Wenbei Li 
筑山殿	Zhushan Temple 
巴西利亚国家体育场	Brasilia National Stadium 
矢田旭	Asahi Yada 
保加利亚军队球场	Bulgarian Army Stadium 
泰卢固文	Telugu 
陈美诗	Chen Meishi 
搞笑一家人	Funny family 
直捣蜂窝的女孩	The girl who beats the honeycomb 
赎罪日战争	Yom Kippur War 
容妃_(乾隆帝)	Concubine Rong_ (Emperor Qianlong) 
锦屏街道	Jinping Jiedao 
河北工业大学	Hebei University of Technology 
人力资本	human capital 
乔治·克拉克，第一代库姆的西德汉姆	George Clark, Sidham of the First Coombe 
流星花园	Meteor Garden 
朱光民	Zhu Guangmin 
s:中央研究院组织法	s: Organic Law of Academia Sinica 
都卜勒光谱学	Doppler Spectroscopy 
人类发展指数	Human Development Index 
加拿大国家足球队	Canadian National Football Team 
竹下亘	Takeshita Ke 
伦敦文物学会	London Heritage Society 
保加利亚列弗	Bulgarian Lev 
裴秀智	Bae Suzy 
山田晃平	Kohei Yamada 
美国人口调查局	U.S. Census Bureau 
江苏省扬州中学	Yangzhou Middle School, Jiangsu Province 
西班牙国王	King of Spain 
早川智子	Tomoko Hayakawa 
工商管理硕士协会	Association of Masters of Business Administration 
兰卡斯特领地总裁	President of Lancaster Territory 
丘就却	Qiu Juque 
欧洲大学联盟	European Union of Universities 
斐迪南_(罗马尼亚)	Ferdinand_(Romania) 
波多野都	Hatanoto 
红旗勋章	Red Flag Medal 
乃木静子	Nogi Shizuko 
陈克勤	Chen Keqin 
南拳妈妈	Nanquan mother 
因纽特语族	Inuktitut 
法兰克福学派	Frankfurt School 
日本历史	Japanese history 
日本平运动公园竞技场	Nihondaira Athletic Park Arena 
庄稼汉_(中共官员)	Farmer_(Official of the Communist Party of China) 
爱德华·斯坦利，第十七代德比伯爵	Edward Stanley, 17th Earl of Derby 
丹麦君主列表	List of Danish monarchs 
超微半导体	Advanced Semiconductor 
美国人民党	American People's Party 
党卫队全国领袖	National leader of the SS 
珍妮佛·罗许_(1984年专辑)	Jennifer Rosh_ (1984 album) 
弗朗茨_(萨克森-科堡-萨尔费尔德)	Franz_(Saxony-Coburg-Saalfeld) 
行动应变及机动组	Action Response and Mobility Group 
图特摩斯四世	Thutmose IV 
德国第17军团	German 17th Army 
岸本齐史	Masashi Kishimoto 
邓梓峰	Deng Zifeng 
葡萄牙摇滚	Portuguese Rock 
傣痕语	Dai Hen Language 
夏威夷王国的覆灭	The fall of the Kingdom of Hawaii 
葛莱美奖	Grammy Awards 
那不勒斯的马里纳斯	Marinas of Naples 
宁新中邑	Ningxin Zhongyi 
张文豪	Zhang Wenhao 
蒙古人民党中央委员会主席	Chairman of the Central Committee of the Mongolian People's Party 
梅彭体育俱乐部	May Pen Sports Club 
温带季风气候	Temperate monsoon climate 
中国中信股份有限公司	China CITIC Limited 
武汉华创工程足球俱乐部	Wuhan Huachuang Engineering Football Club 
三好茂臣	Miyoshi Shigeo 
上河内町	Kamikawachi Town 
bhubaneswar	bhubaneswar 
标致206	Peugeot 206 
卢志培	Lu Zhipei 
厄利墨亚的菲拉	Phila of Elimoa 
佐佐木久美	Sasaki Kumi 
宗座圣多默大学	Pontifical Saint Thomas University 
机关车体育团	Locomotive Sports Team 
周先旺	Zhou Xianwang 
科伦布城堡	Columbus Castle 
爱尔兰共和军	Irish Republican Army 
梁漫之	Liang Manzhi 
地藏菩萨	Ksitigarbha 
马其顿共和国国家银行	National Bank of the Republic of Macedonia 
松平忠敬	Matsudaira Tadanori 
怀特菲尔德_(俄克拉何马州)	Whitefield_(Oklahoma) 
女子亚洲杯足球赛	Women's Asian Cup Football 
865号州际公路	Interstate 865 
成都航空	Chengdu Airlines 
曼城足球俱乐部	Manchester City Football Club 
少女的祈祷_(真野惠里菜单曲)	Girl's Prayer_ (Mano Eri Menu Song) 
印度之星勋章	Star of India 
加利福尼亚州第十二国会选区	California's 12th Congressional District 
yorin	yorin 
无宗教	non-religious 
新迷幻摇滚	New psychedelic rock 
辛巴威罗德西亚	Zimbabwe Rhodesia 
阿尔玛学院	Alma College 
自由贸易党	Free Trade Party 
整块性核心	Monolithic core 
菲盖拉-达福什	Figueira-Dafors 
路易十二	Louis XII 
香港宝嘉	Baojia 
葡萄牙自治区域	Portuguese Autonomous Region 
袁英杰	Yuan Yingjie 
英国飞机公司	British Aircraft Corporation 
十九世纪哲学家	Philosophers of the nineteenth century 
宏内核	Macro kernel 
汉莎货运航空	Lufthansa Cargo 
五条市	Gojo 
周礼茂	Zhou Limao 
藤原庆子	Fujiwara Keiko 
门罗县_(宾夕法尼亚州)	Monroe County_(Pennsylvania) 
马度古	Madugu 
语素文字	Morpheme 
圣尼古拉_(比利时东佛兰德省)	Saint Nicolas_ (East Flanders Province, Belgium) 
哥辛沙	Ge Xinsha 
区德辉	Ou Dehui 
张华立	Zhang Huali 
阿尔巴尼亚社会党	Albanian Socialist Party 
桥本巧	Hashimoto 
茨木惟昭	Toshiaki Ibaraki 
巴拉圭独立日	Paraguay Independence Day 
张鼓峰事件	Zhang Gufeng Incident 
电脑硬体	Computer hardware 
早川车站	Hayakawa Station 
伊朗军事史	Iranian military history 
姚懿珊	Yao Yishan 
苏联武装力量	Soviet armed forces 
英格兰的都会郡和非都会郡	Metropolitan and Non-Metropolitan Counties in England 
仓田秋	Kurata Autumn 
英国英语	British English 
阿非利加_(罗马行省)	Africa_(Rome Province) 
乌利维球场	Ulivi Stadium 
第二次泰法战争	The second Thai-French war 
杰斐逊维尔_(印第安纳州)	Jeffersonville_ (Indiana) 
醇贤亲王嫡妃	Prince and concubine 
泊松过程	Poisson process 
哈伊梅·阿古尔苏阿里	Hayme Agursuari 
大洋洲国家杯	Oceania National Cup 
英国自治市镇地位	British borough status 
中置引擎	Mid-engine 
大川めぐみ	Megumi Ogawa 
韦克县_(北卡罗来纳州)	Wake County_ (North Carolina) 
北侧一雄	Kazuo Kita 
何嘉丽	He Jiali 
sbs株式会社	sbs co., Ltd. 
中华人民共和国全国人民代表大会和地方各级人民代表大会选举法	Election Law of the National People's Congress of the People's Republic of China and Local People's Congresses 
法罗群岛议会	Faroe Islands Parliament 
厦门足球俱乐部	Xiamen Football Club 
藏语支	Tibetan branch 
火星之音乐团	Mars Music Group 
基调强节奏	Keynote strong rhythm 
艾迪·保斯拿	Eddie Bosner 
张徐宁	Zhang Xuning 
弦理论	String theory 
生物技术	Biotechnology 
卡那卡那富语	Kanakanafu 
南部非洲	Southern Africa 
三星galaxy_s系列	Samsung galaxy_s series 
叙利亚总理	Prime Minister of Syria 
哈雷-维滕贝格大学	Halle-Wittenberg University 
徐正陶	Xu Zhengtao 
韦恩县_(宾夕法尼亚州)	Wayne County_ (Pennsylvania) 
美国参议院多数党领袖	U.S. Senate Majority Leader 
搜神传	Search for God 
闪亮的星	Shining star 
春日部市	Kasukabe City 
吴家裕	Wu Jiayu 
民主党代表	Democratic Party Representative 
高清科幻荷里活	HD Sci-Fi Hollywood 
美国第2军	U.S. 2nd Army 
富士吉田市	Fujiyoshida City 
石潭里	Shitanli 
.it	.it 
理论物理学	Theoretical physics 
乌大经	Udaipur 
华北人民政府	North China People's Government 
民主党_(韩国1990年）	Democratic Party_ (South Korea 1990) 
邦比球场	Bambi Stadium 
希腊东正教	Greek Orthodox Church 
海南藏族自治州	Hainan Tibetan Autonomous Prefecture 
潘香凝	Pan Xiangning 
迈凯伦技术中心	McLaren Technology Center 
赫拉德茨-克拉洛韦足球俱乐部	Hradec Králové Football Club 
网际协议通话技术	Internet Protocol Call Technology 
足利满诠	Ashikaga Mitsua 
四氧化二氮	Dinitrogen Tetroxide 
比斯开省	Vizcaya 
宋飞的视野	Song Fei's vision 
北一真	Kitaichijin 
国际自由联盟	International Liberty League 
伊朗标准时间	Iran Standard Time 
露易丝皇后	Queen Louise 
瓦拉瓦拉县_(华盛顿州)	Walla Walla County_ (Washington State) 
伊斯法罕理工大学	Isfahan University of Technology 
肯雅君主	Kenyan monarch 
曾益新	Zeng Yixin 
韩相𬀪	Han Xiang𬀪 
河北精英	Hebei Elite 
大连体育中心体育场	Dalian Sports Center Stadium 
少女漫画	Shojo manga 
马其顿的佛提雅	Fotia of Macedonia 
芬兰足球协会	Finnish Football Association 
直接行动	Direct action 
八幡平市	Hachimantai City 
云南红塔	Yunnan Hongta 
科威特国家体育场	Kuwait National Stadium 
钵吕吉雄	Hachiro Yoshio 
财政部财务秘书	Finance Secretary of the Ministry of Finance 
中国驻俄罗斯/苏联大使列表	List of Chinese Ambassadors to Russia/Soviet Union 
埃及的欧律狄刻	Eurydice of Egypt 
麦克阿瑟奖	MacArthur Award 
香港宽频bbtv	Hong Kong Broadband bbtv 
胡恩_(央视副台长)	Hu En_ (Deputy Director of CCTV) 
探险托里兰托	Explore Torriranto 
奥兰治-拿骚王朝	Orange-Nassau Dynasty 
文理学院联盟	Liberal Arts College Alliance 
交通大学	Jiaotong University 
玉东町	Gyokuto Town 
十月围城	October Siege 
航空航天工程	Aerospace Engineering 
康沃尔公爵	Duke of Cornwall 
槟城州授勋及嘉奖制度	Penang State Honors and Awards System 
尼尔斯·波耳研究所	Niels Bohr Institute 
电子流行	Electronic pop 
忻贵妃	Xin Guifei 
詹姆斯党王位继承者列表	List of successors to the Jacobite throne 
钢片琴	Celeste 
明治大学	Meiji University 
日本民主青年同盟	Japan Democratic Youth League 
马尔他君主	Maltese monarch 
科隆大学	University of Cologne 
多贺町	Taga Town 
格罗宁根大学	University of Groningen 
土耳其海军	Turkish Navy 
qaf足球俱乐部	qaf football club 
青叶通站	Aoba Street Station 
康斯坦斯_(布列塔尼)	Constance_(Brittany) 
显肃公主	Princess Hyun Su 
社中里	In the society 
符晓薇	Fu Xiaowei 
圣丹尼斯教堂	Saint Denis Church 
中华民国行政区划	Administrative divisions of the Republic of China 
是永美记	Yeong Mi Kee 
file:friendfeed.png	file:friendfeed.png 
超级星光大道_(第七届)	Super Avenue of Stars_ (7th) 
联盟党_(法罗群岛)	Coalition Party_ (Faroe Islands) 
新百伦	new Balance 
tbs电视台	tbs television station 
捷克斯洛伐克总理	Prime Minister of Czechoslovakia 
意大利统一运动	Italian Unity Movement 
高惠真	Gao Huizhen 
深田明宏	Akihiro Fukada 
周燕娴	Zhou Yanxian 
新加坡国立大学	National University of Singapore 
拉丁美洲文学爆炸	Latin American literature explosion 
西布朗足球俱乐部	West Brom Football Club 
高文昕	Gao Wenxin 
固体物理学	Solid state physics 
克罗地亚语和波斯尼亚语字母	Croatian and Bosnian alphabet 
林佩娟	Lin Peijuan 
约翰·f·肯尼迪政府学院	John F. Kennedy School of Government 
申铉碻	Shin Hyun Sung 
湖南广播电视学校	Hunan Radio and Television School 
英属西太平洋高级专员	High Commissioner for the British West Pacific 
reprise唱片	reprise record 
一位论派	Unitarian 
严励行	Yan Lixing 
天禄_(圆融天皇)	Tianlu_(Emperor Yuanrong) 
自由主义和激进主义在意大利	Liberalism and activism in Italy 
自由意志主义	Libertarianism 
比勒费尔德足球俱乐部	Bielefeld Football Club 
拿比奥祖利球场	Nabiozuli Stadium 
郑徐客运专线	Zhengxu Passenger Dedicated Line 
风中奇缘_(电视剧)	Pocahontas_ (TV series) 
全国运动汽车竞赛协会	National Sports Car Racing Association 
书院联邦制	College federation 
通用语言运行库	Universal language runtime 
锡兰总督	Governor of Ceylon 
叛逆的鲁鲁修	Disobedient Lelouch 
青草背长江大桥	Qingcaobei Yangtze River Bridge 
sse4a	sse4a 
皇家邮政	Royal Mail 
.sz	.s 
联合力量作战	Joint Force Operations 
联合爱尔兰	United Ireland 
世界职业台球与斯诺克协会	World Professional Billiards and Snooker Association 
天平上的马尔济斯	Maltese on the scale 
焦点理论	Focus theory 
情歌没有告诉你	The love song didn't tell you 
丰原功补	Fengyuan Gongbu 
三星重工	Samsung Heavy Industries 
奥尔良的厄门特鲁德	Ermentrud of Orleans 
逾越节	Passover 
安杰洛·科玛斯特里	Angelo Komastri 
外交部长（柬埔寨）	Minister of Foreign Affairs (Cambodia) 
张之彦	Zhang Zhiyan 
布拉格条约_(1866年)	Treaty of Prague_ (1866) 
济南里	Jinanli 
伊斯兰社会主义	Islamic Socialism 
印第安纳州州长列表	List of Governors of Indiana 
钢城唱片	Steel City Records 
nba全明星赛	nba all-star game 
日本新党	Japan New Party 
后形而上学的哲学	Post-metaphysical philosophy 
圣贝纳迪诺_(加利福尼亚州)	San Bernardino_ (California) 
涡轮喷气发动机	Turbojet engine 
芬兰总理	Prime Minister of Finland 
罗贝尔一世_(诺曼底)	Robert I_ (Normandy) 
斯洛伐克19岁以下国家足球队	Slovakia Under-19 National Football Team 
赵克志	Zhao Kezhi 
中华人民共和国公务员	Civil servants of the People's Republic of China 
东之伊甸	East of Eden 
全罗南道	Jeollanam-do 
乔治二世	George II 
奇卡莫加战役	Battle of Chicamoga 
香港数码地面电视广播	Hong Kong Digital Terrestrial Television Broadcasting 
恐怖小说	horror story 
单身情歌	lonely love song 
阿尔泰共和国国徽	National Emblem of the Altai Republic 
file:raaf_badge.png	file: raaf_badge.png 
欧洲人民党党团	European People's Party Group 
新泽西州众议院	New Jersey House of Representatives 
消费者金融保护局	Consumer Financial Protection Bureau 
朱礼和	Zhu Lihe 
斯洛文尼亚21岁以下国家足球队	Slovenia Under-21 National Football Team 
李慧镝	Li Huidi 
柴木丈瑠	Chai Mu Zhanglu 
民主运动-统一的格鲁吉亚	Democratic Movement-Unified Georgia 
rcf巴黎	rcf paris 
埃及总理	Prime Minister of Egypt 
爱尔兰自由邦总督	Governor of the Free State of Ireland 
花吃了那女孩	Flower ate that girl 
苏我常陆娘	Su Wo Chang Lu Niang 
乔赛亚·韦奇伍德，第一代韦奇伍德男爵	Josiah Wedgwood, the first Baron Wedgwood 
about.com	about.com 
塞曼效应	Zeeman effect 
卡罗琳·玛蒂尔德_(萨克森-科堡-哥达)	Caroline Mathilde_ (Saxony-Coburg-Gotha) 
曾振农	Zeng Zhennong 
印度尼西亚银行	Bank of Indonesia 
教宗斯德望二世	Pope Stephen II 
西太平洋银行体育场	Westpac Stadium 
江西各地级市地区生产总值列表	List of Regional GDP of Jiangxi Prefectures 
图瓦卢君主	Monarch of Tuvalu 
张萤富	Zhang Yingfu 
长庚医院站	Chang Gung Memorial Hospital Station 
grindavíkurvöllur	grindavíkurvöllur 
体育及旅游业部长	Minister of Sports and Tourism 
超级制作人	Super producer 
古希腊宗教	Ancient Greek religion 
cj希杰集团	cj CJ Group 
朴次茅斯和约	Portsmouth Peace Treaty 
雷伊市政体育场	Rey Municipal Stadium 
波尔克县_(爱阿华州)	Polk County_ (Iowa) 
金子升	Jinsheng 
黄色魔术交响乐团	Yellow Magic Symphony Orchestra 
拜耳勒沃库森足球俱乐部	Bayer Leverkusen Football Club 
林布字母	Limb alphabet 
中央军事委员会改革和编制办公室	Central Military Commission Reform and Establishment Office 
国家中山科学研究院	National Zhongshan Academy of Sciences 
卡纳维尔角空军第36综合发射台	Cape Canaveral Air Force 36th Integrated Launch Pad 
西燕里	Xiyanli 
中国中央电视台英语新闻频道	China Central Television English News Channel 
巴黎戴高乐机场	Paris Charles de Gaulle Airport 
财政部首席秘书	Chief Secretary of the Ministry of Finance 
低音提琴	Double bass 
文学硕士	Master of Arts 
诺高平体育会	Norkoping Sports Club 
黄小晶	Huang Xiaojing 
锯齿边缘	Jagged edge 
渡边哲也	Watanabe Tetsuya 
利特尔瓦利_(纽约州)	Little Valley_ (New York State) 
芬兰-波米克语支	Finnish-Bomik branch 
国会工党	Congress Labor Party 
思蕊梵娜瓦瑞公主	Princess Sirivannavari 
大同里_(田寮区)	Datongli_(Tianliao District) 
日本外务省	Ministry of Foreign Affairs of Japan 
油尖旺足球队	Yau Tsim Mong Football Team 
nba最有价值球员	nba most valuable player 
第一代白金汉侯爵乔治·纽金特-坦普尔-格伦维尔	George Nugent-Tempel-Grenville, First Marquis of Buckingham 
墨尔本大学	University of Melbourne 
国家森林城市	National Forest City 
波兰总理列表	List of Prime Ministers of Poland 
非建制地区	Non-organized area 
皇家加斯拿素	Royal Gassner 
温僖贵妃	Concubine Wen Xi 
.uk	.uk 
小碧潭支线	Xiaobitan Branch 
尚稷	Shang Ji 
牧园大学	Muyuan University 
斯大林格勒战役	Battle of Stalingrad 
阪田章裕	Akihiro Sakata 
爱德华·巴恩斯_(英国军官)	Edward Barnes_ (British officer) 
林采民	Lin Caimin 
牟田雄祐	Yusuke Muta 
印度国防部部长	Minister of Defense of India 
slimport	slimport 
普惠公司	Pratt & Whitney 
阿根廷国民议会宫	Argentine National Congress Palace 
北七真	Kita Qizhen 
革命机valvrave	Revolution machine valvrave 
江西省奥体中心体育场	Jiangxi Olympic Sports Center Stadium 
荷兰君主列表	List of Dutch monarchs 
述行矛盾	Performance contradiction 
意大利宪法法院	Italian Constitutional Court 
.km	.km 
南太铉	Nam Tae Hyun 
天主教清州教区	Catholic Diocese of Cheongju 
曾勇夫	Zeng Yongfu 
玉山铁二	Yushan Teji 
温带大陆性气候	Temperate continental climate 
【国家级非通用语种本科人才培养基地】	[National non-universal language undergraduate talent training base] 
地铁英雄	Metro Hero 
罗贝坦王朝	Robetan Dynasty 
台北市私立华冈艺术学校	Taipei Private Huagang Art School 
格林纳达君主	Monarch of Grenada 
加拿大枢密院	Privy Council of Canada 
马拉加拉西河	Malagaras 
圣贝尔纳多-杜坎普	San Bernardo do Campo 
湖北华凯尔足球俱乐部	Hubei Huakair Football Club 
西班牙15岁以下国家足球队	Spain Under-15 National Football Team 
法尔马球场	Falma Stadium 
大不里士拖拉机足球俱乐部	Tabriz Tractor Football Club 
阿根廷20岁以下国家足球队	Argentina Under-20 National Football Team 
成乐寅	Akin Seong 
查理七世_(神圣罗马帝国)	Charles VII_ (Holy Roman Empire) 
上村健一	Kenichi Uemura 
中贝德福德郡_(英国国会选区)	Central Bedfordshire_(British Parliamentary District) 
奥地利王位继承战争	War of the Austrian Succession 
华盛顿大学	Washington University 
