桥本由香利	Hashimoto Yukari 
严岛神社	Itsukushima Shrine 
曾雯婷	Zeng Wenting 
冯柏源	Feng Baiyuan 
蔡氏电路	Chua's circuit 
绚香×可苦可乐	Ayaka × Coco Cola 
一江山岛战役	Battle of Yijiangshan Island 
作词家	Lyricist 
鲁西永	Roussillon 
贝莱斯沙士菲体育会	Velez Shasfield Sports Club 
第二次马纳沙斯之役	The Second Battle of Manassas 
浪速人	Naniwa 
弗里蒙特_(内布拉斯加州)	Fremont_ (Nebraska) 
国民革命军陆军新编第四军	New Fourth Army of the National Revolutionary Army 
中国南部	Southern China 
神旺投资	Sanwang Investment 
伯尔克郡政府	Berkshire Government 
李四川	Li Sichuan 
拜金女孩	Money girl 
贝特公式	Bethe formula 
达卡亚巴哈尼足球会	Dakaya Bahani Football Club 
屋大维娅	Octavia 
京都不死鸟	Kyoto Sanga 
category:伊顿公学校友	category:Eton College Alumni 
瑞典王后	Queen of Sweden 
美国战役奖章	American Battle Medal 
演进式hspa	Evolutionary hspa 
何文薏	He Wenyi 
赫尔-李特伍德多项式	Hull-Littlewood Polynomial 
大辽里	Daliaoli 
诺贝尔奖得主列表	List of Nobel Prize winners 
手机规格	Phone specifications 
陕西各地级市地区生产总值列表	List of regional GDP of various cities in Shaanxi 
初恋嗱喳面	First Love Screaming Noodles 
比安伊拉夫‧祖云奴域	Bianyilav Zuyunnuyu 
圣菲利普区_(巴巴多斯)	Saint Philip District_(Barbados) 
爱沙尼亚银行	Bank of Estonia 
雀形目	Passerine 
拉华尔足球俱乐部	Raval Football Club 
加尔各达	Calcutta 
比亚斯华	Biaswa 
标致雪铁龙集团	Peugeot Citroen Group 
那帕	Napa 
伊朗伊斯兰议会	Islamic Parliament of Iran 
富裕柯尔克孜语	Wealthy Kirghiz 
加利福尼亚州第十四国会选区	California's 14th Congressional District 
日本华人	Japanese Chinese 
德黑兰澳洲军事学院	Tehran Australian Military Academy 
科技音乐	Technological Music 
德意志之歌	Song of Germany 
中央情报局局长	Director of the Central Intelligence Agency 
洪涛_(制作人)	Hong Tao_(Producer) 
美洲人	American 
苗礼治	Miao Lizhi 
清太祖皇六女	Six Daughters of Qing Taizu Emperor 
和宫亲子内亲王	Prince of the Palace 
布恩_(爱阿华州)	Boone_ (Iowa) 
j5	j5 
桑乔六世_(纳瓦拉)	Sancho VI_ (Navarre) 
间接选举	Indirect election 
上田茂	Shigeru Ueda 
国立民雄高级农工职业学校	National Minxiong Advanced Agricultural and Industrial Vocational School 
云南陆军讲武堂	Yunnan Army Lecture Hall 
阿尔及利亚银行	Bank of Algeria 
杨行密	Yang Xingmi 
兹维亚德·加姆萨胡尔季阿	Zvyad Gamsakhurdia 
丰都长江大桥	Fengdu Yangtze River Bridge 
艾希迪体育及文化会	Ashidi Sports and Cultural Association 
日本百观音	Hundred Kannon 
北瓦济里斯坦特区	North Waziristan 
卡塔尼亚大学	University of Catania 
宋希斌	Song Xibin 
白谷建人	Kento Shiratani 
为爱而活	Live for love 
荷兰省份	Dutch provinces 
许美珍	Xu Meizhen 
agm-154联合战区外武器	Agm-154 Joint Out-of-Theater Weapons 
埃及第十八王朝	Eighteenth Dynasty of Egypt 
阿富汗卢比	Afghan Rupee 
马略卡王国	Kingdom of Mallorca 
国家宫_(蒙古国)	National Palace_(Mongolia) 
西方马克思主义	Western Marxism 
玛塔·路易斯公主	Princess Marta Louis 
与谢野馨	Xie Yexin 
fc检基	fc base 
智能电视	Smart TV 
任天堂3ds家族	Nintendo 3ds family 
巴滕堡王朝	Battenberg Dynasty 
d-pad	d-pad 
腓特烈·威廉_(布兰登堡)	Frederick William_ (Brandenburg) 
欧洲城市列表	List of European cities 
保顿艾尔宾足球俱乐部	Paulton Albin Football Club 
丹麦国防大臣	Danish Minister of Defense 
经济学学士	Bachelor of Economics 
红月_(神秘园专辑)	Red Moon_ (Secret Garden Album) 
革新运动	Innovation movement 
中天综合台	Zhongtian Comprehensive Station 
萨尔茨堡红牛足球俱乐部	Salzburg Red Bull Football Club 
台北市政府捷运工程局	Taipei City Government MRT Engineering Bureau 
大邱广域市	Daegu Metropolitan City 
西太平洋高级专员	High Commissioner for the Western Pacific 
中南财经政法大学	Zhongnan University of Economics and Law 
灰面鹫	Grey Faced Buzzard 
美国政府独立机构	United States Government Independent Agency 
民权西路站	Minquan West Road Station 
冈井千圣	Chisato Okai 
鸡冠刺桐	Cockscomb Erythrina 
保罗-亨利·夏尔·斯巴克	Paul-Henry Charles Spark 
深渊传奇	Legend of the Abyss 
连香树	Lianxiangshu 
沙巴拉拿	Sabalana 
王伟仁	Wang Weiren 
浪漫民族主义	Romantic nationalism 
第47届日本众议院议员总选举	The 47th General Election of the Japanese House of Representatives 
顿涅茨克国立科技大学	Donetsk State University of Technology 
熔点测定管	Melting point measuring tube 
玛丽公主_(告罗士打及爱丁堡公爵夫人)	Princess Mary_ (Gloucester and Duchess of Edinburgh) 
大分县旗	Flag of Oita Prefecture 
榊翔太	Shota Sakaki 
tbd唱片	tbd record 
后藤凉	Goto Ryo 
西班牙的玛丽亚·特里萨	Maria Theresa of Spain 
黄碧仁	Huang Biren 
胜利投手	Winning pitcher 
李小鹏_(政治人物)	Li Xiaopeng_(Politician) 
东西布朗_(英国国会选区)	East-West Brown_(British Parliamentary District) 
中文数字	Chinese numbers 
辰野町	Tatsuno Town 
王唯农	Wang Weinong 
教宗西尔维斯特一世	Pope Sylvester I 
梁启政	Liang Qizheng 
谢尔比维尔_(肯塔基州)	Shelbyville_ (Kentucky) 
天平宝字	Tianping Baozi 
古埃及	Ancient Egypt 
星球大战系列小说列表	List of Star Wars Novels 
三菱电机	Mitsubishi Electric 
藏心术	Hidden mind 
汉普郡学院	Hampshire College 
赵柯	Zhao Ke 
福井未菜	Fukui Mina 
公主嫁到	Princess married 
亚历山德拉王后	Queen Alexandra 
生活大爆炸_(第八季)	The Big Bang Theory_ (Season 8) 
安川有	Yaskawa 
孝肃皇后	Empress Xiaosu 
前3世纪	3rd century BC 
法兰西的伊莎贝拉	Isabella of France 
埃及总统列表	List of Presidents of Egypt 
交易成本	transaction cost 
封常清	Feng Changqing 
波兰议会	Polish Parliament 
雷斯威克条约	Treaty of Reswick 
2014年度yahoo!搜寻人气大奖得奖名单	2014 Yahoo! Search Popularity Award Winner List 
原始罗马尼亚语	Original Romanian 
银楼金粉	Silver House Gold Powder 
雷丁修道院	Reading Abbey 
美好的一天	good day 
玩具总动员4	Toy Story 4 
麦施文·韦伯·耶迪拿	Meschven Weber Yedina 
华沙圣约翰大教堂	St. John's Cathedral in Warsaw 
太田制作	Ota production 
傅尔曼大学	Fuhrman University 
球面反照率	Spherical albedo 
陈展安	Chen Zhanan 
克莱因-戈尔登方程	Klein-Golden equation 
陈俊明	Chen Junming 
黄志华(助理编导)	Huang Zhihua (Assistant Choreographer) 
森进一	Mori Shinichi 
细胞分裂系列	Cell division series 
平安里_(冈山区)	Pingan Lane_(Gangshan District) 
海军十字勋章	Navy Cross 
巴黎第十大学	Paris Tenth University 
薛其坤	Xue Qikun 
约旦第纳尔	Jordanian Dinar 
自我中心主义	Egocentric 
伊朗科技大学	Iran University of Science and Technology 
美国民主党总统候选人列表	List of Democratic Presidential Candidates 
五和里	Wuheli 
费拉拿球场	Ferrana Stadium 
斯洛伐克国家银行	National Bank of Slovakia 
李茂_(足球运动员)	Li Mao_ (football player) 
土耳其城市列表	List of cities in Turkey 
美人心计	Beauty scheming 
郑传义	Zheng Chuanyi 
玟贵妃	Concubine 
巴拉圭瓜拉尼	Paraguayan Guarani 
问题资产处理计划	Problem asset treatment plan 
里斯本竞技b	Sporting Lisbon b 
荷兰行政区划	Dutch administrative divisions 
吕西安·巴伯	Lucien Barber 
今井绘理子	Eriko Imai 
小野寺裕司	Yuji Onodera 
辛辛那提学院	Cincinnati College 
宇宙传奇	Universe legend 
图皮-瓜拉尼语支i	Tupi-Guarani branch i 
张简君伟	Zhang Jianjunwei 
葡属帝汶埃斯库多	Portuguese Timor Escudo 
1820年痛苦和刑罚草案	Draft of Pain and Penalty of 1820 
游戏机历史_(第六世代)	Game console history_ (sixth generation) 
水原大学	University of Suwon 
迪亚高施华	Diago Silva 
三重冕	Triple crown 
荷兰加勒比区	Dutch Caribbean 
西川优大	Nishikawa Yuda 
瑞士联邦院	Swiss Federal Council 
奥地利哈布斯堡王朝	Habsburgs of Austria 
萩奈穂美	Naomi Hagi 
德川家齐	Tokugawa Ieki 
冰岛财政部长	Minister of Finance of Iceland 
塔尔图大学	University of Tartu 
安顿韦迪	Anton Vidi 
占语字母	Cham 
澳洲气象局	Australian Bureau of Meteorology 
hangedup	hangedup 
分析心理学	Analytical psychology 
陆军大臣	Secretary of the Army 
doppelgangland	double gangland 
博阿尔内家族	Boarnet family 
陈-博特定理	Chen-Bo theorem 
巴斯克区徽	Basque Country Emblem 
婆媳谁怕谁	Who is afraid of mother-in-law? 
南梦宫万代游戏	Namco Bandai Games 
上田雅美	Masami Ueda 
萨德体育会	THAAD Sports Club 
社会活动家	Social activist 
涉谷飞翔	Shibuya Flying 
国家检察官学院	National Prosecutors College 
李相仑	Lee Sang Lun 
开尔文方程式	Kelvin equation 
副省会	Vice provincial capital 
比拉瓦尔·布托·扎尔达里	Vilavar Bhutto Zardari 
人民议会_(卢甘斯克人民共和国)	People's Assembly_ (Luhansk People's Republic) 
威尔斯国民议会	National Assembly of Wales 
荣信达影视	Rongxinda Television 
沙加系列	Shaka series 
爱尔兰下议院主席	Chairman of the Irish House of Commons 
潘宏昱	Pan Hongyu 
阿些斯奥体育会	Althus Olympic Games 
堀内信子	Nobuko Horiuchi 
美国陆军航空队	U.S. Army Air Force 
印度地区列表	India region list 
奇异博士	Doctor Strange 
梁健邦	Liang Jianbang 
赛扬汽车	Celeron 
chinsali	is not left 
农村经济学	Rural Economics 
鲁冷当	Lulendang 
category:法国王后	category:Queen of France 
lalchhuan_mawia	lalchhuan_ says 
杨柳青年画	Willow Youth Painting 
上海戏剧学院	Shanghai Theater Academy 
大埔运动场	Tai Po Sports Ground 
file:ou-logo-improved.png	file: ou-logo-improved.png 
万灵学院	Wan Ling College 
大谷光胜妻	Mitsukazu Otani 
识法代言人	Spokesperson 
笨蛋，测验，召唤兽	Idiot, quiz, summoned beast 
教宗维理	Pope Veri 
沙乌地阿拉伯行政区划	Administrative divisions of Saudi Arabia 
陆柏熹	Lu Baixi 
泰山区_(泰安市)	Taishan District_(Taian City) 
甲虫王者	Beetle King 
杉本有美	Yumi Sugimoto 
大西洋沿岸联盟最佳运动员	Best Athlete of the Atlantic Coast League 
科隆火车总站	Cologne Main Station 
鞑靼斯坦共和国国徽	National Emblem of the Republic of Tatarstan 
尼亚美	Niamey 
织田信雄	Oda Nobuo 
奥尔嘉·康斯坦丁诺芙娜_(希腊王后)	Olga Konstantinovna (Queen of Greece) 
丰田皇冠马杰斯塔	Toyota Crown Majesta 
英国统一	United Kingdom 
日本20岁以下国家足球队	Japan Under-20 National Football Team 
杨敬农	Yang Jingnong 
劳迪丝二世	Laudice II 
萨尔瓦多立法议会	Legislative Assembly of El Salvador 
突尼斯21岁以下国家足球队	Tunisia Under-21 National Football Team 
哥德堡大学	University of Gothenburg 
伊集院五郎	Ijuin Goro 
克罗地亚足球总会	Croatian Football Association 
安哥拉独立日	Angola Independence Day 
斯特鲁加茨基兄弟	The Strugatsky Brothers 
安迪·麦克唐纳_(政治人物)	Andy MacDonald_ (political figure) 
萩原佐代子	Sayoko Hagiwara 
许特根森林战役	Battle of Hütgen Forest 
赖明辉	Lai Minghui 
银翼杀手	Blade Runner 
2014年万千星辉颁奖典礼	2014 Thousand Thousand Stars Awards Ceremony 
东格拉斯哥_(英国国会选区)	East Glasgow_ (British Parliamentary Constituency) 
求爱365	Courtship 365 
北爱尔兰大臣	Minister of Northern Ireland 
utc+11	utc+11 
柏林联盟足球俱乐部	Berlin Union Football Club 
北京爱情故事_(2012年电视剧)	Beijing Love Story_ (2012 TV series) 
罗马尼亚王后列表	List of Queens of Romania 
涡轮螺旋桨发动机	Turboprop engine 
白象勋章	White Elephant Medal 
民主自由党	Democratic Liberal Party 
登录建筑	Login building 
庆愼公主	Princess Qingming 
路易吉王子_(两西西里)	Prince Luigi_ (Two Sicily) 
京广高速铁路	Beijing-Guangzhou High-speed Railway 
卡尔十一世	Karl XI 
施一公	Shi Yigong 
马来亚大学	University of Malaya 
国际城市博览会杯	International City Expo Cup 
约克的玛格丽特	Margaret of York 
拉达克山脉	Ladakh Mountains 
仓持明日香	Kuramochi Asuka 
我阿妈系黑玫瑰	My grandma is a black rose 
约尼域治	Johnny 
孝定太后	Queen Mother Xiaoding 
土广东话	Cantonese 
凉宫春日的忧郁	The Melancholy of Haruhi Suzumiya 
h是都m	h is all m 
肯塔基州国会议员	Kentucky Member of Congress 
马耳他大学	University of Malta 
莲花车队_(1954年)	Lotus Racing Team_ (1954) 
福田康夫内阁	Cabinet of Yasuo Fukuda 
太阳与你所描绘的story	The sun and your story 
黄升恺	Huang Shengkai 
魔域幻境系列	Magic Domain Fantasyland Series 
中正纪念堂站	Chiang Kai-shek Memorial Hall Station 
水岛精二	Seiji Mizushima 
宫下隼一	Miyashita Hayato 
皇家学会院士	Fellow of the Royal Society 
爱贝克思集团	ABEX Group 
阮氏定	Nguyen Thi Ding 
南关东	South Kanto 
墨西哥参议院	Mexican Senate 
巴哈伊信仰	Bahá'í Faith 
青衣东北公园	Tsing Yi Northeast Park 
培材大学	Peicai University 
ipade	meeting 
斐济元	Fijian Dollar 
塞米诺尔战争	Seminole War 
格域机场	Gatwick Airport 
美国第一夫人列表	List of first ladies of the United States 
竹敷要港部	Takeshiki Main Port 
清迈大学	Chiang Mai University 
亚历山大·亚历山德罗维奇大公	Grand Duke Alexander Alexandrovich 
巴西20岁以下国家足球队	Brazil Under-20 National Football Team 
唐桥侄子	Tang Qiao nephew 
今井智基	Imai Tomoki 
梁田清之	Liang Tianqingzhi 
朱家彤	Zhu Jiatong 
刘芷韵	Liu Zhiyun 
自然神论	Deism 
联合国宪章	United Nations Charter 
菲律宾副总统	Vice President of the Philippines 
普威尔国际	Prowell International 
李锦斌	Li Jinbin 
天一广场	Tianyi Square 
汤曜明	Tang Yaoming 
成城大学	Seijo University 
法国国家教育部	French National Ministry of Education 
亨利·佩蒂-菲茨莫里斯，第五代兰斯顿侯	Henry Petty-Fitzmorris, fifth generation Langston Hou 
国立台湾师范大学	National Taiwan Normal University 
汤玛斯·布鲁斯，第七代额尔金伯爵	Thomas Bruce, the seventh Earl of Erkin 
渡边绅	Senator Watanabe 
大希腊	Great Greece 
锦绣缘华丽冒险	Fairview Gorgeous Adventure 
森永太一郎	Taichiro Morinaga 
星无限娱乐	Star Unlimited Entertainment 
闪电十一人go	Inazuma Eleven go 
perica_marošević	perica marošević 
金钱崛起	Money rise 
法兰克福公墓	Frankfurt cemetery 
京师大学堂建筑遗存	Remains of the Capital University Hall 
自由职业运动员足球俱乐部	Freelance football club 
向罗马进军	March to Rome 
冷暖人间	Warm and cold world 
第60届奥斯卡金像奖	The 60th Academy Awards 
南斯拉夫人民军	People's Army of Yugoslavia 
扎达尔足球俱乐部	Zadar Football Club 
益安大君	Prince Ik'an 
西亚特altea	Seat altea 
美国国道	American National Highway 
simigon	simigon 
诺曼征服英格兰	Norman conquered England 
潘特雷蒙·波诺马连科	Pantremon Ponomarenko 
商业、创新和技能大臣	Minister of commerce, innovation and skills 
大日本帝国宪法	Constitution of the Empire of Japan 
英格兰皇家外科医学院	Royal College of Surgeons of England 
量子电动力学	Quantum electrodynamics 
布伦塔诺学派	Brentano School 
中华人民共和国境内地区邮政编码列表	List of Postal Codes in the People's Republic of China 
有乐町站	Yurakucho Station 
涅俄普托勒摩斯二世	Neoptolemos II 
布里亚特共和国国徽	National Emblem of the Republic of Buryatia 
维利拿	Velina 
增田顺一	Masuda Junichi 
波兰摇滚	Polish rock 
武里南联足球俱乐部	Buriram United Football Club 
牙买加银行	Bank of jamaica 
江户川乱步	Edogawa Ranbu 
马嘉尔语支	Magal 
李真	Li Zhen 
山玉成	Shan Yucheng 
拉脱维亚足球总会	Latvia Football Association 
北京时间	Beijing time 
有色人种	People of color 
海南民系	Hainanese 
影片编辑软体	Video editing software 
东巴里托语支	East Barito language branch 
福克兰群岛历史	History of the Falkland Islands 
艾奥瓦州众议院	Iowa House of Representatives 
玛丽亚·亚历山大罗夫娜女大公	Grand Duke Maria Alexandrovna 
.gt	.gt 
惇慈皇太妃	Donci Huang Duo 
纯贞孝皇后	Queen Pure Jeongxiao 
和铜	And copper 
九龙社团联会	Kowloon Federation of Societies 
雷纳托-达尔阿拉球场	Renato d'Alala Stadium 
幸福不二家	Happy Family 
罗伯特·克鲁-米尔恩斯，第一代克鲁侯爵	Robert Crewe-Milnes, the first Marquis of Crewe 
哥伦比亚总统	President of Colombia 
菊儿汗	Juerhan 
基辅大公	Grand Duke of Kiev 
巴吞鲁日_(路易斯安那州)	Baton Rouge_ (Louisiana) 
克里门汀橙太空船	Clementine Orange Spaceship 
比利时16岁以下国家足球队	Belgium Under-16 National Football Team 
纳塔尔总督	Governor of Natal 
克来蒙研究大学	Cremon Research University 
史丹福桥球场	Stamford Bridge Stadium 
联合国大会主席	President of the United Nations General Assembly 
海军陆战队	Marines 
诺贝尔生理学或医学奖	Nobel Prize in Physiology or Medicine 
蝙蝠女孩	Bat girl 
南斯拉夫国家足球队	Yugoslavia National Football Team 
西北英格兰	North West England 
加拿大总督列表	List of Governors of Canada 
天主教智利的圣地牙哥总教区	Santiago Archdiocese of Catholic Chile 
贵阳市奥林匹克体育中心	Guiyang Olympic Sports Center 
澳大利亚家庭事务部	Australian Department of Family Affairs 
流行朋克音乐	Pop punk music 
beikhokhei_beingaichho	Bei k ho k hei _ beingai c ho 
安道尔总委员会	Andorra General Council 
中央企业	Central enterprise 
海滩音乐	Beach music 
赖比瑞亚元	Liberia Dollar 
永恒唱片	Eternal Records 
廖亦崟	Liao Yiying 
奥赫热河	Ohre 
孙一凡	Sun Yifan 
大韩民国宪法	Constitution of the Republic of Korea 
砍杀游戏	Hack and slash game 
吕四娘_(电视剧)	Lu Siniang_(TV series) 
符号学	Semiotics 
大众传媒	Mass media 
卡夫真高	Kraft really high 
曼哈顿计画	Manhattan Project 
冈本かの子	Kaneko Okamoto 
尖子攻略	Top Raiders 
校园大学	Campus university 
无线电视	Wireless TV 
新界民政署	New Territories Civil Affairs Department 
滑板庞克	Skateboard punk 
结构理论	Structural theory 
你必须爱我	You must love me 
金东真	Kim Dongjin 
布里斯托战役	Battle of Bristol 
屈出律	Bend law 
中国共产党第八届中央委员会	The Eighth Central Committee of the Communist Party of China 
孙爱军	Sun Aijun 
塞维尔(挪威王子)	Seville (Prince of Norway) 
司马干	Sima Gan 
较大的市	Larger city 
黎显宗	Li Xianzong 
梅富根城战役	Battle of Mafgen City 
政治安全局	Political Security Bureau 
陈芷菁	Chen Zhijing 
冲绳群岛	Okinawa Islands 
摄政公园	Regent's Park 
寒川町	Samukawa Town 
莱昂大教堂	Leon Cathedral 
2011年女子世界杯足球赛	Women's World Cup 2011 
普里斯特菲尔德球场	Priestfield Stadium 
城户裕次	Yuji Shiroki 
第二次伊普尔战役	Second Battle of Ypres 
创作共用	Creative Commons 
柳贵博	Liu Guibo 
施沛任	Shi Peiren 
卡塔尔埃米尔	Emir of Qatar 
灵魂音乐	Soul music 
英格兰足球联赛系统	English Football League System 
波斯尼亚和黑塞哥维那可兑换马克	Bosnia and Herzegovina convertible mark 
辛辛那提法学院	Cincinnati Law School 
阮文和	Nguyen Van Ho 
爱德华·卢埃林_(英国政治顾问)	Edward Llewellyn_ (British Political Advisor) 
加泰罗尼亚人	Catalan 
宋光宗	Song Guangzong 
你笑了	you laughed 
马来西亚联邦授勋及嘉奖制度	Malaysian Federation Honors and Awards System 
即时通讯	Instant messaging 
日本高速公路	Japanese highway 
有肥人终成眷属	Fat people finally get married 
区委书记	District Party Secretary 
哈伯序列	Hubble sequence 
阿萨巴斯卡－埃雅克语族	Athabasca-Eyak 
华纳兄弟唱片	Warner Bros. Records 
冼海超	Xian Haichao 
芬兰参议院	Senate of Finland 
章仁香	Zhang Renxiang 
第一国务秘书	First secretary of state 
朱巴	Juba 
穆斯林兄弟会	Muslim Brotherhood 
吹波糖流行	Pop sugar pop 
罗伯特学院	Robert College 
石丸博也	Hiroya Ishimaru 
高永文	Gao Yongwen 
希腊国家女子足球队	Greece National Women's Football Team 
乌利华球场	Ulihua Stadium 
喀麦隆足球协会	Cameroon Football Association 
西雅图海湾者足球会_(1994-2008)	Seattle Bayers Football Club_(1994-2008) 
阿尔发音乐	Alfa Music 
福安话罗马字	Fu'an Romaji 
陈泓宇	Chen Hongyu 
保加利亚联盟	Bulgarian Union 
国际民主党联盟	International Democratic League 
乔·克拉克_(澳大利亚政治家)	Joe Clark_ (Australian politician) 
亚历山大大帝的征战	The Battle of Alexander the Great 
堪萨斯大学	University of Kansas 
千里达和多巴哥君主	Monarch of Trinidad and Tobago 
塞万努斯·塞耶尔奖	Cervanus Thayer Award 
当子内亲王	Prince of the Son 
荣誉服务奖	Honorary Service Award 
最终幻想ix	Final Fantasy ix 
雪山飞狐	Snow Mountain Flying Fox 
和历	Heli 
西九新动力	West Kowloon New Power 
独鲁万市	Tacloban City 
埃尔切足球俱乐部	Elche Football Club 
绿区_(名古屋市)	Midori Ward_(Nagoya City) 
就业及退休保障大臣	Minister of employment and retirement protection 
毒药乐团	Poison Orchestra 
卡米拉_(康沃尔公爵夫人)	Camilla (Duchess of Cornwall) 
月满抱佳人	Full moon hug a beautiful woman 
百田夏菜子	Momota Kanako 
洛泰尔_(西法兰克国王)	Lotaire (King of West Franconia) 
以色列足球协会	Israel Football Association 
碓井将大	Masahiro Usui 
托斯卡纳统治者列表	List of Tuscan rulers 
克拉约瓦	Craiova 
清太祖皇五女	Five Daughters of the Emperor Taizu of the Qing Dynasty 
维杰尔伯格球场	Vijelberg Stadium 
希腊20岁以下国家足球队	Greece Under-20 National Football Team 
杭州萧山国际机场	Hangzhou Xiaoshan International Airport 
东祥三	Toshozo 
清水县_(明尼苏达州)	Clearwater County_(Minnesota) 
百日皇朝	Hundred Days Dynasty 
古川雄辉	Furukawa Yuki 
神谷英树	Hideki Kamiya 
grombalia	grombalia 
有限承认国家列表	List of limited recognition countries 
进步党	Progressive Party 
意大利丙组联赛杯	Italy Group C League Cup 
轻型车	Light car 
德国三级方程式锦标赛	German Formula 3 Championship 
电子游戏史	History of video games 
大数假说	Large number hypothesis 
世间路	World road 
双璧传说	Legend of Shuangbi 
十日町市	Tokamachi City 
标致雪铁龙pf2平台	Peugeot Citroen pf2 platform 
环境光线感应器	Ambient light sensor 
在赌城醒来	Wake up in casino 
巴基斯坦外交部长	Minister of Foreign Affairs of Pakistan 
山梨县之歌	Song of Yamanashi Prefecture 
与谢野町	Yosano Town 
记得·我们有约	Remember·We have an appointment 
康沃利斯侯爵	Marquis of Cornwallis 
金贤_(足球运动员)	Kim Hyun_ (football player) 
前110年	110 years ago 
势力范围	Sphere of influence 
加冷河	Kallang River 
佳子内亲王	Princess Kako of Akishino 
埃斯拜的埃芒加德	Emangard of Espai 
大蒙古国	Greater Mongolia 
千岁市	Chitose City 
一条美贺子	Ichijo Mikako 
满－通古斯语族	Manchu-Tungusian 
nieuwegein	Nieuwegein 
西北叛乱	Northwest Rebellion 
圣保罗大学	Saint Paul University 
乍得-_利比亚冲突	Chad-Libya conflict 
涡轮轴引擎	Turboshaft engine 
阿特莱蒂·阿祖里球场	Atleti Azuri Stadium 
理发师合唱	Barber chorus 
美好年代	Belle Epoque 
薛顿贺尔大学法学院	Sherton Hall University School of Law 
黄晋发	Huang Jinfa 
gregoria	Gregorian 
青木良太	Ryota Aoki 
夏君璐	Xia Junlu 
f-15j战斗机	f-15j fighter 
菅谷梨沙子	Risako Sugaya 
少年四大名捕	Four famous young arrests 
皇家巴斯克语学院	Royal Basque School 
谢尼亚·亚历山德罗芙娜女大公	Grand Duke Xenia Alexandrovna 
田渕久美子	Kumiko Tabuchi 
柳田稔	Minoru Yanagida 
文字处理	Word processing 
皇家文艺学会	Royal Society of Arts 
春畑道哉	Michiya Haruhata 
牙买加总理	Prime Minister of Jamaica 
莫奇米林体育俱乐部	Mochi Milling Sports Club 
岱依语	Daiyi 
大卫·博伊尔，第七代格拉斯哥伯爵	David Boyle, 7th Earl of Glasgow 
阿尔巴尼亚甲组足球联赛	Albania First Division Football League 
沈阳体育学院体育场	Shenyang Sports University Stadium 
小米note顶配版	Mi Note top version 
有马新一	Arima Shinichi 
堪萨斯州立大学	Kansas State University 
西日本旅客铁道	West Japan Railway 
人和商业	People and business 
牛山镇_(东海县)	Niushan Town_(Donghai County) 
教宗玛策林	Pope Marcellin 
田树樟	Cinnamomum tiana 
桃园捷运	Taoyuan MRT 
威斯康星州州长	Governor of Wisconsin 
法兰克斯顿松树足球俱乐部	Frankston Pines Football Club 
北安普顿	Northampton 
平林良昭	Hirabayashi Ryoaki 
清水德川家	Shimizu Tokugawa House 
周乃翔	Zhou Naixiang 
法赫德·本·阿卜杜勒-阿齐兹·阿勒沙特	Fahd Bin Abdul-Aziz Al Shat 
殷美兰	Yin Meilan 
冼夫人	Mrs. Xian 
义大利天主教民主党秘书长	Secretary General of the Italian Catholic Democratic Party 
行署专员	Commissioner 
威尼斯足球俱乐部	Venice Football Club 
教会法	Canon law 
积水化学	Sekisui Chemical 
互补式金属氧化物半导体	Complementary metal oxide semiconductor 
伯明翰足球俱乐部	Birmingham Football Club 
我是歌手_(第二季)	I am a singer_ (season 2) 
竞速游戏	Racing game 
第比利斯国立大学	Tbilisi National University 
波斯王子：时之砂	Prince of Persia: Sands of Time 
门户乐团	Portal band 
戈尔甘	Gorgan 
奥罗莫分支	Oromo branch 
桌球天王	Snooker King 
陈刚_(中共贵阳市委书记)	Chen Gang_(Secretary of the Guiyang Municipal Committee of the Communist Party of China) 
十市皇女	Princess Tochi 
nazımiye	verse 
苏丹希沙姆汀阿南沙	Sultan Hishamuddin Anansha 
内阁府特命担当大臣（原子能损害赔偿支援机构担当）	Minister in charge of the Cabinet Office (in charge of the Atomic Energy Damage Compensation Support Organization) 
医师好辣	The doctor is so spicy 
共和国议会宫	Parliament Palace of the Republic 
阿拉伯国家联盟	League of Arab States 
阿曼足球协会	Oman Football Association 
都市方程式	Urban formula 
纪皇女	Emperor Ji 
菲律宾披索	Philippine Peso 
进阶音讯编码	Advanced audio coding 
民族保守主义	National conservatism 
清太祖皇七女	Seventh Daughter of the Emperor Taizu of the Qing Dynasty 
陕西渭南信达篮球俱乐部	Shaanxi Weinan Xinda Basketball Club 
牛津大学基督圣体学院	University of Oxford College of the Eucharist 
szigetvar	szigetvar 
得梅因河	Des Moines 
沙·贾汗三世	Shah Jahan III 
高卢雄鸡	Gallic rooster 
和硕端静公主	Princess He Shuo Duan Jing 
丹麦行政区划	Administrative divisions of Denmark 
秘鲁体育大学	Peru Sports University 
社会民主连线	Social Democracy Connection 
社东里	Shedongli 
沈阳飞机工业集团	Shenyang Aircraft Industry Group 
埃以消耗战争	Egypt-Israel War 
贞爱亲王妃利子女王	Princess of Love, Princess Lizi 
世界旅游组织	World Tourism Organization 
贾天子	Jia Tianzi 
传播媒体	media 
金门女	Golden Gate Girl 
冶天科技	Yetian Technology 
斯洛维尼亚摇滚	Slovenian Rock 
奥斯曼帝国的崛起	The rise of the Ottoman Empire 
李玉琴	Li Yuqin 
李东明	Li Dongming 
美国总统列表	List of Presidents of the United States 
林迈可	Lin Mike 
海顿天象馆	Haydn Planetarium 
列特体育会	Leit Sports Club 
.eu	.I 
乔治城大学法律中心	Georgetown University Law Center 
帕多瓦足球俱乐部	Padova Football Club 
包惜弱	Bao Xiwei 
传闻中的七公主	The rumored seven princesses 
藤尾正行	Masayuki Fujio 
佳子女王	Queen Kako 
格斗游戏	Fighting games 
剩女保镖	Leftover female bodyguard 
基督教左派	Christian Left 
大学公园市	University Park City 
我相信_(张靓颖专辑)	I Believe_(Zhang Jingying Album) 
冯燊明	Feng Shenming 
汉特-曼西自治区区徽	Khanty-Mansi Autonomous Region Emblem 
河合龙二	Kawai Ryuji 
金致坤	Jin Zhikun 
丁进成	Ding Jincheng 
阿姆斯特丹中央车站	Amsterdam Central Station 
梅州五华	Meizhou Wuhua 
2016年亚足联冠军联赛	2016 AFC Champions League 
日热科夫足球俱乐部	Zhizhekov Football Club 
台湾民间信仰	Taiwanese folk beliefs 
空气调节	Air conditioning 
南港车站	Nangang Station 
远东山雀	Far Eastern Tit 
久世公尧	Jiushi Gongyao 
运行时系统	Runtime system 
南昌奥体中心	Nanchang Olympic Sports Center 
恶灵骑士	Ghost Rider 
td花园	td garden 
挪威银行	Norwegian Bank 
加州女孩	California girl 
斯拉文贝鲁波足球俱乐部	Slavin Belupo Football Club 
瓦斯卢伊足球俱乐部	Vaslui Football Club 
德国联邦卫生部	German Federal Ministry of Health 
栗潜心	Li Qianxin 
沙乌地阿拉伯皇家空军	Royal Saudi Air Force 
gala汤泽车站	gala Yuzawa station 
雷州民系	Leizhou ethnic group 
惠提尔学院	Whittier College 
岳阳楼区	Yueyang Tower District 
加拿大英语	Canadian English 
人民院领袖	Leader of the People's House 
格鲁吉亚总统	President of Georgia 
广播大厦	Broadcasting Building 
国民大学	Kookmin University 
软件开发工具包	Software Development Kit 
巴黎第一大学	Paris First University 
川辺骏	Kawabe Hayao 
普斯卡什球场	Puskas Stadium 
叙利亚陆军	Syrian Army 
于家堡站	Yujiapu Station 
香港榄球代表队	Hong Kong Rugby Team 
加拿大保守党	Conservative Party of Canada 
视觉系	Visual kei 
马来西亚国庆日	Malaysia National Day 
阿尔伯塔大学	University of Alberta 
松江南京站	Songjiang Nanjing Railway Station 
黄莉新	Huang Lixin 
花山天皇	Emperor Hanayama 
文昭甄皇后	Empress Wen Zhaozhen 
klaha	klaha 
海军机械军士长	Naval mechanical sergeant 
2005年世界博览会	2005 World Expo 
大连市市长列表	List of mayors of Dalian 
申成禄	Shen Chenglu 
卡尔马联合	Kalmar Union 
刘之媛	Liu Zhiyuan 
欧洲超级杯	European Super Cup 
王任重	Wang Renzhong 
能源及气候变化大臣	Minister of energy and climate change 
峡谷地国家公园	Canyonlands National Park 
福本尚纯	Fukumoto Sho Jun 
有你终身美丽	Have you beautiful for life 
俄亥俄州县列表	List of Ohio counties 
马自达626	Mazda 626 
德川明子	Tokugawa Akiko 
纽卡斯尔_(新南威尔士州)	Newcastle_(New South Wales) 
巴西人足球俱乐部	Brazilian Football Club 
上海电影集团公司	Shanghai Film Group Corporation 
香港特别行政区区徽	Hong Kong Special Administrative Region Regional Emblem 
前235年	235 years ago 
马赫原理	Mach principle 
法国共产主义学生联盟	French Communist Student Union 
原来是美男	You're Beautiful 
卡加延河谷	Cagayan Valley 
蒙哥马利公墓	Montgomery Cemetery 
大阪府知事列表	List of Governors of Osaka Prefecture 
永井龙	Nagai Dragon 
孟加拉国家足球队	Bangladesh National Football Team 
西南赛区	Southwest Division 
巴基斯坦君主	Monarch of pakistan 
珊瑚海群岛	Coral Sea Islands 
康尼·马克三世	Connie Mark III 
高魁元	Kao Kueiyuan 
曹智雄	Cao Zhixiong 
咸宁公主	Princess Xianning 
刘品言	Liu Pinyan 
believe/乌云散去，天气晴	believe/The clouds are gone, the weather is sunny 
北京大学红楼	Peking University Red House 
阿尔勒-阿维尼翁田径俱乐部	Arles-Avignon Athletic Club 
日本元帅	Japanese Marshal 
张庆翔	Zhang Qingxiang 
利默里克大学	University of Limerick 
德川寿千代	Tokugawa Tokuchiyo 
台风战斗机	Typhoon Fighter 
罗马尼亚自由民主党	Romanian Liberal Democratic Party 
埃普瑟姆和尤厄尔_(英国国会选区)	Epsom and Ewell_ (British Parliamentary District) 
谭天乐	Tan Tianle 
捷克共和国议会众议院	House of Representatives of the Parliament of the Czech Republic 
安和	Anhe 
共产主义青年联盟_(罗马尼亚)	Communist Youth League_ (Romania) 
工人阶级解放斗争协会	Working Class Liberation Struggle Association 
数据压缩	data compression 
康威·伯纳斯-李	Conway Berners-Lee 
禾拿	Herna 
湖南杨开慧烈士陵园	Yang Kaihui Martyrs Cemetery, Hunan 
黄镇_(政治人物)	Huang Zhen_(Politician) 
wikt:广东	wikt: Guangdong 
迎红杜鹃	Azalea 
东映公司	Toei 
德国联邦环境、自然保育及核能安全部	German Federal Ministry of Environment, Nature Conservation and Nuclear Energy Safety 
和硕柔嘉公主	Princess and princess 
比利时18岁以下国家足球队	Belgium Under-18 National Football Team 
应用程序接口	Application program interface 
东柏柏尔语支	East Berber 
郑震浩	Zheng Zhenhao 
国际货币基金组织	International Monetary Fund 
北川航也	Koya Kitagawa 
费尔南多王子（西班牙）	Prince Fernando (Spain) 
国立大学足球俱乐部	National University Football Club 
磁带合成器	Tape synthesizer 
美斯·芬格	Mess Finger 
克罗地亚20岁以下国家足球队	Croatian Under-20 National Football Team 
王三运	Wang Sanyun 
超级军旗攻击机	Super Military Standard Attack Aircraft 
青木哲朗	Tetsuro Aoki 
华中方面军	Central China Front 
刘裕猷	Liu Yuyou 
我的少女时代	My girlhood 
西京极综合运动	Xijingji Comprehensive Sports 
拿破仑五世	Napoleon V 
knjaževac	knjaževac 
台北车站_(桃园捷运)	Taipei Main Station_(Taoyuan MRT) 
丹麦自治市	Danish municipalities 
サポーター（supporter）	Supporter 
赵素桂	Zhao Sugui 
卡路士·比蒙迪球场	Carlos Bimondi Stadium 
大学体育场	University Stadium 
美国足球年度最佳运动员	American Football Player of the Year 
格奈乌斯·科尼利厄斯·雷恩图卢斯·马赛立那	Gnaeus Cornelius Rentulus Marcelina 
曼德博集合	Mandelbrot Collection 
地名资讯管理系统	Place Name Information Management System 
赵俊浩	Zhao Junhao 
e!	is! 
中华人民共和国人民警察	People's Police of the People's Republic of China 
约翰·厄斯金，第二十二代马尔伯爵	John Erskine, 22nd Earl of Mar 
圣尼阁老教堂_(根特)	Saint Niguel Old Church_(Ghent) 
教宗西玛克	Pope Simak 
上市町	Kamicho 
保禄四世	Paul IV 
张润镐	Zhang Runhao 
社会公益奖章	Social Service Medal 
空灵柩	Empty coffin 
罗斯、斯凯和洛哈伯_(英国国会选区)	Ross, Skye and Lochaber_ (UK Parliamentary District) 
哥伦比亚摇滚	Colombian Rock 
交响乐摇滚	Symphony Rock 
谢深山	Xie Shenshan 
第五辑	Fifth series 
jedburgh	jedburgh 
薗田淳	Jun Sonoda 
张文岳	Zhang Wenyue 
七姐妹学院	Seven Sisters College 
吕西安·布沙尔	Lucien Bouchard 
圣诞入侵	Christmas invasion 
李琬	Li Wan 
邓伟根	Deng Weigen 
金刚战士:zeo	King Kong Warrior: zeo 
windows相片检视器	windows photo viewer 
中国共产党中央委员会副主席	Vice Chairman of the Central Committee of the Communist Party of China 
石井健太	Kenta Ishii 
争取一体化社会主义运动	Movement for integrated socialism 
蒙古人民共和国部长会议主席	Chairman of the Council of Ministers of the Mongolian People's Republic 
红白埃森足球俱乐部	Red and White Essen Football Club 
全国保守党会议	National Conservative Party Conference 
毛荣楷	Mao Rongkai 
留基伯	Rukibe 
圣西蒙及裘德堂	St. Simon and Jude Church 
维堡-彼得罗扎沃茨克攻势	Vyborg-Petrozavodsk offensive 
魔法人力派遣公司	Magic manpower dispatch company 
八重山语	Yaeyama 
只见町	Tadamimachi 
国家邮政局	State Post Office 
厚生劳动大臣	Minister of Health, Labour and Welfare 
裴克廉	Pekelian 
中国中央电视台财经频道	China Central Television Finance Channel 
石锦航	Shi Jinhang 
iq博士	Dr. iq 
土库曼独立日	Turkmenistan Independence Day 
18岁的约定	18 year old promise 
中华人民共和国国防部部长	Minister of National Defense of the People's Republic of China 
下诹访町	Shimosuwa Town 
迦纳塞地	Ghana Cedi 
高皇后_(北魏孝武帝)	Queen Gao_ (Emperor Xiaowu of the Northern Wei Dynasty) 
unrealscript	unrealscript 
佐藤健一	Kenichi Sato 
刘菘	Liu Song 
石原良纯	Yoshizumi Ishihara 
迦南诸语	Canaanite languages 
王兴尉	Wang Xingwei 
尹周熙	Yoon Zhouxi 
一条良子	Yoshiko Ichijo 
鼓打贝斯历史	Drumming bass history 
空降部队	Airborne troops 
栉引政敏	Kushiyuki Masatoshi 
蜘蛛怪咖	Spider freak 
at&t体育场	at&t stadium 
吴承恩	Wu Chengen 
南中部	South Central 
北美地区	North America 
垂水藤太	Touta Tarumi 
高芳先	Gao Fangxian 
山东里	Shandong Li 
憬纬企业	Jingwei Enterprise 
美国南北战争	American Civil War 
比赫积	Bih product 
郝尔拜奖	Holby Award 
京都市交通局	Kyoto Municipal Transportation Bureau 
三和里	Sanwa ri 
大连航空	Dalian Airlines 
神圣罗马皇帝	Holy Roman Emperor 
明俊在	Ming Jun is 
德国十字勋章	German Cross 
日本电视剧	Japanese TV series 
澎湖海战	Battle of Penghu 
路易·德·博普瓦尔，圣欧莱尔伯爵	Louis de Beaupvar, Count of Saint-Eulaire 
甘马高	Camargue 
诺瓦托_(加利福尼亚州)	Novato_ (California) 
联邦国民议会	Federal National Assembly 
真理坚固	The truth is firm 
file:《咸丰皇帝朝服像》.jpg	file: "Portrait of Emperor Xianfeng's Court Clothes".jpg 
华氏温标	Fahrenheit temperature scale 
赵治治	Zhao Zhizhi 
王东洲	Wang Dongzhou 
巴西摇滚	Brazilian rock 
广岛县旗	Hiroshima Prefecture Flag 
广福里_(旗山区)	Guangfuli_(Qishan District) 
加舒安	Gassuan 
爱杀宝贝	Love to kill baby 
兼六园	Kenrokuen 
亲爱的，我爱上别人了	Honey, i'm in love with someone 
东平尾公园博多陆上竞技场	Higashihiro Park Hakata Land Arena 
赤木良次	Ryoji Akagi 
哈密尔顿_(百慕大)	Hamilton_(Bermuda) 
微内核	Microkernel 
黄龙体育场	Huanglong Stadium 
幕后大老爷	Master behind the scenes 
潘文璘	Pan Wenlin 
路易斯·德·吉尔_(1818年－1896年)	Louis de Gil_ (1818-1896) 
挪威政府首脑列表	List of heads of government of Norway 
前16世纪	16th century BC 
詹郎二氏情绪理论	Zhan Lang's Emotion Theory 
中华民国立法委员选举	Election of legislators of the Republic of China 
希腊19岁以下国家足球队	Greece Under-19 National Football Team 
故乡兵库	Hometown Hyogo 
藤原飞吕	Fujiwara Hiro 
邦芳王	King Bangfang 
拉脱维亚总统	President of Latvia 
牙买加国家足球队	Jamaica National Football Team 
京田边市	Kyotanabe City 
斯特拉斯克莱德国王列表	List of King Strathclyde 
约旦国王	King of Jordan 
长荣国际储运	Evergreen International Storage and Transportation 
东雷丁_(英国国会选区)	East Reading_ (British Parliamentary Constituency) 
上原正三	Uehara Masazo 
靴尔福特联足球俱乐部	Sulford United Football Club 
正红色	Positive red 
刘贵珍	Liu Guizhen 
郭妃丽	Guo Feili 
维拉克斯占领	Occupation by Velax 
普莱德公园球场	Pride Park Stadium 
名越埝洋	Mingyue Nianyang 
小米太亚德	Mi Tai Yade 
南阿拉伯字母	South Arabic alphabet 
德国第4装甲军团	German 4th Armored Corps 
科特迪瓦足球协会	Cote d'Ivoire Football Association 
埃甲足球乙级联赛	Ethiopian Football League Two 
福特汽车	Ford 
朝鲜总理列表	List of North Korean Prime Ministers 
金日成体育场	Kim Il Sung Stadium 
拿破仑六世	Napoleon VI 
丕平一世_(阿基坦)	Piping I_ (Aquitaine) 
世界正美丽	The world is beautiful 
联合国常务副秘书长	Deputy Secretary-General of the United Nations 
苏联国防委员会	Soviet Defense Council 
奇科_(加利福尼亚州)	Chico_ (California) 
塔巴-采卡区	Taba-Ceka District 
哥德复兴式建筑	Gothic Revival Architecture 
警察部队成就勋章	Police Achievement Medal 
松平康直	Matsudaira Yasunao 
新屋区	Xinwu District 
汤玛斯·罗宾逊，第二代格兰瑟姆男爵	Thomas Robinson, second generation Baron Grantham 
500欧元纸币	500 euro banknotes 
大叙利亚	Greater Syria 
于仁泰	Yu Rentai 
图拉兵工厂	Tula Arsenal 
德川糸子	Tokugawa Shiko 
葡萄牙足球总会	Portuguese Football Association 
裴乐士	Peles 
香港历史博物馆	Hong Kong Museum of History 
渡部博文	Hirofumi Watanabe 
玛利亚·约瑟法_(奥地利女大公)	Maria Josepha_ (Grand Duke of Austria) 
台湾银行券	Taiwan Bank Notes 
电机工程	Electrical Engineering 
缪拉家族	Murat family 
吉他英雄	Guitar hero 
zapopan	zapopan 
地方政府委员会主席	Chairman of Local Government Committee 
象山影视城	Xiangshan Film and Television City 
王刚_(政治人物)	Wang Gang_(Politician) 
黑暗奇幻	Dark fantasy 
南非党	South African Party 
地面固定波	Ground fixed wave 
中国共产党第十五次全国代表大会	The 15th National Congress of the Communist Party of China 
陈玉珊	Chen Yushan 
jean-paul_brasselet	jean-paul_brasselet 
全明星中队	All-Star Squadron 
柏林网球会	Berlin Tennis Club 
王光豪	Wang Guanghao 
宇野治	Osamu Uno 
新古典经济学派	Neoclassical economics 
伟士兰海王直升机	Weissland Sea King Helicopter 
超越时代	Beyond the era 
法蒂玛王后	Queen Fatima 
长老教会	Presbyterian church 
堀口悠纪子	Yukiko Horiguchi 
曾汉	Zeng Han 
杭州安格足球俱乐部	Hangzhou Ange Football Club 
中共国务院党组	Party Group of the State Council of the Communist Party of China 
亚拉巴马州州长	Governor of Alabama 
韩国足球协会	Korea Football Association 
中共中央直属机构	Institutions directly under the CPC Central Committee 
伊莎贝拉一世_(卡斯蒂利亚)	Isabella I_ (Castile) 
sasktel	sasktel 
律政司司长官邸	Secretary of Justice's Residence 
南非共和国储备银行	Reserve Bank of the Republic of South Africa 
让-雅克·雷吉斯·德·冈巴塞雷斯	Jean-Jacques Regis de Gombaceres 
.pe	.on 
越南电话区号	Vietnam telephone area code 
美洲足球俱乐部_(圣保罗州)	American Football Club_ (Sao Paulo State) 
家猪	Domestic pig 
背风群岛	Leeward Islands 
朝鲜人民军陆军	Korean People's Army Army 
安田显	Yasuda Akira 
男人当家	Man headed 
塞尔维亚帝国	Serbian Empire 
苏格兰足球代表乙队	Scottish Football Team B 
游戏设计师	game designer 
德国纸马克	German paper mark 
巴基斯坦国会议长	Speaker of the National Assembly of Pakistan 
岛根县旗	Shimane Prefecture Flag 
苏格兰国歌	Scottish National Anthem 
韩芝俊	Han Zhijun 
灵幻小子	Phantom kid 
让-弗朗索瓦·利奥塔	Jean-François Liotta 
德国的共产党	Communist Party of Germany 
联合直接攻击弹药	Joint direct attack ammunition 
军队总检阅官	General inspector of the army 
陈佳慧	Chen Jiahui 
程连元	Cheng Lianyuan 
库克郡政府	Cook County Government 
庇护五世	Pius V 
本丢·彼拉多	Pontius Pilate 
玛丽·费尔曼-托马斯，威灵东侯爵夫人	Mary Fairman-Thomas, Marquise of Wellingdon 
印度尼西亚外交部长	Minister of Foreign Affairs of Indonesia 
白色巨塔_(2006年电视剧)	The White Tower_ (2006 TV series) 
安南保护国	Annan Protectorate 
黑田直陈	Kuroda Naochen 
英格兰足球议会联赛杯	English Football League Cup 
户岛章	Toshima Akira 
东北保安总司令	Commander-in-chief of northeast security 
科克城足球俱乐部	Cork City Football Club 
寮国内战	Lao Civil War 
肯尼亚先令	Kenyan Shilling 
崔相炫	Choi Sang Hyun 
curren$y	curren $ y 
前川淳	Atsushi Maekawa 
卡尔顿学院	Carleton College 
邓兆尊	Deng Zhaozun 
台湾积体电路制造公司	Taiwan Semiconductor Manufacturing Company 
亨利二世	Henry II 
嵌入式系统	Embedded Systems 
碧红里	Bihongli 
加拉加斯足球俱乐部	Caracas Football Club 
老挝总理	Prime Minister of Laos 
超级星光大道_(第四届)	Super Avenue of Stars_ (4th) 
边峻范	Bian Junfan 
集宁师范学校	Jining Normal School 
捷豹车队	Jaguar Racing 
海湾省_(巴布亚纽几内亚)	Gulf Province_(Papua New Guinea) 
苏达球场	Sudar Stadium 
赖中美	Lai Zhongmei 
松平政隆	Masataka Matsudaira 
佛罗里达礁岛群	Florida Keys 
阿卜杜勒-卡里姆·卡塞姆	Abdul-Karim Kasem 
科技传播学	Science and Technology Communication 
邓小巧	Deng Xiaoqiao 
琉球君主列表	List of Ryukyu monarchs 
临时立法会	Provisional Legislative Council 
洛桑联邦理工学院	Federal Institute of Technology Lausanne 
以赛亚·汤玛斯	Isaiah Thomas 
埃尔多拉多镇区_(巴特勒县)	Eldorado Township_(Butler County) 
昭和村_(群马县)	Showa Village_ (Gunma Prefecture) 
翡翠台电视剧集列表_(2009年)	Jade TV series list_(2009) 
议行合一	Harmony 
国家服务总监	National Service Director 
金日成社会主义青年同盟	Kim Il Sung Socialist Youth League 
爱尔兰参议院	Senate of Ireland 
古桥一浩	Furuhashi Kazuhiro 
让·佛朗科伊斯·吉列	Jean Francois Gillette 
刘厝里	Liucuoli 
日本军用手票	Japanese military ticket 
育碧红色风暴	Ubisoft Red Storm 
移魂大法	Soul Transfer Dafa 
东帝汶总统	President of East Timor 
罗马执政官列表	List of Archons of Rome 
日野康子	Yasuko Hino 
绝不认输	Never admit defeat 
巴西南部	Southern Brazil 
罕穆扎	Hammuza 
鲁弗斯·艾萨克，第一代莱丁侯爵	Rufus Isaac, the first Marquis of Reading 
弗里德里希_(萨克森-阿尔滕堡)	Friedrich_(Saxony-Altenburg) 
威廉二世_(符腾堡)	William II_ (Wuerttemberg) 
维托里奥·阿梅迪奥二世	Vittorio Amedio II 
外务大臣	Minister of Foreign Affairs 
万隆工程学院	Bandung Institute of Engineering 
开尔文滴水起电机	Kelvin dripping motor 
哥谭奖	Gotham Award 
超级英雄	Super hero 
seongnam足球会	seongnam football club 
民主党_(1955年韩国)	Democratic Party_ (South Korea in 1955) 
中央人民广播电台	People's Central Broadcasting Station 
newlisp	newlisp 
欧洲蓝调	European Blues 
切沃足球俱乐部	Chievo Football Club 
香港迪士尼乐园度假区	Hong Kong Disneyland Resort 
奥斯汀马刺	Austin Spurs 
英属印度陆军	British Indian Army 
魔法家族	Magic family 
哥德时尚	Goth fashion 
美国职棒大联盟胜投王	Major League Baseball winning vote 
正一位	Positive one 
伊斯兰民主	Islamic democracy 
南港展览馆站	Nangang Exhibition Center Station 
黑田长兴	Kuroda Changxing 
清水建设	Shimizu Construction 
朝鲜民主主义人民共和国主席	Chairman of the Democratic People's Republic of Korea 
荣亲王	Prince Rong 
佛山话	Foshan dialect 
代代木站	Yoyogi Station 
庄社理	Zhuang Sheli 
台北市立第一女子高级中学	Taipei No.1 Girls High School 
邱吉尔兄弟体育俱乐部	Churchill Brothers Sports Club 
标明类型系统	Type system 
.sc	.sc 
黑田家谱	Kuroda Family Tree 
伏尔加格勒足球俱乐部	Volgograd Football Club 
小普林尼	Pliny the Little 
中国广播电影电视节目交易中心	China Radio, Film and Television Program Trading Center 
刘松藩	Liu Songfan 
天狼星xm卫星广播	Sirius xm satellite radio 
厄尔士山脉奥厄足球会	Oare Football Club 
黄长兴	Huang Changxing 
越南空军	Vietnam Air Force 
荒凉山庄	Desolate Villa 
爱伯佛勒_(斯特灵)	Albert Fowler_ (Stirling) 
bs-tbs	bs-tbs 
纽西兰国家党	New Zealand National Party 
鼠鲨目	Squirrel 
5美元纸币	5 dollars banknotes 
松本山雅足球会	Matsumoto Yamaga Football Club 
三硝基甲苯	Trinitrotoluene 
镇安大君	King Zhen'an 
查尔斯·阿弗烈·克里普斯，第一代帕穆尔男爵	Charles Afred Krips, the first Baron Pamur 
东京工业大学	Tokyo Institute of Technology 
正田巌	Iwao Shoda 
黄禾音乐工作室	Huanghe Music Studio 
塞尔维亚进步党	Serbian Progressive Party 
博茨瓦纳宗教	Religion in Botswana 
深圳世界大学生运动会体育中心	Shenzhen Universiade Sports Center 
阿图瓦的夏尔·费迪南德	Charles Ferdinand of Artois 
河南东方足球俱乐部	Henan Oriental Football Club 
特里亚农条约	Trianon Treaty 
企业挤压	Enterprise Squeeze 
安波罗修共和国	Ambrosian Republic 
小b大任务	Small b big task 
露琪娅公主_(两西西里)	Princess Lucia_(Two Sicily) 
段献忠	Duan Xianzhong 
博迪贺路球场	Bodhi Road Stadium 
丽江体育发展中心体育场	Lijiang Sports Development Center Stadium 
天主教塔坎巴罗教区	Catholic Diocese of Cambaro 
密西根州大学	University of Michigan 
阿根廷国民议会	National Assembly of Argentina 
日本电气	NEC 
米尔顿凯恩斯东北_(英国国会选区)	Milton Keynes Northeast_(British Parliamentary District) 
乌普顿公园球场	Upton Park Stadium 
阿尔比恩流浪足球会	Albion Wanderers Football Club 
八大戏剧台	Eight drama stations 
一柳梦吾	Yiliu Menggo 
大来皇女	Princess Oku 
哈萨克独立日	Kazakh Independence Day 
江世俊	Jiang Shijun 
中国总理	Premier of China 
孙文龙	Sun Wenlong 
越南独立同盟会	Vietnam Independence League 
阿拉伯之春	Arab Spring 
榛睡鼠	Dormouse 
太康公主_(明孝宗)	Princess Taikang_(Ming Xiaozong) 
昌吉回族自治州	Changji Hui Autonomous Prefecture 
东方设计学院	Oriental Design Institute 
铃木望	Suzuki Wang 
佩德罗_(巴西帝国皇子)	Pedro_ (Prince of the Brazilian Empire) 
日本标准时间	Japan Standard Time 
电子游戏机历史_(第七世代)	History of electronic game consoles_ (seventh generation) 
弗雷德里克·阿道夫王子	Prince Frederick Adolf 
同事三分亲	Co-workers 
香草航空	Vanilla Air 
鲁尔包围战	Siege of Ruhr 
gosu	gosu 
古典哲学	Classical philosophy 
csi犯罪现场	csi crime scene 
前375年	375 years ago 
尼泊尔立法议会	Nepal Legislative Assembly 
哈尔滨工业大学	Harbin Institute of Technology 
蛤蟆仙人图	Toad fairy figure 
泰国君主列表	List of Thai monarchs 
新发田市	Shibata City 
教育哲学	Educational philosophy 
反斯大林主义左翼	Anti-Stalinist left 
椙山浩一	Koichi Sugiyama 
台湾汉字	Taiwanese Chinese Characters 
全基成	Jeon Ki Sung 
德涅斯特河沿岸卢布	Ruble along the Transnistria 
真爱如血_(第一季)	True Love is Blood_ (Season One) 
陆天华	Lu Tianhua 
file:bowdoin-wordmark.jpg	file:bowdoin-wordmark.jpg 
南斯拉夫共产主义者联盟	Union of Communists of Yugoslavia 
长株潭小片	Changzhutan small piece 
和谐号crh2型电力动车组	Harmony crh2 electric train set 
中国人民解放军军衔	Ranks of the Chinese People's Liberation Army 
闽中语	Minzhong 
玛丽亚·阿侬奇娅塔公主_(两西西里)	Princess Maria Anunchiata_ (Two Sicily) 
数据科学	Data science 
不丹努尔特鲁姆	Nurtrum, Bhutan 
文部科学大臣	Minister of Education, Culture, Sports, Science and Technology 
朱利安·阿斯奎斯，第二代牛津及阿斯奎斯伯爵	Julian Asquith, second generation Earl of Oxford and Asquith 
罗淑蕾	Luo Shulei 
王子变青蛙	The prince turns into a frog 
布里斯本中央商业区	Brisbane Central Business District 
乔治·华盛顿大学	George Washington University 
朱世珍	Zhu Shizhen 
孙元一	Sun Yuanyi 
森永太平	Morinaga Taihei 
数学分析	Mathematical analysis 
保育运动	Conservation movement 
户冢忠春	Totsuka Tadaharu 
山谷惠里子	Valley eriko 
前17世纪	BC 
黑豹_人中之龙新章	Black Panther_A New Chapter of the Dragon in Man 
李杰翔	Li Jiexiang 
劳资关系、教育和就业部长	Minister of labor relations, education and employment 
稻美町	Inami Town 
绿区_(埼玉市)	Midori Ward_ (Saitama City) 
系统平台	System platform 
nba灌篮大赛冠军	nba slam dunk contest champion 
波兰社会党	Polish Socialist Party 
福冈县旗	Flag of Fukuoka Prefecture 
phi相关系数	phi correlation coefficient 
山岳标准时间	Mountain Standard Time 
三级方程式赛车	Formula Three 
巴西独立战争	Brazilian War of Independence 
梁少华	Liang Shaohua 
道格拉斯_(马恩岛)	Douglas_ (Isle of Man) 
百合花饰	Lily flower decoration 
矢野乔子	Yano Kyoko 
穆罕默德-礼萨·马赫达维·卡尼	Mohamed-Reza Mahdavi Kani 
\ufeff朱世玉	\ufeffZhu Shiyu 
m._thambidurai	ம்._தம்பிதுரை 
朝鲜劳动党第一书记	First Secretary of the Workers' Party of Korea 
metoffice	metoffice 
美国职棒大联盟防御率王	Major League Baseball defense rate leader 
水谷元	Gen Mizutani 
美国政府	American government 
komis	commission 
死亡厄运金属	Death doom metal 
萧小燕	Xiao Xiaoyan 
克里斯蒂安四世	Christian IV 
美国音乐协会	American Music Association 
后卫（足球）	Defender (football) 
中国人民解放军战略支援部队	Chinese People's Liberation Army Strategic Support Force 
参宿七号修理舰_(ar-11)	Samuel VII Repair Ship_(ar-11) 
阿部翔平	Shohei Abe 
南梦宫万代发展	Namco Bandai Development 
英国邮政区号	United Kingdom Postal Code 
巴基斯坦议会	Parliament of pakistan 
田纳西州陆军第三兵团	Tennessee Army Third Corps 
kbs第2频道	kbs channel 2 
自由民主党	Liberal Democratic Party 
新西兰总督	Governor of New Zealand 
威尔明顿_(特拉华州)	Wilmington_ (Delaware) 
纳吉普足球俱乐部	Najip Football Club 
奈良时代	Nara Period 
河本忍	Jin Kawamoto 
阿方索·亨里克斯球场	Alfonso Henriques Stadium 
徐富新	Xu Fuxin 
巴东_(西苏门答腊省)	Padang_(West Sumatra) 
马斯梅赫伦足球俱乐部	Masmechelen Football Club 
只想告诉你	Just want to tell you 
.kz	.kz 
佐藤谦介	Sato Keisuke 
墨西哥雷亚尔	Mexican Real 
乔治梅森大学	George Mason University 
极速快感系列	Speedy Pleasure Series 
西长铁路	Xichang Railway 
环太平洋大学联盟	Pacific Rim University Alliance 
长户大幸	Daiko Nagato 
林肯县_(内布拉斯加州)	Lincoln County_ (Nebraska) 
格鲁吉亚理工大学	Georgia Tech University 
季连	Ji Lian 
拉格茜尔公主	Princess Raghiel 
中国中央电视台西班牙语国际频道	Spanish International Channel of China Central Television 
北美足球联赛	North American Football League 
德铁机动物流	Deutsche Bahn Mobile Logistics 
1812年战争	War of 1812 
金周贤_(政治人物)	Jin Zhouxian_(Politician) 
本笃十四世	Benedict XIV 
情境音乐	Situational music 
汽车制造业	Automotive Manufacturing 
帕斯卡定律	Pascal's Law 
滨海北站	Binhai North Station 
不丹足球协会	Bhutan Football Association 
民族自由主义	National liberalism 
星尘传播	Stardust spread 
张耕_(1965年)	Zhang Geng_ (1965) 
奥斯卡最佳女配角奖	Oscar for Best Supporting Actress 
.tw	.tw 
爱达·勒芙蕾丝	Ada Lovelace 
东北议会	Northeast Parliament 
世袭专政	Hereditary dictatorship 
西北大学协会	Northwestern University Association 
德国g集团军	German Army Group G 
张南锡	Zhang Nanxi 
我美丽的守护天使	My beautiful guardian angel 
方西屏	Fang Xiping 
织田长益(有乐)	Oda Nagasaki (Uraku) 
苏格兰行政区划	Administrative divisions of Scotland 
蓟花勋章	Order of Thistle 
罗马尼亚外交部长列表	List of Romanian Ministers of Foreign Affairs 
第二次延坪海战	The second Yanping naval battle 
美国驻洪都拉斯大使	U.S. Ambassador to Honduras 
内蒙古方言	Inner Mongolian dialect 
京急本线	Keikyu Main Line 
弗雷德里克·汉密尔顿-坦普尔-布莱克伍德，第一代达费林和阿瓦侯爵	Frederick Hamilton-Tempel-Blackwood, the first Dafering and the Marquis of Ava 
津巴布韦储备银行	Reserve Bank of Zimbabwe 
月球勘测轨道飞行器	Lunar Reconnaissance Orbiter 
田秀英	Tian Xiuying 
因斯布鲁克机场	Innsbruck Airport 
护理人员	Nursing staff 
冲浪摇滚	Surf rock 
占美·麦卡伦	Jimmy McAllen 
世纪传媒	Century Media 
威贾雅足球俱乐部	Vijaya Football Club 
重庆足球俱乐部	Chongqing Football Club 
李炳军	Li Bingjun 
巴黎的阿德莱德	Adelaide in Paris 
hroznatín	grapes 
乌克兰内阁	Cabinet of Ukraine 
奇异冥想乐团	Strange Meditation Orchestra 
缅语支	Burmese branch 
广东各地级市面积列表	List of areas of prefecture-level cities in Guangdong 
普鲁士大公	Grand Duke of Prussia 
澳大利亚足球协会	Australian Football Association 
大麻哈鱼	Salmon 
2011/12赛季欧洲冠军联赛	2011/12 season UEFA Champions League 
法国高速列车	French high-speed train 
日本皇军	Imperial Japanese Army 
二村秀树	Nimura Hideki 
巴不得爸爸...	I wish dad... 
陈芷涵	Chen Zhihan 
极限金属	Extreme metal 
益阳奥林匹克公园	Yiyang Olympic Park 
杨力衡	Yang Liheng 
五代高之	Five generations of Gao Zhi 
蝙蝠侠_(1989年电影)	Batman_ (1989 movie) 
社区及地方政府部长	Minister of Community and Local Government 
阿伦航空	Allen Airlines 
.bl	.bl 
尼日利亚足球协会	Nigeria Football Association 
村井泰希	Taiki Murai 
日本赤松	Japanese red pine 
爱情悠悠药草香	Love Yoyo Herbal Scent 
存在现象学	Existential phenomenology 
新圣女公墓	New Virgin Cemetery 
孝明世子	Xiao Ming Shi Zi 
大地测量学	Geodesy 
agm-84鱼叉反舰飞弹	agm-84 Harpoon anti-ship missile 
托木斯克汤姆足球会	Tom Tomsk Football Club 
摩纳哥赛道	Monaco Circuit 
原田笃	Harada Atsushi 
北卡罗来纳柏油脚跟男子篮球队	North Carolina Tar Heel Men's Basketball Team 
堀江庆	Horie Kei 
梦想天堂	Dream paradise 
李显扬	Li Xianyang 
东京国际展示场	Tokyo Big Sight 
杰佛逊堂区_(路易斯安那州)	Jefferson Parish_ (Louisiana) 
库纳雅拉特区	Kunayalat District 
锺志超	Zhong Zhichao 
金烔完	Jin Yongwan 
范良锈	Fan Lianghui 
川村纯义	Kawamura Junyoshi 
俄罗斯苏维埃联邦社会主义共和国部长会议	Council of Ministers of the Russian Soviet Federal Socialist Republic 
富田晋伍	Tomita Jinwu 
奥斯皮塔莱特-德略布雷加特	Ospitalet de Llobregat 
达雅语	Dayak 
abdulkadir_özdemir	abdulkadir_ozdemir 
东千代之介	Higashi Chiyonosuke 
穆罕默德二世	Muhammad II 
莱克巴特勒_(佛罗里达州犹尼昂县)	Lake Butler_ (Union County, Florida) 
祖国联盟-共和国党	Fatherland Union-Republic Party 
林心如工作室	Ruby Lin Studio 
霍杰比	Hojeby 
以法莲·麦克道尔	Ephraim McDowell 
相川茉穗	Maho Aikawa 
第一次卡洛斯战争	The first Carlos war 
樋上至	Higashi 
莎拉·劳伦斯学院	Sarah Lawrence College 
陕西大秦足球俱乐部	Shaanxi Daqin Football Club 
splitsville	splitsville 
古罗马宗教	Roman religion 
eon制片公司	eon production company 
尚小平	Shang Xiaoping 
桑坦德网络	Santander Network 
美亚娱乐	Meiya Entertainment 
山东人	Shandong people 
奇卡诺摇滚	Chicano Rock 
大河内辉耕	Okochichi 
丹麦的乔治勋爵	Lord George of Denmark 
中国共产党第十八届中央委员会第一次全体会议	The First Plenary Session of the 18th Central Committee of the Communist Party of China 
伽地的马格努斯·加百利	Magnus Gabriel 
樱号列车	Sakura Train 
王延翰	Wang Yanhan 
航空喷气公司	Aerojet 
都留短期大学	Tokyo Junior College 
唐人影视	Chinese Film and Television 
tvb娱乐新闻报道	tvb entertainment news report 
乔治·巴顿四世	George Patton IV 
白延龄草	White Trillium 
左翼民粹主义	Left-wing populism 
yevpatoria	yevpatoria 
中国少年先锋队	Chinese Junior Vanguard 
天主教河内总教区	Catholic Archdiocese of Hanoi 
手机游戏	mobile game 
路易斯安那蓝调	Louisiana Blues 
摩尔多瓦独立日	Moldova Independence Day 
中华人民共和国开国大典	The Founding Ceremony of the People's Republic of China 
对马海峡海战	Battle of Tsushima Strait 
坂本昌行	Masayuki Sakamoto 
比约恩·奥瓦尔斯	Bjorn Ovals 
三藩之乱	San Francisco Rebellion 
刘思齐	Liu Siqi 
缅甸中央银行	Central Bank of Myanmar 
核心马来-波利尼西亚语族	Core Malay-Polynesian 
keroro军曹	keroro sergeant 
阿伯穆斯林足球俱乐部	Arbor muslim football club 
创氏改名	Chuang's name changed 
福斯原子能	Flowserve Atomic Energy 
拉塔基亚战役_(2013年)	Battle of Latakia_ (2013) 
gülay_barbarosoğlu	gulay_barbarosoğlu 
中共中央主要负责人	Main person in charge of the CPC Central Committee 
加拿大首席大法官	Chief Justice of Canada 
丰华唱片	Fenghua Records 
上原力也	Rikiya Uehara 
罗彻斯特理工学院	Rochester Institute of Technology 
霍华德·弗洛里，弗洛里男爵	Howard Flory, Baron Flory 
天津利顺德大饭店	Tianjin Astor Hotel 
科隆ii	Cologne II 
曾柏健	Zeng Baijian 
巴黎伯爵	Earl of Paris 
君王万岁	Long live the king 
巴黎高等师范学院	Ecole Normale de Paris 
宪政爱国主义	Constitutional patriotism 
刘千芸	Liu Qianyun 
克拉福德奖	Crawford Prize 
波兰司法部长	Polish Minister of Justice 
西班牙特区	Special Zone of Spain 
佛苯之争	Buddhism 
约旦河西岸地区	West Bank 
中闪米特语支	Middle Semitic 
蒙哥马利县_(德克萨斯州)	Montgomery County_ (Texas) 
雅温得霹雳足球俱乐部	Yaounde Perak Football Club 
香港西联网医院联网	Hong Kong West Cluster Hospital Cluster 
酸性朋克	Acid punk 
儒略年	Julian Year 
菲律宾邮政编码列表	Philippines postal code list 
nasīr_al-dīn_al-tūsī	nasīr_al-dīn_al-tūsī 
苏丹穆罕默德四世体育场	Sultan Mohammed IV Stadium 
维多利亚-迪圣安唐	Vitoria-de-Saint-Anton 
槟城州	Penang 
梁芷珊	Liang Zhishan 
教宗加理多一世	Pope Caledonian 
金光荣大	Jin Guangrong 
madcon	madcon 
夏威夷王国议会	Parliament of the Kingdom of Hawaii 
小松由佳_(声优)	Komatsu Yuka_ (seiyuu) 
哈利法克斯罗伯特·洛恩·斯坦菲尔德国际机场	Halifax Robert Lorne Stanfield International Airport 
美国南大西洋地区	U.S. South Atlantic 
西朗_(甲米地省)	Xilang _ (Ministry of Land and Infrastructure) 
兰开斯特的托马斯，第一代克拉伦斯公爵	Thomas of Lancaster, the first Duke of Clarence 
英国联合主义	British Unionism 
陈玉惠	Chen Yuhui 
本地治里县	Pondicherry County 
凯恩斯机场	Cairns Airport 
孔波斯特拉大学集团	University of Compostela Group 
亚美尼亚自由党	Liberal Party of Armenia 
张玉玫	Zhang Yumei 
赞比亚副总统列表	List of Vice Presidents of Zambia 
交互式娱乐	Interactive entertainment 
亚当斯县_(华盛顿州)	Adams County_ (Washington State) 
泉谷裕	Yutaka Izumiya 
阿斯顿·加特球场	Aston Gart Stadium 
福斯娱乐集团	Fox Entertainment Group 
西安北站	Xi'an North Railway Station 
种族关系	Race relations 
影子教育大臣	Shadow education minister 
大树里	Dashuli 
星野悟	Hoshino Go 
吴凤科技大学	Wufeng University of Science and Technology 
流动应用程式	Mobile app 
方恩珍	Fang Enzhen 
索马里全国联盟	Somali National League 
天堂执法者_(第四季)	Heaven Enforcer_ (Fourth Season) 
东北陆军讲武堂	Northeast Army Lecture Hall 
亨利王子殿下	His Royal Highness Prince Henry 
前峰里	Qianfengli 
汤斯维尔市政府	Townsville City Council 
希腊足球乙级联赛	Greek Football League 
鸠山由纪夫内阁	Cabinet of Yukio Hatoyama 
何勇_(政治人物)	He Yong_(Politician) 
drăgăşani	Drăgăşani 
马德里竞技c	Atletico Madridc 
现在才知道	Just now know 
你是我的唯一	you are my only 
伟大的于格	The great huge 
航空竞技	Aviation Sports 
自由软件运动	Free software movement 
地狱厨房_(英国节目)	Hell's Kitchen_ (UK program) 
八重之樱	Yae no Sakura 
谢德立	Xie Deli 
柳原寻美	Hiromi Yanagihara 
义大利国王	King of Italy 
苏格兰君主配偶列表	List of spouses of Scottish monarchs 
wpch-tv	wpch-tv 
江干体育中心	Jianggan Sports Center 
大宋提刑官	Da Song Ti Criminal Officer 
cnn美国头条新闻	cnn U.S. headlines 
联合中心	United Center 
何启南	He Qinan 
寂静岭系列	Silent Hill Series 
利兹市议会	Leeds City Council 
动物之森系列	Animal Crossing Series 
三笠号战舰	Battleship Mikasa 
宗座梵蒂冈城国委员会主席	Chairman of the Pontifical Council of the Vatican City State 
廖秀冬	Liao Xiudong 
朝鲜中央电视台	North Korean Central Television 
数位音讯播放器	Digital audio player 
高雄捷运公司	Kaohsiung MRT Corporation 
泰芳皇后	Queen Taifang 
朝鲜圆	North Korean Won 
.et	.and 
太平洋赛区	Pacific Division 
松本大辉	Matsumoto Daiki 
亨利_康沃尔公爵	Henry _ Duke of Cornwall 
金庸来	Jin Yonglai 
栋笃笑	Don Duxiao 
机场联络轨道系统	Airport Link Rail System 
香港公务员事务局	Hong Kong Civil Service Bureau 
夏桔花	Summer Orange Flower 
东京防御総督部	Tokyo Defense Department 
宝马方程式	Formula BMW 
夏威夷本土英语	Native Hawaiian English 
.jo	.already 
冈本知刚	Okamoto Tomoko 
南达科他州单一国会选区	Single congressional district of South Dakota 
jubi	jubi 
弗雷德里克斯堡_(德克萨斯州)	Fredericksburg_ (Texas) 
贵人张氏_(朝鲜高宗)	Nobleman Jang Clan_ (Gojong, North Korea) 
前泽希	Maesawa Nozomi 
莫里茨王子_(巴腾堡)	Prince Moritz_ (Batenberg) 
上野寿野	Ueno Toshino 
台湾海峡	Taiwan Strait 
南昌西动车运用所	Nanchang West Railway Station 
约旦足球协会	Jordan Football Association 
云哥达	Yun Geda 
月之恋人	Lovers of the Moon 
1986年美国空袭利比亚	U.S. air strikes on Libya in 1986 
瓦尔德克-皮尔蒙特	Waldeck-Pyrmont 
谭又新	Tan Youxin 
瑞典王后列表	List of Queens of Sweden 
美杜莎	Medusa 
行为哲学	Behavioral philosophy 
克莱孟八世	Clement VIII 
希尔斯波罗县_(佛罗里达州)	Hillsboro County_ (Florida) 
闽越人	Minyue people 
樱兰高校男公关部	Ouran High School Host Club 
人造卫星	Artificial satellite 
温带半干旱大陆性季风气候	Temperate semi-arid continental monsoon climate 
白俄罗斯足球甲级联赛	Belarusian Football League 
广州富力	Guangzhou R&F 
克罗埃西亚摇滚	Croatian Rock 
洛杉矶国王	Los Angeles Kings 
意大利海军	Italian Navy 
伊斯兰法西斯主义	Islamic Fascism 
孟祥伟	Meng Xiangwei 
相反的我	Opposite me 
新加坡总督	Governor of Singapore 
玻尔半径	Bohr radius 
世界拉力锦标赛	World Rally Championship 
英国下议院议长	Speaker of the House of Commons 
多博伊	Doboi 
广东奥林匹克体育中心	Guangdong Olympic Sports Center 
.kr	.kr 
上北双子	Shangbei Gemini 
阿布查哈乌江	Abu Chaha Wujiang 
贝克、波加特与阿比特	Baker, Bogart and Abit 
约旦大学	University of Jordan 
二本松市	Nihonmatsu City 
富察氏	Fuchs 
进攻中场	Offensive midfielder 
马德里体育馆	Madrid Arena 
罗马尼亚民主党大会	Romanian Democratic Party 
单内核	Single core 
曾伟权	Zeng Weiquan 
阿闭皇子	A closed prince 
印度最多人口的城市列表	List of most populous cities in India 
叙利亚空军	Syrian Air Force 
2018年夏季青年奥林匹克运动会	2018 Summer Youth Olympic Games 
戴维斯_(港督)	Davis_ (Hong Kong Governor) 
老唐纳德·威尔士·道格拉斯	Donald Welsh Douglas Sr 
核物理学	Nuclear physics 
叙利亚革命指挥委员会	Syrian Revolution Command Committee 
冰火五重天	Ice and Fire Five Heavens 
反天主教	Anti-Catholic 
中欧时区	Central European Time Zone 
社交网路服务	Social network service 
台北市立兰雅国民中学毕业	Graduated from Taipei Lanya National High School 
爱情急整室	Love rush room 
中山久美子	Nakayama Kumiko 
王多年	Wang years 
托尔马切沃机场	Tolmachevo Airport 
联合进步联盟	United Progress Alliance 
赵香奇	Zhao Xiangqi 
村上和弘	Kazuhiro Murakami 
波特萨莫-希尔内科斯攻势	Portsamo-Hiernekos offensive 
约翰蓝侬/塑胶小野乐团	John Lennon/Plastic Ono Orchestra 
中顽童	Middle urchin 
幻成院英晃常晖大童子	The big boy of Yinghuang Changhui 
儿岛雄一	Kojima Yuichi 
丰见城市	Tomomi City 
肯顿_(新泽西州)	Camden_(New Jersey) 
吴昌炽	Wu Changchi 
阿尔戈斯的波丽克拉提亚	Polycratia of Argos 
数字版权管理	Digital rights management 
厄瓜多尔乙组足球联赛	Ecuador Group B Football League 
神魔小说	Fiction 
利布尔讷圣瑟兰足球会	Libourne Saint Serin Football Club 
佩萨罗	Pesaro 
海军中将	Vice Admiral 
阿尔巴尼亚列克	Albanian Lek 
克波拉区_(昆士兰州)	Keppola District_ (Queensland) 
芦洲机厂	Luzhou Machinery Factory 
自由民主党国会对策委员会	Liberal Democratic Party Congressional Countermeasures Committee 
韦莱特里	Velletri 
周江勇	Zhou Jiangyong 
动画情景喜剧	Animated sitcoms 
沙姆士兵伊斯兰联盟	Sham Soldiers Islamic League 
山本美月	Mizuki Yamamoto 
施派尔主教座堂	Speyer Cathedral 
施洗者约翰	John the Baptist 
项姓	Item 
2005年英国国会议员大选	2005 British Parliamentary Election 
中国进步党	Chinese Progressive Party 
奥平信昌	Okudaira Nobumasa 
中共中央统一战线工作部	United Front Work Department of the CPC Central Committee 
阿里海牙	Ali the Hague 
mbc水木迷你连续剧	mbc Mizuki mini series 
平尾道雄	Michio Hirao 
德永千奈美	Chinami Tokunaga 
伊拉克副总统	Vice President of Iraq 
正田惠美子	Emiko Masada 
综艺晓松	Variety Show Xiao Song 
统一阿布哈兹	Unify Abkhazia 
杉村升	Noboru Sugimura 
关系数据库	relational database 
威秀娱乐集团	Village Show Entertainment Group 
谢正义	Xie Zhengyi 
武定里	Wudingli 
元气妈妈	Vitality mother 
芳德邻医院	Fontaine Hospital 
美国联邦第七巡回上诉法院	U.S. Court of Appeals for the Seventh Circuit 
茶是故乡浓	Tea is hometown strong 
上田稔	Minoru Ueda 
牛蛙制作	Bullfrog Making 
蝙蝠家庭	Bat family 
中华人民共和国立法法	Legislation Law of the People's Republic of China 
约瑟夫·蒂埃里	Joseph Thierry 
共聚焦显微镜	Confocal microscope 
垮掉的一代	Beat generation 
哈布斯堡-洛林皇朝	Habsburg-Lorraine Dynasty 
李锡铭	Li Ximing 
曾沛慈	Zeng Peici 
马也	Ma Ye 
黑田忠之	Tadayuki Kuroda 
贞圣王后	Queen of Saints 
上海博物馆	ShangHai museum 
塞尔维亚公国	Principality of Serbia 
橡树岭附属大学	Oak Ridge University 
美式橄榄球	American football 
东京振武学校	Tokyo Zhenwu School 
崔秉烈	Cui Binglie 
郝明珠	Hao Mingzhu 
.dj	.dj 
寺田绅一	Terada Shinichi 
异常的一元论	Abnormal monism 
滨海布洛涅	Boulogne-sur-Mer 
苅田町	Kanda Town 
北京大学西门	West Gate of Peking University 
维基媒体基金会	Wikimedia Foundation 
美国能源部	U.S. Department of Energy 
阿积士足球俱乐部	Ajax Football Club 
斯里维加亚足球俱乐部	Sriwijaya Football Club 
莫斯科鱼雷	Moscow Torpedo 
地平装置	Horizon device 
格奥尔格-汉斯·莱因哈特	Georg-Hans Reinhardt 
深圳红钻	Shenzhen Red Diamond 
李旼赫	Lee Min Hyuk 
马里科帕县	Maricopa County 
矢野贵章	Kisho Yano 
社会保守主义	Social conservatism 
数理逻辑	Mathematical logic 
jp:朴台洪	jp: Park Taehong 
台中清泉岗机场	Taichung Airport 
马来西亚高等教育部	Ministry of Higher Education of Malaysia 
闽民系	Hokkien 
创新、工业、科学暨研究部长	Minister of Innovation, Industry, Science and Research 
为泰党	For the Thai party 
越南国会主席	Chairman of the National Assembly of Vietnam 
青岛里	Qingdaoli 
科罗拉多大峡谷	Colorado Grand Canyon 
王荣平	Wang Rongping 
教宗本笃二世	Pope Benedict II 
教宗沙彬	Pope Shabin 
中阿尔冈昆语支	Middle Algonquin 
幸野志有人	Kono Shitoto 
格奥尔格·维克多_(瓦尔德克和皮尔蒙特)	Georg Victor_ (Waldeck and Pyrmont) 
高尔基汽车厂	Gorky Automobile Plant 
绿色环境党	Green Environment Party 
中国航天科工集团	China Aerospace Science and Industry Corporation 
让-克洛德·特里谢	Jean-Claude Trichet 
艺术创作硕士	Master of Art Creation 
中洲里_(旗山区)	Zhongzhouli_(Qishan District) 
中华人民共和国超大城市列表	List of mega cities in the People's Republic of China 
马拉尼昂联邦大学	Federal University of Maranhao 
山樱花	Mountain cherry 
旺旺中时媒体集团	Want Want Zhongshi Media Group 
贾西姆本哈马德体育场	Jasim Bin Hamad Stadium 
法国国家u20国家足球队	French national u20 national football team 
意大利战争	Italian war 
雷亚尔城区	Real City 
新闻阅读器	News reader 
越南共产党中央书记处	Secretariat of the Communist Party of Vietnam 
基本粒子	elementary particle 
浩室流行	House fashion 
日心轨道	Heliocentric orbit 
昆特仑理工大学	Kwantlen University of Technology 
朱安_(鲁迅夫人)	Zhu An_ (Mrs. Lu Xun) 
本木雅弘	Masahiro Motoki 
德威弗尔的劳合·乔治伯爵	Lord Lloyd George of Dwyver 
雪菲尔哈伦_(英国国会选区)	Sheffield Hallun_ (UK Parliamentary District) 
岐阜纪念中心长良川竞技场	Gifu Memorial Center Nagaragawa Arena 
杀手千钧一发	Killer 
久我誓圆	Kuga Oath 
法国国家u16国家足球队	French national u16 national football team 
călimăneşti	Călimăneşti 
玛丽亚·特蕾西亚_(奥地利皇后)	Maria Theresia_ (Queen of Austria) 
jvc建伍	jvc kenwood 
贺韵芝	He Yunzhi 
英式摇滚	British Rock 
古田宽幸	Kanyuki Furuta 
弗雷德里克王子_(约克和奥尔巴尼公爵)	Prince Frederick_ (Duke of York and Albany) 
bălți	ponds 
韦洛坡内阁	Willopo Cabinet 
禔子内亲王	Prince inside 
染井吉野樱	Yoshino cherry tree 
国际饭店	International Hotel 
lipophobicity	lipophobicity 
张光世	Zhang Guangshi 
格拉斯哥市议会	Glasgow City Council 
唐纳德一世_(皮克特人)	Donald I_ (Pikts) 
德国联邦议会	German Bundestag 
电子鼓乐器	Electronic drum instrument 
中华人民共和国人民法院法徽	The People's Court of the People's Republic of China 
君子剑	Gentleman sword 
中央公园球场	Central Park Stadium 
清水胜则	Katsunori Shimizu 
黄三平	Huang Sanping 
欧洲女子足球锦标赛	European Women's Football Championship 
程志明	Cheng Zhiming 
维拉克鲁兹_(巴伊亚州)	Vera Cruz_ (Bahia) 
泽尼察-多博伊州	Zenica-Doboj Region 
阿卡围城战_(1291年)	Siege of Akka_ (1291) 
澳大利亚20岁以下国家足球俱乐部	Australian Under-20 National Football Club 
拉谦域	Lachenfield 
奥斯陆大学	University of Oslo 
爱尔兰杯	Irish Cup 
邓允肾	Deng Yunshen 
兹沃勒足球俱乐部体育场	Zwolle Football Club Stadium 
陈兆禧	Chen Zhaoxi 
德国国会大厦	Reichstag Building 
萧孟能	Xiao Mengneng 
青年小说	Youth fiction 
塞奇菲尔德_(英国国会选区)	Sedgefield_(British Parliamentary District) 
玉女剑法	Jade Girl Swordsmanship 
田上町	Tagami Town 
専修大学	Senshu University 
阿德莉萨_(诺曼底)	Adelisa _ (Normandy) 
img足球学院	img Football Academy 
çapa	anchor 
紧凑型轿车	Compact car 
罗杰·莫蒂默，第一代马奇伯爵	Roger Mortimer, the first Earl of March 
泊松括号	Poisson bracket 
铃木幸太	Suzuki Kota 
飞利浦体育馆	Philips Stadium 
印度联邦院	Indian Federal Council 
日剧台	Japanese TV 
恭顺皇贵妃	Respectful to the imperial concubine 
泊松回归	Poisson regression 
新加坡慈善盾	Singapore Charity Shield 
博特夫足球俱乐部	Botev Football Club 
德克萨斯州大学	University of Texas 
费尔维尤镇区_(堪萨斯州巴特勒县)	Fairview Township_ (Butler County, Kansas) 
宪仁亲王妃久子	Princess Hyun Ren Hisako 
洪卡足球俱乐部	Honka Football Club 
学生工党	Student Labor Party 
武汉天河国际机场	Wuhan Tianhe International Airport 
奥兰治亲王	Prince of Orange 
佟图赖	Tong Tulai 
中欧时间	Central European Time 
猎户座飞船	Orion spacecraft 
阿纳斯塔修斯一世	Anastasius I 
民主党_(大韩民国2000年)	Democratic Party_ (Republic of Korea 2000) 
夏威夷州州长	Governor of Hawaii 
江南七怪	Seven Monsters of Jiangnan 
吴超荣	Wu Chaorong 
美国归正会	Reformed Church of America 
美国陆军指挥参谋学院	U.S. Army Command and Staff College 
政制及内地事务局	Constitutional and Mainland Affairs Bureau 
朝鲜民主主义人民共和国最高领导人	Supreme Leader of the Democratic People's Republic of Korea 
标准线性固体模型	Standard linear solid model 
艺能娱乐	Arts Entertainment 
桂林里_(小港区)	Guilin_(Xiaogang District) 
c-band	c-band 
圣文森特和格林纳丁斯君主	Monarch of Saint Vincent and the Grenadines 
坏女人好女人	Bad woman good woman 
塔那	Thane 
秋山真之	Akiyama Saneyuki 
btooom!	btooom! 
虚位元首	Phantom head 
英国音乐	British music 
波兰海军	Polish Navy 
秘鲁太阳勋章	Peruvian Sun Medal 
圣心天主教大学	Catholic University of the Sacred Heart 
综合企业	Integrated enterprise 
科尔内拉-埃尔普拉特球场	Cornella-El Prat Stadium 
大上海	Big Shanghai 
刘官女子	Liu Guan Women 
我家小孩有够多!大家族奋斗记	There are enough children in my family! The struggle of a big family 
基尔大学	Keele University 
天津市区	Tianjin City 
英属洪都拉斯总督	Governor of British Honduras 
大宅皇女	Mansion Queen 
英属奎亚那政府秘书	Secretary of the Government of British Quinana 
匈牙利国旗	Hungarian flag 
邓迪足球俱乐部	Dundee Football Club 
精神疗法	Psychotherapy 
中国共产党中山市委员会	Zhongshan City Committee of the Communist Party of China 
欧律狄刻_(阿明塔斯三世之妻)	Eurydice_ (Wife of Amintas III) 
草野博纪	Hironori Kusano 
坂田谦人	Yoshito Sakata 
麦斯·彭利拿	Max Penlina 
reinhardsbrunn	reinhardsbrunn 
奥巴马峰	Obama Peak 
水主皇女	Princess Minushi 
行为矫正疗法	Behavior modification therapy 
冰岛社会事务部	Icelandic Ministry of Social Affairs 
奥地利u17足球代表队	Austria U17 National Football Team 
西门菲沙大学	Simon Fraser University 
尹启铭	Yin Qiming 
市川昌永	Masanaga Ichikawa 
利氏冷凝管	Leech condenser 
查尔斯·皮尔庞特，第一代曼弗斯伯爵	Charles Pierpont, the first Earl of Manvers 
北柏柏尔语支	North Berber 
何宗就	He Zongjiu 
王冠球场	Crown Stadium 
加平战斗	Gapyeong battle 
橙县_(佛罗里达州)	Orange County_(Florida) 
郝廉思	Hao Liansi 
狄西德里乌斯	Dissidrius 
佐佐木彩夏	Sasaki Ayaka 
斯巴达克同盟	Spartak League 
色格拉布鲁日皇家体育会	Royal Athletic Club of Brugge 
多纳尔森堡战役	Battle of Fort Donaldson 
节奏游戏	Rhythm game 
瑟罗克议会	Thurrock Council 
安全皇后	Security queen 
应用数学	applied mathematics 
奈良县旗	Nara Prefecture Flag 
拉脱维亚银行	Bank of Latvia 
雅典的普卢塔赫	Plutakh 
圭亚那君主	Monarch of Guyana 
伊藤畅达	Ito Chanda 
上莱茵省	Haut-Rhin 
卡尔皮足球俱乐部	Carpi Football Club 
须江信人	Xujiang Xinren 
tydal	tydal 
命令与征服：泰伯利亚之日	Command and Conquer: Tiberium Day 
菲律宾地理	Philippine Geography 
美国参议院情报挑选委员会	U.S. Senate Intelligence Selection Committee 
公告牌二百强专辑榜	Billboard Top 200 Albums Chart 
尼菲治巴库足球俱乐部	Nefici Baku Football Club 
国家杂志奖	National Magazine Awards 
半自动手枪	Semi-automatic pistol 
雅赫摩斯-西特卡摩斯	Yahmos-Sit Camos 
国立台湾大学医学院	National Taiwan University College of Medicine 
卓克索大学	Jokzo University 
同生不共死	Live without death 
保罗·拉马迪埃	Paul Ramadier 
印巴分治	Divide and conquer India and Pakistan 
卢森堡大公宫殿	Grand Ducal Palace of Luxembourg 
都柏林市政厅	Dublin City Hall 
三维计算机图形	Three-dimensional computer graphics 
修·基斯-拜伦	Hugh Keith-Byron 
香港高等法院	Hong Kong High Court 
费索·本·侯赛因王子	Prince Faso Bin Hussein 
冲绳县旗	Flag of Okinawa Prefecture 
北爱尔兰行政区划	Administrative divisions of Northern Ireland 
wikt:山东	wikt: Shandong 
菲律宾军事功绩勋章	Philippine Medal of Military Merit 
马丁四世	Martin IV 
莱耶华伦球场	Layer Warren Stadium 
威廉·佩蒂，第二代谢尔本伯爵	William Petty, 2nd Earl of Metabolism Urban 
游戏设计	game design 
日本鹡鸰	Japanese Wagtail 
大坪里	Dapingli 
撒旦之子	Son of Satan 
高雄捷运林园延伸线	Kaohsiung MRT Linyuan Extension Line 
后庞克	Post-punk 
互联网电影数据库	Internet Movie Database 
乌拉圭20岁以下国家足球队	Uruguay Under-20 National Football Team 
芬兰-伏尔加语支	Finnish-Volga branch 
古典经济学	Classical economics 
色麻町	Shikama Town 
灿烂的遗产	Splendid legacy 
日本朝鲜族	Japanese Korean 
克罗地亚共产主义者联盟	Croatian Communist League 
意大利20岁以下国家足球队	Italy under-20 national football team 
鹰石娱乐	Eagle Rock Entertainment 
威斯巴登体育俱乐部	Wiesbaden Sports Club 
久木田绅吾	Shingo Kukita 
周采诗	Zhou Caishi 
拉阿鲁哇语	La Aruwa 
博雷尔测度	Borrell measure 
圣玛丽球场	St. Mary's Stadium 
巴基斯坦空军	Pakistan Air Force 
分析力学	Analytical mechanics 
卡-31直升机	Ka-31 helicopter 
巴什科尔托斯坦共和国	Republic of Bashkortostan 
纲田大志	Tsunada Taishi 
奥地利的凯瑟琳_(1533年–1572年)	Catherine of Austria (1533–1572) 
c++builder	c++builder 
哈萨克甲组足球联赛	Kazakh Football League 
那班道尔吉·扎丹巴	Nabandorji Zadamba 
香港公开大学	The Open University of Hong Kong 
陈旭_(女学者)	Chen Xu_ (Female Scholar) 
曰云	Yueyun 
香港青年军	Hong Kong Youth Army 
qt发展框架	qt development framework 
巴基斯坦行政区划	Administrative divisions of Pakistan 
乔瑟夫·高登-李维	Joseph Gordon-Levy 
福冈证券交易所	Fukuoka Stock Exchange 
北美洲语言	North American languages 
奥里韦拉足球俱乐部	Orihuela Football Club 
重庆市人民大礼堂	Chongqing People's Auditorium 
朱希华	Zhu Xihua 
兹诺伊莫足球俱乐部	Znojmo Football Club 
帕斯卡定理	Pascal's Theorem 
伊莉诺-摩雷基-宁蒙德女爵	Lady Illinois-Morekey-Ningmond 
韩泰轮胎	Hankook Tire 
哥特小说	Gothic fiction 
j4	j4 
道路通行方向	Road traffic direction 
东伦敦	East London 
伯明翰业馀足球总会	Birmingham Amateur Football Association 
松平容保	Matsudaira Katamori 
普韦布洛_(科罗拉多州)	Pueblo_ (Colorado) 
j2000.0	j2000.0 
成都体育学院	Chengdu Institute of Physical Education 
加州艺术学院	California Academy of Arts 
喜来登阿勒颇酒店	Sheraton Aleppo Hotel 
斯泰伦博斯大学	Stellenbosch University 
滨海湾浮动舞台	Marina Bay floating stage 
哥本哈根学院足球会	Copenhagen Academy Football Club 
第二届阿里·沙斯特罗阿米佐约内阁	The 2nd Ali Shastro Amizoyo Cabinet 
高速上行分组接入	High-speed uplink packet access 
中山佳久	Zhongshan Jiajiu 
比尤特-银弓市和县_(蒙大拿州)	Butte-Silver Bow City and County_ (Montana) 
雷诺方程式2.0西欧杯	Formula Renault 2.0 West European Cup 
星际争霸系列	StarCraft Series 
吕珊德拉	Lusandra 
乳源瑶族自治县	Ruyuan Yao Autonomous County 
中华民国交通部部长	Minister of Transport of the Republic of China 
班克斯_(澳大利亚国会选区)	Banks_ (Australian Parliamentary Constituency) 
uttarakhandi	Uttarakhandi 
子午圈_(科罗拉多州)	Meridian Circle_ (Colorado) 
民族自治地方	Ethnic autonomous areas 
美国动视	Activision 
东北贝德福德郡_(英国国会选区)	Northeast Bedfordshire_(British Parliamentary District) 
杨天啸	Yang Tianxiao 
叶祖新	Ye Zuxin 
尤文图斯球场	Juventus Stadium 
美国参议员	U.S. Senator 
山本権兵卫	Yamamoto Gonnohye 
莫斯科中央陆军	CSKA Moscow 
法国足球联赛系统	French Football League System 
佛教自由民主党	Buddhist Liberal Democratic Party 
泰格伍兹高尔夫巡回赛	Tiger Woods Golf Tour 
鸿准精密工业	Hongzhun Precision Industry 
中华人民共和国中央人民政府	The Central People's Government of the People's Republic of China 
岩垂寿喜男	Sukio Iwataru 
electrofunk	electrofunk 
昌原足球运动场	Changwon Football Stadium 
堪萨斯市皇家	Kansas City Royals 
格陵兰地理	Geography of Greenland 
苏格兰国教会	National Church of Scotland 
庄顺皇贵妃	Imperial Concubine Zhuang Shun 
新灵魂乐	New Soul 
孔切肖	Concesio 
加山兴行会社	Kayama Toko Company 
日本年号列表	List of Japanese era names 
凯萨酋长足球俱乐部	Caesars Football Club 
阿鲁辛·科芬拿	Arushin Cofina 
马素尔科多	Masulcodo 
提斯利大学	Tishley University 
邓进东	Deng Jindong 
澳大利亚联邦	Commonwealth of Australia 
弗朗西斯·戈多尔芬·奥斯本，第五代利兹公爵	Francis Godolphine Osborne, the fifth Duke of Leeds 
热那亚足球会	Genoa Football Club 
奥地利大公国	Grand Duchy of Austria 
织田信行	Oda Nobuyuki 
阿玛琳王后	Queen Amarin 
西部开发	Western Development 
民主左派联盟	Democratic Left League 
迈帕足球俱乐部	Maipa Football Club 
欧元纸币	Euro banknotes 
2012年夏季奥林匹克运动会女子足球比赛	Women's football match at the 2012 Summer Olympics 
堤幸彦	Yukihiko Tsutsumi 
日本自由党_(1953年)	Liberal Party of Japan (1953) 
灵元天皇	Emperor Lingyuan 
里奥拉古大学	Rio Lago University 
阿尔及利亚国徽	National Emblem of Algeria 
南华梦飞翔	South China Dream Flying 
乌尔巴诺八世	Urbano VIII 
里斯本奥利安图足球会	Lisbon Oleanto Football Club 
北京慈文影视制作有限公司	Beijing Ciwen Television Production Co., Ltd. 
巴西君主列表	List of Brazilian monarchs 
火神运载火箭	Vulcan Launch Vehicle 
合成器流行	Synthesizer Pop 
暴风雨_(池上永一)	Tempest_(Eiichi Ikegami) 
平田东助	Hirata Tosuke 
加拿大环境部	Environment Canada 
毁灭公爵	Duke of Destruction 
梁咏珊	Liang Yongshan 
堀之纪	Horinoki 
孙玦新	Sun Yuexin 
美国联邦巡回法院	U.S. Federal Circuit 
孤立语言	Isolated language 
悲惨世界	Les Miserables 
黑岩善宏	Kuroiwa Zenhiro 
内斯托尔·马赫诺	Nestor Makhno 
南胜里	Nanshengli 
自由党_(日本1998年)	Liberal Party_ (Japan 1998) 
金边王宫	Royal Palace of Phnom Penh 
圣母无染原罪瞻礼	Feast of the Immaculate Conception 
真卡布历基	Real Kabriki 
阿娣	Adi 
天国之吻	Heavenly kiss 
苏丹玛末	Sultan Mahmud 
罪案调查	Crime investigation 
约翰·汤普森_(澳大利亚政治家)	John Thompson_ (Australian politician) 
脱离轨道	Off track 
港灯体育会	Hongkong Electric Sports Association 
新殖民主义	Neocolonialism 
越南军校	Vietnam Military Academy 
东山纪之	Higashiyama Kiyuki 
坚盐媛	Ken Yanyuan 
美国联赛杯	American League Cup 
巴斯爵级大十字勋章	Grand Cross of Bath 
公共交通	Public transit 
九曲里	Jiuquli 
完全娱乐	Full entertainment 
电视出品人	TV Producer 
国际tex用户组	International tex user group 
南非国王	King of South Africa 
国道319线	National Highway 319 
危机边缘各集列表	List of episodes on the verge of crisis 
米拉马尔米西奥内斯体育俱乐部	Miramar Misiones Sports Club 
库克山航空	Mount Cook Airlines 
glostrup	glostrup 
贵州人和足球俱乐部	Guizhou Renhe Football Club 
斯洛伐克足球甲级联赛	Slovak Football League 
达喀尔区	Dakar District 
苏格兰副首席部长	Deputy Chief Minister of Scotland 
洪志相	Hong Zhixiang 
哥路达	Grotta 
野路菊	Chrysanthemum Noji 
他可·盖茨	Tak Gates 
不确定性原理	Uncertainty principle 
凯霍加县	Cuyahoga County 
中国共产党中央军事委员会副主席	Vice Chairman of the Central Military Commission of the Communist Party of China 
亚历山德里亚_(弗吉尼亚州)	Alexandria_ (Virginia) 
塞尔维亚国家银行	National Bank of Serbia 
md6	md6 
匈牙利王国_(1920年—1946年)	Kingdom of Hungary_ (1920-1946) 
府中町	Fuchu Town 
越后汤泽车站	Echigo Yuzawa Station 
荣誉勋章	Medal of Honor 
普罗旺斯的贝亚特丽丝	Beatrice of Provence 
和佐野健一	Kenichi Wasano 
海老泽健次	Kenji Ebisawa 
小海女	Little sea girl 
clipse	clipse 
地质构造	Geological structure 
罗伯特·盖斯科因-塞西尔，第五代索尔兹伯里侯爵	Robert Gascoyne-Cecile, the fifth Marquis of Salisbury 
重庆航空	Chongqing Airlines 
川副德子	Toko Kawasoe 
港海豹	Harbor seal 
英荷条约	Anglo-Dutch Treaty 
哈密尔顿国际机场	Hamilton International Airport 
杨振声(助理编导)	Yang Zhensheng (Assistant Choreographer) 
线上学习	Online learning 
中国人民解放军东部战区	Eastern Theater of the Chinese People's Liberation Army 
海峡殖民地总督	Governor of the Straits Settlements 
米兰统治者列表	List of rulers of Milan 
普鲁士总理	Prime Minister of Prussia 
城市地位	City status 
东南斯拉夫亚语支	Southeastern Slavic 
日本自由党_(1945年)	Liberal Party of Japan_ (1945) 
兄弟战争	war between brothers 
道语言	Tao language 
卫子夫_(电视剧)	Wei Zifu_ (TV series) 
松平喜德	Matsudaira Nobunori 
类型推论	Type inference 
史酷比	Scooby Doo 
德克萨斯大学法学院	University of Texas Law School 
种子音乐	Seed music 
地球队长	Captain 
环境光传感器	Ambient light sensor 
国立西南联合大学	National Southwest Associated University 
拉姆福德奖	Rumford Prize 
南城街道_(东莞市)	Nancheng Street_(Dongguan City) 
阿布哈兹民族团结论坛	Abkhaz National Unity Forum 
file:明宣宗画像.jpg	file:Ming Xuanzong portrait.jpg 
psapp	psapp 
黄文太	Huang Bunta 
白米里	Bai Mili 
阿斯图里亚斯君主列表	List of Asturian monarchs 
大山崎町	Oyamazaki Town 
罗金汉侯爵	Marquis of Rockingham 
新光里_(旗山区)	Xinguangli_(Qishan District) 
神话再现	Myth reappearance 
海岛大亨	Island Tycoon 
醇贤亲王	Prince Jinxian 
致命玩笑	Fatal joke 
美国证券交易委员会	U.S. Securities and Exchange Commission 
直布罗陀首席部长	Chief Minister of Gibraltar 
s:中华民国总统府组织法	s: Organic Law of the Presidential Palace of the Republic of China 
三好市_(爱知县)	Miyoshi City_(Aichi Prefecture) 
梅阿查球场	Meazza Stadium 
斯洛文尼科学及艺术研究院	Slovenian Academy of Science and Art 
克赫历程	Kehe course 
戈亚尼恩斯竞技俱乐部	Goianians Athletic Club 
黑森林体育场	Black Forest Stadium 
迈克尔·哈弗斯，哈弗斯男爵	Michael Havers, Baron Havers 
冰岛卫生和社会保险部	Ministry of Health and Social Insurance of Iceland 
廖素惠	Liao Suhui 
西雅图水手	Seattle Mariners 
白俄罗斯文	Belarusian 
行为经济学	Behavioral Economics 
科科斯（基林）群岛	Cocos (Keeling) Islands 
控股公司	Holding company 
全美大学体育协会	National College Athletic Association 
冲田智	Okita Chi 
参议院少数党党鞭	Senate Minority Whip 
纽约市立大学	City University of New York 
钱达尔勒·卡拉·哈利勒·海雷丁帕夏	Chandar Kara Khalil Heredin Pasha 
艾萨克区政府	Isaac District Government 
牛顿大学	University of Newton 
utc±0	utc±0 
纽约上州	Upstate New York 
英国驻美大使列表	List of British Ambassadors to the United States 
美国联盟中区	American League Central 
越南独立同盟	Vietnam Independence League 
金砖国家大学联盟	BRICS University Alliance 
开放国民党	Open National Party 
必娶女人	Must marry a woman 
自由印度临时政府	Free India Provisional Government 
李建欣	Li Jianxin 
蕙兰属	Cymbidium 
端恪皇贵妃	Emperor Duanke 
英格兰联赛挑战杯	England League Challenge Cup 
福尔曼基督教学院	Foreman Christian College 
径向速度	Radial velocity 
镇江会展中心体育馆	Zhenjiang Convention and Exhibition Center Gymnasium 
归正宗	Return to authentic 
陈湘乐	Chen Xiangle 
达卡专区	Dhaka Zone 
上海理工大学	University of Shanghai for Science and Technology 
自动竖琴	Automatic harp 
marshintsy	Marshinasi 
列宁格勒围城战	Siege of Leningrad 
美菲战争	US-Philippine war 
中国人民解放军南部战区	Southern Theater of the Chinese People's Liberation Army 
乌林里	Ulinli 
亨利·诺利斯·罗素讲座	Henry Norris Russell Lecture 
筒井ともみ	Tomomi Tsutsui 
宏茂桥集选区	Ang Mo Kio GRC 
安德烈斯_(萨克森—科堡-哥达)	Andres_(Saxony-Coburg-Gotha) 
卢森堡公爵	Duke of Luxembourg 
绿色保守主义	Green conservatism 
樋口宽规	Higuchi 讽 规 
马克西米连·德·贝蒂讷_(叙利公爵)	Maximilian de Bettina_ (Duke of Surly) 
黑暗浩室	Dark house 
横山里	Yokoyama 
江苏舜天	Jiangsu Sainty 
巴黎第六大学	University of Paris VI 
蒙特娄奥林匹克体育场	Montreal Olympic Stadium 
brother唱片	brother record 
特诗琳王太后	Queen Mother Teresin 
夏绿蒂·勃朗特	Charlotte Bronte 
柬埔寨华裔首相	Chinese Prime Minister of Cambodia 
东法兰克王国	East Franconian Kingdom 
京滨急行电铁	Keikyu Electric Railway 
尔朱荣	Er Zhurong 
库纳-德瓦尔干迪特区	Kuna-Dwargandi District 
海防足球俱乐部	Haiphong Football Club 
巴基斯坦标准时间	Pakistan Standard Time 
黑斯廷斯_(内布拉斯加州)	Hastings_ (Nebraska) 
伯利兹君主	Monarch of Belize 
2013年亚足联冠军联赛	2013 AFC Champions League 
密接支援	Close support 
阿里乌教派	Arianism 
国信体育场	Guoxin Stadium 
高木阳介	Ryosuke Takagi 
重庆腾辉地维水泥有限公司	Chongqing Tenghui Diwei Cement Co., Ltd. 
第五组宇航员	The fifth group of astronauts 
英联邦元首	Head of Commonwealth 
俄罗斯帝国财政部长列表	List of Ministers of Finance of the Russian Empire 
贞妃_(顺治帝)	Zhen Fei_(Shunzhi Emperor) 
法国法郎	French franc 
石勒苏益格-荷尔斯泰因王朝	Schleswig-Holstein Dynasty 
中国人民解放军历史	History of the Chinese People's Liberation Army 
无线网络电视	Wireless network TV 
格奥尔格·威廉_(勃兰登堡)	Georg Wilhelm_ (Brandenburg) 
拉塞福散射	Rutherford Scattering 
美国参议院卫生、教育、劳工及退休金委员会	U.S. Senate Committee on Health, Education, Labor and Pensions 
台湾有线电视业者列表	List of Taiwan Cable TV Companies 
电子游戏开发	Video game development 
最美好的自己	Best self 
冲绳岛战役	Battle of Okinawa 
八反田康平	Kohei Hattanda 
懿敬世子	Yi Jing Shizi 
鲁汶天主教大学_(1834–1968)	Catholic University of Leuven_ (1834–1968) 
伊朗行政区划	Administrative divisions of Iran 
累西腓竞技会	Recife Athletic Club 
智利足球协会	Chilean Football Association 
广播公司	Broadcasting company 
向井理	Mukai Osamu 
伊朗陆军	Iranian Army 
赫雷斯足球俱乐部	Jerez Football Club 
交通部邮政总局	General Post Office of the Ministry of Communications 
熊取町	Kumatori Town 
澳大利亚国防部长	Australian Minister of Defence 
吕埃马尔梅松	Ruemalmaison 
坎伯兰_(马里兰州)	Cumberland_ (Maryland) 
c-54_%22空中霸王%22	c-54_%22 Skymaster%22 
头号天文台圆环	Number One Observatory Circle 
刺客教条iii	Assassin's Creed III 
恩斯蒂图竞技俱乐部	Ensitu Athletic Club 
教宗本笃三世	Pope Benedict III 
王少伟	Wang Shaowei 
东高地省_(巴布亚纽几内亚)	Eastern Highlands Province_ (Papua New Guinea) 
梅尔顿选区	Melton Constituency 
河畔球场	Riverside Course 
埃德加_(苏格兰国王)	Edgar (King of Scotland) 
欧沙里	Oshari 
卡尔一世_(符腾堡)	Karl I_ (Wuerttemberg) 
刺客教条ii：探索	Assassin's Creed II: Exploration 
中岛源太郎	Gentaro Nakajima 
山冈贤次	Yamaoka Kenji 
尼尔·阿伯克龙比	Neil Abercrombie 
锡尔克堡体育协会	Silkeborg Sports Association 
上下埃及	Upper and Lower Egypt 
二川孝广	Takahiro Futagawa 
寿天里	Shoutianli 
英格堡·哈康斯多塔	Engelberg Hakonsdota 
天主教克拉科夫总教区	Catholic Archdiocese of Krakow 
阿肯色大学	University of Arkansas 
中国中央电视台阿拉伯语国际频道	China Central Television Arabic International Channel 
藤原赖通	Fujiwara Raito 
三乡町	Sango Town 
胡大为	Hu Dawei 
孙仲斌	Sun Zhongbin 
维特尔斯巴赫王朝	Wittelsbach Dynasty 
blera	purchased 
弗朗索瓦·奥尔良_(儒安维尔亲王)	Francois Orleans_ (Prince Junville) 
色常在	Color is always in 
俄罗斯天然气工业股份公司	Gazprom 
商务喷射机	Business jet 
纽卡斯尔联喷气机	Newcastle United Jets 
第一财政大臣	First Minister of Finance 
湖南烈士公园	Hunan Martyrs Park 
电动方程式	Formula E 
中岸球场	Central Coast Stadium 
德国联邦国防部	German Federal Ministry of Defense 
脑水肿	Brain edema 
新跃大学	Xinyue University 
张翼_(香港演员)	Zhang Yi_ (Hong Kong actor) 
唐·卡洛斯王子	Prince Don Carlos 
方法论的二元主义	Methodological dualism 
新井章太	Shota Arai 
淑哲公主	Princess Shuzhe 
南墨尔本足球俱乐部	South Melbourne Football Club 
西尾铁也	Nishio Tetsuya 
天津火车头体育场	Tianjin Lokomotiv Stadium 
拼音文字	alphabetic writing 
赤祖德赞	Chizu Dezan 
大谷吉继	Otani Yoshiki 
唐佳丽	Tang Jiali 
福冈工业大学	Fukuoka Institute of Technology 
曹海清	Cao Haiqing 
汉诺威莱布尼兹大学	Leibniz University of Hannover 
阿尔塔薛西斯二世	Artaxerxes II 
水里溪	Shuilixi 
伏尔加保加利亚	Volga Bulgaria 
中国美术学院	China Art College 
中华人民共和国全国人民代表大会组织法	Organic Law of the National People's Congress of the People's Republic of China 
超限抑制	Overrun suppression 
哈萨克斯坦议会下院	Lower House of the Parliament of Kazakhstan 
&mkz	& mkz 
全珉洸	Quan Min 
圣尼古拉球场	San Nicolas Stadium 
jp:源伦子	jp: Yuan Renzi 
恩戈贝-布格雷特区	Ngobe-Bugretto 
新洛哈	New Loha 
海尔·塞拉西一世	Haile Selassie I 
马蒂尔德一世_(布洛涅)	Matilde I_ (Boulogne) 
奥地利足球协会	Austrian Football Association 
不伦瑞克统治者列表	List of Brunswick rulers 
美国参谋长联席会议主席	Chairman of the Joint Chiefs of Staff 
石柜洋祐	Yosuke Ishibitsu 
民主党_(日本1947年)	Democratic Party_ (Japan 1947) 
埃里希·冯·曼施坦因	Erich von Manstein 
英格兰pfa最受欢迎球员	The most popular player in England pfa 
郑满植	Zheng Manzhi 
贝塔斯曼音乐集团	Bertelsmann Music Group 
自由职业	Freelance 
美国驻伊拉克大使	U.S. Ambassador to Iraq 
塔恩-加龙省	Tarn-Garonne 
章缜翔	Zhang Zhenxiang 
洛城孤独男孩乐团	Lonely Boys 
迪恩考特球场	Dean Court Stadium 
龙翔官立中学	Longxiang Government Secondary School 
ocn日曜连续剧	ocn sun TV series 
庞蒂弗拉克特城堡	Pontefract Castle 
模拟城市_(2013年游戏)	Sim City_ (2013 game) 
路易-菲利普二世_(奥尔良公爵)	Louis-Philippe II_ (Duke of Orleans) 
欧姆接触	Ohmic contact 
布拉克内尔_(英国国会选区)	Bracknell_ (British Parliamentary District) 
乐山大佛	Leshan Giant Buddha 
佛陀国际赛道	Buddha International Circuit 
杂交弦理论	Hybrid string theory 
亚的斯亚贝巴公爵	Duke of Addis Ababa 
西川善久	Yoshihisa Nishikawa 
香港一百五十元纸币	Hong Kong One Hundred and Fifty Dollar Notes 
凯特做了什么	What did kate do 
朝鲜哲宗	Cheljong of Korea 
.md	.md 
沙皇俄国	Tsarist Russia 
欧塞奇县_(奥克拉荷马州)	Osage County_ (Oklahoma) 
张瑞华	Zhang Ruihua 
西部非洲	West Africa 
淑慎皇贵妃	Emperor Shushen 
加拿大司法部	Canadian Department of Justice 
比利时利奥波德大绶章勋章	Grand Ribbon Medal of Leopold, Belgium 
廉基勋	Lien Jixun 
弗雷德里克·斯图尔特_(澳大利亚政治家)	Frederick Stewart (Australian politician) 
巴黎cac40指数	Paris cac40 index 
自由及开放原始码软体	Free and open source software 
渥斯特学院	Worcester College 
吉布提中央银行	Central Bank of Djibouti 
铁路大亨系列	Railway Tycoon Series 
巴黎第十区	Paris 10th district 
愍太后	The Queen Mother 
阿根廷五月革命	Argentina May Revolution 
黄承晖谢敏瑜告别式	Huang Chenghui Xie Minyu farewell ceremony 
威尔斯行政区划	Administrative divisions of Wales 
佳贵妃	Jia Guifei 
阿根廷总统府	Presidential Palace of Argentina 
大琉璃	Da Liuli 
保守党未来苏格兰	Conservative Party Future Scotland 
本杰明·富兰克林·巴特勒_(马萨诸塞州政治家)	Benjamin Franklin Butler_ (Massachusetts statesman) 
牙与爪	Tooth and claw 
全球绿党	Global Green Party 
池田厚子	Atsuko Ikeda 
阿拉伯联合酋长国军事	United Arab Emirates Military 
革命社会主义	Revolutionary socialism 
迈蒂利文	Maitillivan 
毕尔巴鄂竞技俱乐部	Athletic Club Bilbao 
冰岛联赛杯	Iceland League Cup 
和田拓也	Takuya Wada 
马哈奇卡拉	Makhachkala 
多哥团结党	Togolese Solidarity Party 
水道桥站	Suidobashi Station 
陆军副参谋长	Deputy chief of staff of the army 
杰威尔音乐	Jewel Music 
杉浦恭平	Kyohei Sugiura 
英格兰王位继承人列表	List of heirs to the throne of England 
德兰士瓦殖民地	Transvaal Colony 
jp:ハン・ジェホ	jp: Han Jae Ho 
小暮大器	Xiaomu Daqi 
刑警二人组	Criminal Duo 
考文垂	Coventry 
电气指令式空气制动	Electrical command air brake 
金园英学	Kim 园 English studies 
瑞士16岁以下国家足球队	Switzerland under-16 national football team 
圣玛丽斯县_(马里兰州)	St. Marys County_ (Maryland) 
徐永昌	Xu Yongchang 
日语书写系统	Japanese writing system 
第一届工作内阁	The first working cabinet 
白语支	Bai language branch 
池忠国	Chi Zhongguo 
新加坡环境及水源部	Ministry of Environment and Water Resources of Singapore 
保加利亚共和国	Republic of Bulgaria 
哈尔滨国际会展中心体育场	Harbin International Convention and Exhibition Center Stadium 
西班牙银行	Bank of Spain 
freakbeat	freakbeat 
英国政府	British government 
斗山集团	Doosan Group 
卡泽诺维亚学院	Cazenovia College 
亚历山大·蒙巴顿，第一代卡里斯布鲁克侯爵	Alexander Mountbatten, the first Marquis of Carisbrooke 
威根竞技	Wigan Athletic 
1993年亚洲女子足球锦标赛	1993 Asian Women's Football Championship 
联邦主体市	Federal City 
新贵人_(乾隆帝)	Upstart_ (Emperor Qianlong) 
副省级市辖区	Sub-provincial city district 
莱斯特大学	University of Leicester 
泰甸尼球场	Tideini Stadium 
鬼同你ot	Ghost with you ot 
中国足彩网	China Football Lottery 
tarragonès	Tarragona 
基督硬核	Christ Hardcore 
玛利欧系列	Mario series 
周伯华	Zhou Bohua 
西班牙陆军	Spanish Army 
爱上丑八怪	Fall in love with ugly 
庞加莱猜想	Poincaré Conjecture 
弗里德里希王子_(黑森和莱茵)	Prince Friedrich_ (Hesse and Rhein) 
标准铁轨	Standard rail 
小牛唱片	Mavericks Records 
堂安律	Don Anlu 
欧洲共产主义	European Communism 
雅各布森语言功能	Jacobson language features 
器乐摇滚	Instrumental Rock 
梁思浩	Liang Sihao 
新浪潮	New wave 
千里达及托巴哥	Trinidad and Tobago 
特普利采足球俱乐部	Teplice Football Club 
西班牙足协杯	Spanish Football Association Cup 
天安门广场	Tiananmen Square 
弱相互作用	Weak interaction 
松方巌	Iwao Matsukata 
阿克托比足球俱乐部	Aktobe Football Club 
黑龙江省_(中华民国)	Heilongjiang Province_(Republic of China) 
信德大学	Sindh University 
埃克塞特公爵夫人约克的安妮	Anne of York, Duchess of Exeter 
德国联邦财政部	German Federal Ministry of Finance 
罗马尼亚众议院	Romanian House of Representatives 
.il	.the 
伊凡四世	Ivan IV 
疗伤篇	Healing 
皮尔斯县_(华盛顿州)	Pierce County_ (Washington State) 
沈阳河畔足球俱乐部	Shenyang Riverside Football Club 
王德麟	Wang Delin 
艾历斯积‧维斯拿高夫斯	Elisj Wisnagoffs 
图形处理器	Graphics processor 
锡比乌	Sibiu 
祖拉布.日瓦尼亚	Zurab Zhivania 
新特兰北_(英国国会选区)	New Zealand North_(British Parliamentary District) 
薛尼·施斯奥拿	Xueni Shisona 
.vn	.VN 
霹雳-5导弹	Thunderbolt-5 missile 
早矢仕洋介	Yosuke Hayashi 
恰德察	Chadca 
山阶宫晃亲王	Prince Yamagai Miyako 
中华人民共和国高等教育部	Ministry of Higher Education of the People's Republic of China 
亨利·巴瑟斯特，第三代巴瑟斯特伯爵	Henry Bathurst, the third Earl of Bathurst 
上海市人民政府	Shanghai Municipal People's Government 
车库庞克	Garage Punk 
一等站_(中国大陆)	First Class Station_ (Mainland China) 
平泉成	Hiraizumi 
町田文人	Machida Literati 
file:dreamcast_logo.svg	file:dreamcast_logo.svg 
starstrukk	starstrukk 
管理委员会主席	Chairman of the Management Committee 
奥入濑溪流	Oirase Stream 
美国舰队总司令	Commander-in-chief of the united states fleet 
马其顿东正教会	Macedonian Orthodox Church 
阿西西	Assisi 
出包王女	To Love-Ru Princess 
温彻斯特城堡	Winchester Castle 
弗兰基球场	Frankie Stadium 
丹麦君主	Danish monarch 
来自塔拉哈西的人	People from Tallahassee 
弗鲁埃拉二世_(莱昂)	Frueira II_ (Leon) 
小埃里克·欣普顿·霍尔德	Eric Himpton Holder Jr. 
探索性数据分析	Exploratory data analysis 
瑞典银行球场	Swedish Bank Stadium 
东莞话	Dongguan dialect 
间接民主	Indirect democracy 
威力流行	Power Pop 
新井凉平	Ryohei Arai 
国际足联俱乐部世界杯	FIFA Club World Cup 
廖宝珊纪念书院	Liu Po Shan Memorial College 
丰能町	Toyono Town 
阿塞拜疆足球协会	Azerbaijan Football Association 
爱久见人心	Love for a long time 
智利人	Chilean 
眨眼182	Blink 182 
詹姆斯·劳瑟，第一代厄尔斯沃特子爵	James Lowther, 1st Viscount Ullswater 
天主教惠灵顿总教区	Catholic Archdiocese of Wellington 
内地延长主义	Mainland Extensionism 
陈丕显	Chen Pixian 
贝尔格莱德市长	Mayor of Belgrade 
朝鲜显宗	King Hyeonjong 
bukittinggi	high hill 
福克兰群岛总督	Governor of the Falkland Islands 
无线通讯	Wireless communication 
城市足球场	City Football Stadium 
巴尔的摩子弹_(1944年–1954年)	Baltimore Bullet_ (1944–1954) 
越南邮政编码	Vietnam Postcode 
美国财政部司库	Treasurer of the U.S. Treasury Department 
空中客车直升机公司	Airbus Helicopters 
高卢-罗曼语	Gaul-Romanian 
切尔伍德的塞西尔子爵	Viscount Cecil of Chelwood 
中华人民共和国国防委员会	National Defense Commission of the People's Republic of China 
剑桥大学圣约翰学院	St. John's College, Cambridge University 
约阿希姆·冯·里宾特洛甫	Joachim von Ribbentrop 
约维尔足球俱乐部	Yeovil Football Club 
苏联乌克兰战争	Soviet Ukraine War 
橘郡风云_(第二季)	Orange County Storm_(Season 2) 
里苏诺夫li-2	Lisunov li-2 
中华民国统帅旗	Flag of the Republic of China 
广东昊昕贸易足球俱乐部	Guangdong Haoxin Trade Football Club 
国务院新闻办公室	State Council Information Office 
上加龙省	Haute-Garonne 
昆明铁路局	Kunming Railway Bureau 
柏克莱加州大学	University of California, Berkeley 
中正国防干部预备学校	Zhongzheng National Defense Cadre Preparatory School 
晶体动力	Crystal power 
巴西军政府	Brazilian military government 
巴耶济德一世	Bayezid I 
mnek	From you 
音乐作曲家	Music composer 
松原市_(消歧义)	Songyuan City_(Disambiguation) 
日本鸡	Japanese chicken 
墨西哥足球甲级联赛	Mexican Football League 
上海绿地申花	Shanghai Greenland Shenhua 
南非行政区划	Administrative divisions of South Africa 
伊庇鲁斯专制国	Autocracy of Epirus 
法国摇滚	French rock 
布莱顿肯普敦_(英国国会选区)	Brighton Kempton_(British Parliamentary District) 
前326年	326 years ago 
光度感应器	Light sensor 
细菌学	Bacteriology 
荷兰副首相	Deputy Prime Minister of the Netherlands 
八代英太	Eita Yashiro 
大治町	Oharu Town 
提乌德拉德	Tiudrad 
德岛县民歌	Tokushima Prefecture Folk Song 
天河东站	Tianhe East Railway Station 
达沙功	Dasha Gong 
第二海务大臣	Second sea minister 
低地法兰克语	Lowland Frank 
郁文_(乔石夫人)	Yu Wen_(Mrs. Qiao Shi) 
伊拉克陆军	Iraqi Army 
科图拉	Kotura 
信仰的意志	Will of faith 
奥里基战役	Battle of Oriki 
中央军委联合作战指挥中心	Central Military Commission Joint Operations Command Center 
英国宇航	British Aerospace 
台上里	Taijo-ri 
艾佩克公司	Apec 
维也纳学派	Vienna School 
塞罗竞技俱乐部	Cerro Athletic Club 
增宫章子内亲王	Prince Zoumiya Zhangzi Nei 
影片分享网站	Video sharing site 
美国偶像_(第一季)	American Idol_ (Season One) 
高加索人种	Caucasian Ethnicity 
凌成兴	Ling Chengxing 
禾路迪高	Herruti 
经济统计学	Economic Statistics 
北京101中学	Beijing 101 Middle School 
麦迪逊_(印第安纳州)	Madison_ (Indiana) 
挛生地球	Spasm earth 
羽原信义	Habara Xinyi 
冰岛语学院	Icelandic Language Institute 
lamport面包店算法	lamport bakery algorithm 
北维吉尼亚军团	Northern Virginia Army 
中文流行音乐	Chinese pop music 
.ch	.h 
特尔斯达足球俱乐部	Telsda Football Club 
人类身高	Human height 
匹克威克外传	Pickwick Gaiden 
大清宝钞	Great Qing Treasures 
法国号	French Horn 
黑田清子	Sayako Kuroda 
美国国家数学研究所	National Institute of Mathematics 
高木彰人	Takagi Akira 
大野城市	Ono City 
新世纪福音战士	Evangelion 
伍咏诗	Wu Yongshi 
爱子内亲王	Prince within Aiko 
上小阿仁村	Kamikoani Village 
台湾原住民族	Taiwan Indigenous Peoples 
菲律宾足球协会	Philippine Football Association 
剑桥大学菲茨威廉学院	Fitzwilliam College, Cambridge University 
南京坤宁流体足球俱乐部	Nanjing Kunning Fluid Football Club 
格鲁吉亚国家科学院	National Academy of Sciences of Georgia 
爱民邨	Aimin Village 
2014–15年欧洲冠军联赛	2014-15 UEFA Champions League 
尤莉娅·季莫申科联盟	Union of Yulia Tymoshenko 
蝙蝠侠群英会	Batman Heroes Club 
德黑兰市议会	Tehran City Council 
村山贮水池	Murayama Reservoir 
教宗列表	Pope list 
塔图因	Tatooine 
巴尔的摩子弹	Baltimore Bullet 
内卡蒂·塔坎	Nekati Takan 
视频编码	Video encoding 
水沼宏太	Kota Mizunuma 
醒吾科技大学	Xingwu University of Science and Technology 
黎雅伦	Li Yalun 
奥克兰国际机场	Oakland International Airport 
圣恭皇后	Queen Saint Christine 
虐杀原形	Prototype 
多米尼加中央银行	Central Bank of Dominica 
维兰柯	Vilanco 
英属印度洋领地专员	Commissioner for British Indian Ocean Territory 
金亨植	Kim Hyung Sik 
筑地俊彦	Toshihiko Tsukiji 
大议会	Great Council 
哈瓦那主教座堂	Havana Cathedral 
郑光荣	Zheng Guangrong 
第二次车臣战争	Second Chechen War 
仁武里	Ren buri 
贺龙体育文化中心	He Long Sports Cultural Center 
克拉伦斯和阿文代尔公爵	Clarence and the Duke of Avondale 
中国人民武装警察部队	Chinese People's Armed Police Force 
t.i.	t.i. 
法国历史	French history 
file:明熹宗像.jpg	file: Munemune statue.jpg 
孝靖太后	Queen Mother Xiaojing 
台语拼音对照表	Taiwanese Pinyin Comparison Table 
野村直辉	Nomura Naoki 
临时政府	Provisional Government 
街坊工友服务处	Neighbourhood Worker Service Office 
nba太平洋赛区	NBA Pacific Division 
努儿·宾特·亚森公主	Princess Noor Bint Yasen 
上尾野边惠	Kamionobe Megumi 
邓燕娥	Deng Yan'e 
富士川町	Fujikawa Town 
唐纳德_(英国驻华大使)	Donald_ (British Ambassador to China) 
新英格兰大学	University of New England 
东京都交通局	Tokyo Metropolitan Bureau of Transportation 
澳大利亚反对党领袖	Leader of the Australian Opposition 
民国纪年	Chronicle of the Republic of China 
进步球场	Progressive Stadium 
超级联盟	Super League 
本桥由香	Yuka Motohashi 
西南德文_(英国议会选区)	Southwest German_(British parliamentary district) 
奥凯航空	Okay Airways 
化学动力学	Chemical kinetics 
古巴爵士乐	Cuban Jazz 
德国哲学家	German philosopher 
多明尼加摇滚	Dominican Rock 
真夜中的纯洁	The purity in the night 
黑森与莱茵公主约翰娜	Hesse and the Rhine Princess Johanna 
俄属远东	Russian Far East 
瑠璃光寺	Ruriko Temple 
斯宾塞·卡文迪许，第八代德文郡公爵	Spencer Cavendish, 8th Duke of Devonshire 
西斯宁缘区政府	Sisnin Border District Government 
巴斯克维尔猎犬	Baskerville Hound 
巴颜喀拉山脉	Bayan Har Mountains 
潘南朴氏	Pan Nam Park 
英国雷诺方程式锦标赛	British Formula Renault Championship 
笹川尧	Sasakawa Yao 
ghosttown_(madonna_song)	ghosttown(madonna song) 
西本浩子	Hiroko Nishimoto 
尖山里	Jianshanli 
艾亚克辛亚侯达	Ayaksin Yahouda 
费利克斯-波莱特球场	Felix-Poulet Stadium 
驸马长江大桥	Luma Yangtze River Bridge 
贞显王后	Queen Jeonghyun 
诚孝昭皇后	Empress Cheng Xiaozhao 
新兵日记	Recruit Diary 
现代石油银行	Hyundai Petroleum Bank 
阿尔达比勒省省长	Governor of Ardabil Province 
美国国徽	U.S. National Emblem 
菲律宾电话号码	Philippines phone number 
九家之书	Book of Jiujia 
马其顿国王	King of Macedonia 
明德学院	Mingde College 
巴西黑黄檀	Brazilian Dalbergia 
你就是希望	You just hope 
刘喆莹	Liu Zheying 
湖南广播电视台	Hunan Radio and Television Station 
王大文	Wang Dawen 
南通古斯语支	Nantong Gusi Branch 
权纯泰	Quan Chuntai 
湖北华创	Hubei Huachuang 
印度外交部	Ministry of Foreign Affairs of India 
紫外灾变	UV catastrophe 
j·c·c·戴维斯，第一代戴维斯子爵	j·c·c·Davis, the first Viscount Davis 
皇家瓦希格都足球俱乐部	Royal Wahigadu Football Club 
丹江	Danjiang 
邓庆林	Deng Qinglin 
黄健庭	Huang Ken Garden 
沙夫豪森足球俱乐部	Schaffhausen Football Club 
公众有限公司	Public limited company 
2012/13赛季欧洲冠军联赛	2012/13 season UEFA Champions League 
威廉明娜公主_（普鲁士）	Princess Wilhelmina_ (Prussia) 
积极的斯洛文尼亚	Active Slovenia 
福利经济学基本定理	Fundamental Theorems of Welfare Economics 
天文期刊	Astronomical Journal 
塞浦路斯乙组足球联赛	Cyprus Group B Football League 
岸祐二	Yuji Kishi 
侦探小说	Detective story 
樱田和树	Sakurada Kazuki 
鲍德熹	Bao Dexi 
黑塔i_最后的枪客	Dark Tower i_ The Last Gunner 
松平赖之	Satoshi Matsudaira 
伊比鸠鲁学派	Epicurean School 
东伊朗次语支	East Iranian sub-language branch 
伯利兹总理	Prime Minister of Belize 
德意志非洲军	German African Army 
斐济储备银行	Reserve Bank of Fiji 
日本百合	Japanese lily 
蓝草音乐	Bluegrass Music 
大高忍	Otaka Shinobu 
信义_(电视剧)	Xinyi_(TV series) 
唱片制作	Record production 
伍代参平	Sanpei Godai 
辽宁青年队	Liaoning Youth Team 
.ru	.Such as 
葛珮帆	Ge Peifan 
华伦西亚马斯泰拿	Valencia Masters 
宏池会_(古贺派)	Hongchihui_(Guhe School) 
塔希提足球总会	Tahitian Football Association 
多纪皇女	Princess Taki 
莫斯科战役	Battle of Moscow 
爱迪生_(新泽西州)	Edison_ (New Jersey) 
叶问_(电视剧)	Ip Man_(TV series) 
第七感_(张靓颖专辑)	Seventh Sense_ (Zhang Jingying Album) 
自然主义文学	Naturalistic literature 
中国音乐学院	China Conservatory of Music 
单方面宣布独立	Unilateral declaration of independence 
安陵_(阮朝)	An Ling_(Nguyen Dynasty) 
贝尔格莱德围城战_(1456年)	Siege of Belgrade_ (1456) 
协调世界时	Coordinated Universal Time 
东大门运动场	Dongdaemun Stadium 
欢瑞世纪	Huan Rui Century 
华英中学	Huaying Middle School 
克罗地亚国会	Croatian Parliament 
菲尔兹奖	Fields Medal 
土岐田洸平	Kohei Tokita 
天后之战	Battle of the Queens 
左轮丝绒	Revolver Velvet 
乔治亚公民联盟	Georgia Citizens League 
兴化平话字	Xinghua Pinghua Characters 
印第安纳州各市镇列表	List of municipalities in Indiana 
美国副国务卿	United States Deputy Secretary of State 
韩国天主教大学	Catholic University of Korea 
隧道视觉	Tunnel vision 
恭嫔崔氏	Christine Choi 
萨克森-科堡	Saxony-Coburg 
费迪南七世	Ferdinand VII 
中央人民政府高等教育部	Ministry of Higher Education of the Central People's Government 
中信资本	CITIC Capital 
联邦陆军	Federal army 
若昂皮涅鲁	Joao Pinheiro 
罗伊特林根足球俱乐部	Reutlingen Football Club 
victor娱乐	victor entertainment 
西乡隆盛	Xixiang Longsheng 
黎颖瑜	Li Yingyu 
犹太-叶门语	Jewish-Yemen 
哥伦比亚唱片公司	Columbia Records 
闵鹿蕾	Min Lulei 
灵圭和尚	Linggui monk 
自由放任	Laissez faire 
前770年代	770 years ago 
角宿里	Spica 
大连龙卷风足球俱乐部	Dalian Tornado Football Club 
大卫靴拔	David Bootstrap 
电子游戏历史_(第七世代)	Video game history_ (seventh generation) 
蜂鸟音乐	Hummingbird Music 
费利佩_(阿斯图里亚斯亲王)	Felipe_ (Prince of Asturias) 
wii平衡器	wii balancer 
对对碰	Bump 
菅沼实	Suganuma 
.nc	.nc 
空中突击	Air assault 
唐寅	Tang Yin 
小选区制	Small constituency 
查普特佩克战役	Battle of Chapultepec 
藤原殖子	Fujiwara 
大人情歌_(电视剧)	Love Songs for Adults_ (TV Series) 
印度国民军	Indian National Army 
小亚细亚字母	Asia Minor 
ecm唱片	ecm record 
比利时足球丙级联赛	Belgian Football League C 
记录的地平线	Recorded horizon 
沈振来	Shen Zhenlai 
lg电子	lg electronics 
国立中兴大学	National Chung Hsing University 
查尔斯·皮尔庞特，第二代曼弗斯伯爵	Charles Pierpont, second Earl of Manvers 
玄朱妮	Hyun Juni 
罗明_(央视副台长)	Luo Ming_(Deputy Director of CCTV) 
弗朗西丝卡·提森-博内米萨	Francesca Thyssen-Bornemisza 
石井圭太	Keita Ishii 
列宁奖	Lenin Prize 
国际足协球证	FIFA Football Card 
新墨西哥大学	University of New Mexico 
普鲁士公园	Prussian Park 
喜羊羊与灰太狼	Pleasant Goat and Big Big Wolf 
陈勇_(社会工作者)	Chen Yong_(Social Worker) 
中嶋悟	Satoru Nakajima 
李堈	Li Jie 
布兰达·黑尔_(里奇蒙德的黑尔女男爵)	Brenda Hale (Baroness Hale of Richmond) 
陆军元帅	Field Marshal 
博多南车站	Hakata South Station 
电视电影	TV movie 
君士坦丁二世	Constantine II 
四朵金花	Four golden flowers 
希尔德加德_(路易二世之女)	Hildegard_ (daughter of Louis II) 
库尔德语字母	Kurdish 
小阿格里皮娜	Little Agrippina 
美国夏威夷联邦地区法院	United States District Court of Hawaii 
法国省际列车	French interprovincial train 
东帝汶国防军	East Timor Defence Force 
维斯瓦河-奥德河攻势	Vistula-Oder Offensive 
法国元帅	Marshal of France 
戴季陶	Dai Jitao 
宾夕法尼亚州立大学尼塔尼雄狮队	Penn State University Nittany Lions 
高阆仙	Gao Langxian 
廖正豪	Liao Zhenghao 
黎辅陈	Li Fuchen 
香港印钞	Hong Kong Banknote Printing 
中华民国海军军官学校	Republic of China Naval Academy 
印度议会	Indian Parliament 
金星勋章	Gold Star Medal 
苏格兰足总杯	Scottish FA Cup 
下村宏	Shimomura Hiroshi 
摇滚歌剧	Rock opera 
军旅音乐	Military music 
第一书记	First secretary 
白天的星星	Stars during the day 
汪小敏	Wang Xiaomin 
北陆地方	Hokuriku place 
日野资康	Hino Yuyasu 
.ng	.ng 
bischofsmais	bischofsmais 
海河教育园足球场	Haihe Education Park Football Field 
埃塞尔斯坦_(肯特国王)	Ethelstein_ (King of Kent) 
内田小百合	Sayuri Uchida 
刘澜波	Liu Lanbo 
苏尔坦·本·阿卜杜勒-阿齐兹·阿勒沙特	Sultan Bin Abdul-Aziz Al Shat 
拉丁美洲政党联盟	Latin American Political Party Alliance 
酒井一圭	Sakai Kazue 
中国人民解放军军徽	Chinese People's Liberation Army Military Emblem 
中国北方与南方	North and South China 
赵静蓉	Zhao Jingrong 
2012年亚足联冠军联赛	2012 AFC Champions League 
ödemiş	paid 
美梅积	Mei Meiji 
pdp-11	PDP-11 
特热邦	Trebon 
青木干雄	Aoki Mikio 
功二级	Grade 2 
结城秀康	Hideyasu Yuki 
北卡罗来纳州立农业与理工大学	North Carolina State Agricultural and Technological University 
伊朗历	Iranian calendar 
国会山圆形大厅	Capitol Hill Rotunda 
新俄罗斯	New Russia 
花冠之泪	Tears of Corolla 
女子世界杯足球赛	Women's World Cup 
中国共产党第十七次全国代表大会	The 17th National Congress of the Communist Party of China 
坂口博信	Hironobu Sakaguchi 
蓝天工作室	Blue Sky Studio 
陈晓霖	Chen Xiaolin 
小奇兵	Little Rock 
埃利奥特·罗斯福一世	Elliott Roosevelt I 
裴晋勇	Pei Jinyong 
圣雷米教堂	Saint Remy Church 
长谷川博一	Hasegawa Hiroichi 
江天佑	Jiang Tianyou 
灵魂摇滚	Soul rock 
华约入侵捷克斯洛伐克	Warsaw Pact invades Czechoslovakia 
第二届夏赫里尔内阁	The 2nd Chahril Cabinet 
罗巴切夫斯基奖章	Lobachevsky Medal 
巴拉圭中央银行	Central Bank of Paraguay 
金日成竞技场	Kim Il Sung Arena 
端懿王后	Queen Duan Yi 
连续电视小说	Serial TV novel 
越-芒语支	Vietnamese-Mango 
虚拟机器	Virtual machine 
韦恩威斯巴登足球俱乐部	Wayne Wiesbaden Football Club 
国家首都区	National Capital Region 
甘地讷格尔	Gandhinagar 
摩达中心	Moda Center 
勒瓦卢瓦-佩雷	Levallois-Perret 
马德拉斯总督	Governor of Madras 
美法短暂冲突	Brief conflict between the United States and France 
template:美国财政部下属单位	template: A unit of the U.S. Department of the Treasury 
西南研究学会	Southwest Research Society 
秋田车辆中心	Akita Vehicle Center 
日本庭园	Japanese garden 
中央军事委员会审计署	Central Military Commission Audit Office 
永安公主	Princess Yongan 
同和会	Dowakai 
米底捷斯基球场	Medizeski Stadium 
苏玛雅·宾特·哈桑公主	Princess Sumaya Bint Hassan 
山梨县旗	Yamanashi flag 
mtv电影大奖	mtv movie awards 
庄妃_(嘉庆帝)	Princess Zhuang_(Jiaqing Emperor) 
柳原前光	Sakimitsu Yanagihara 
李柱益	Li Zhuyi 
荷兰历史	Dutch history 
持久自由行动	Operation Enduring Freedom 
楚科奇人	Chukchi 
.zm	.zm 
滨口雄幸	Osachi Hamaguchi 
荒木伸吾	Shingo Araki 
加齐普尔	Gazipur 
玛格丽塔公主_(帕尔马)	Princess Margarita_ (Parma) 
快乐快乐月刊	Happy Happy Monthly 
台湾闽南语	Taiwanese Hokkien 
机场第二航厦站	Airport Terminal 2 Station 
机械瞄具	Mechanical sight 
上萨瓦省	Haute-Savoie 
肯特的琼	Joan of Kent 
长沙南动车运用所	Changsha South Railway Station 
黎保德	Li Baode 
乔治·劳埃德，第一代劳埃德男爵	George Lloyd, the first Baron Lloyd 
八月革命	August Revolution 
利府町	Rifu Town 
贝乌哈图夫gks足球俱乐部	Beukhatov gks football club 
生活大爆炸_(第一季)	The Big Bang Theory_ (Season One) 
洋基体育场	Yankee Stadium 
秘密与谎言	Secrets and lies 
进步保守主义	Progressive conservatism 
铃木一智	Suzuki Kazuo 
库娜涅	Kunane 
金三角名校	Golden Triangle School 
日本唱片大奖	Japan Record Awards 
血色花园	Scarlet Garden 
佛得角足球协会	Cape Verde Football Association 
玛丽医院	Mary Hospital 
瓦尔德玛四世	Valdemar IV 
英格兰足球依斯米安联赛甲组北区	English Football Ismian League First Division North 
希腊城邦	Greek city state 
file:песня_хорста_весселя.ogg	file: песня_хорста_весселя.ogg 
电视广播（国际）	Television Broadcast (International) 
澳洲23岁以下国家足球队	Australia Under 23 National Football Team 
曾凤如	Zeng Fengru 
天国的嫁衣	Heavenly Wedding Dress 
德国西欧战区	German Western Europe Theater 
黎巴嫩行政区划	Administrative divisions of Lebanon 
御前大臣	Your Minister 
森下仁志	Hitoshi Morishita 
演员工作室	Actor studio 
巴西国家u17足球队	Brazil national u17 football team 
达高‧保素域	Daco 
关岛国家足球场	Guam National Football Stadium 
郭亮	Guo Liang 
公馆站	Gongguan Station 
曼殊院宫譲仁亲王	Prince Churen of Manshu Monastery 
天主教马塔加尔帕教区	Catholic Diocese of Matagalpa 
西维吉尼亚州众议院	West Virginia House of Representatives 
孟庆树	Meng Qingshu 
社会主义共和制	Socialist republic 
青岛黄海制药足球俱乐部	Qingdao Huanghai Pharmaceutical Football Club 
爱在记忆中找你	Love in the memory to find you 
九头龙川	Nine Dragons 
.ag	.ag 
bh娱乐	bh entertainment 
加拿大上议院	House of Lords of Canada 
维亚康姆_(1971–2005)	Viacom_ (1971–2005) 
amends	amends 
妇女及平等部长	Minister of women and equality 
上海虹桥国际机场	Shanghai Hongqiao International Airport 
妮姬和保罗	Nicky and Paul 
森田刚	Morita Go 
圣地亚哥-德智利	Santiago de Chile 
格拉德斯通_(昆士兰州)	Gladstone_ (Queensland) 
小野田英一	Eiichi Onoda 
资讯处理语言	Information processing language 
斯诺霍米什县_(华盛顿州)	Snohomish County_ (Washington State) 
地区地名查询系统	Regional place name query system 
韦恩县_(密歇根州)	Wayne County_ (Michigan) 
巴基斯坦西北部战争	War in Northwest Pakistan 
皮集蓬	Pichipong 
汤宝芳	Tang Baofang 
瑞士国民院	Swiss National Council 
拉贾·纳因戈兰	Raja Naingoran 
杜建时	Du Jianshi 
氛围浩室	Atmosphere house 
济南站	Jinan Railway Station 
布拉格捷克理工大学	Czech Technical University in Prague 
阿部正俊	Masatoshi Abe 
马尔堡大学	University of Marburg 
苏联共产党中央书记处	Central Secretariat of the Communist Party of the Soviet Union 
大勲位	Damenwei 
阿尔科尔孔	Alcorcon 
纽黑文市	New Haven City 
碧海潮生曲	Bihai Chaosheng Song 
奄美语	Amami 
朴次茅斯_(新罕布什尔州)	Portsmouth_ (New Hampshire) 
中村悠一	Yuichi Nakamura 
义大利足球总会	Italian Football Association 
潘演	Pan Yan 
赵志敬	Zhao Zhijing 
法荷战争	French-Dutch War 
和泉市	Izumi 
文献昭圣皇后	Literature Zhaosheng Queen 
小坪里	Xiaopingli 
欧洲之星（英国）有限公司	Eurostar (UK) Ltd 
武井択也	Takuya Takei 
面向过程程序设计	Process-oriented programming 
奥尔登堡大公国	Grand Duchy of Oldenburg 
他他拉氏	Tatarashi 
摇滚名人堂	Rock and Roll Hall of Fame 
弗里德里希·弗朗茨四世_(梅克伦堡-什未林)	Friedrich Franz IV (Mecklenburg-Schwerin) 
2016年中华民国立法委员选举	2016 election of legislators of the Republic of China 
前11世纪	11th century BC 
芝加哥蓝调	Chicago Blues 
桑乔·奥多尼斯一世	Sancho Odonis I 
查普尔特佩克城堡	Chapultepec Castle 
南非标准时间	South Africa Standard Time 
pc-dos	pc-two 
李相德	Li Xiangde 
矢岛由纪	Yajima Yuki 
堀河丰子	Toyoko Horikawa 
caribou唱片	caribou record 
马利亚_(耶稣的母亲)	Mary_(Mother of Jesus) 
古代哲学	Ancient philosophy 
坎特伯里_(新南威尔斯州)	Canterbury_ (New South Wales) 
桂柳话	Guiliu Dialect 
顶峰娱乐	Summit Entertainment 
普罗旺斯的玛格丽特	Marguerite of Provence 
列斐伏尔	Lefebvre 
上将_(皇家海军)	Admiral_ (Royal Navy) 
利特尔顿_(科罗拉多州)	Littleton_ (Colorado) 
安那考斯迪亚河	Anacostia 
亨利·查尔斯·基思·佩蒂-菲茨莫里斯，第五代兰斯当侯爵	Henry Charles Keith Petty-Fitzmorris, the fifth Marquis of Lansdowne 
黎晋才	Li Jincai 
美国战争部	United States Department of War 
威灵顿英文中学	Wellington English Secondary School 
塩田仁史	Hitoshi Shiota 
斐迪南一世_(神圣罗马帝国)	Ferdinand I_ (Holy Roman Empire) 
马来西亚华人公会	Malaysian Chinese Association 
十二月初九	December Nine 
教宗庇护八世	Pope Pius VIII 
韦永庚	Wei Yonggeng 
巴布亚新几内亚大学	University of Papua New Guinea 
牛津大学彭布罗克学院	Pembroke College, Oxford University 
花莲台开女子足球队	Hualien Taikai Women's Football Team 
福斯电视工作室	Fox TV Studio 
利比亚镑	Libyan Pound 
翡翠卫星台	Emerald Satellite Station 
邓莫尔勋爵之战	Battle of Lord Dunmore 
车田正美	Masami Che Tian 
拉瓦尔品第	Rawalpindi 
尤比克争取更好的匈牙利运动	Ubik strives for a better Hungary movement 
浦添极乐陵	Urasoe Mausoleum 
间嶋_佑弥	Majima_Yuya 
清川江战役	Battle of Qingchuan River 
韩鹏飞_(足球运动员)	Han Pengfei_ (football player) 
天津奥林匹克体育中心体育场	Tianjin Olympic Sports Center Stadium 
.mp	.mp 
后卫战役	Defender battle 
罗伯特·达西，第四代霍尔德内斯伯爵	Robert Darcy, the 4th Earl of Holderness 
原田开	Harada Kai 
司法辖区	Jurisdiction 
中国电信	China Telecom 
三笠宫	Mikasa Palace 
广岛与长崎原子弹爆炸	Hiroshima and Nagasaki atomic bombings 
神奇先生	Mr. Fantastic 
印度足球乙级联赛	Indian Football League 
青藏铁路公司	Qinghai-Tibet Railway Company 
自然哲学	Natural philosophy 
高松信司	Shinji Takamatsu 
欧洲迪士尼sca	Euro Disney sca 
阿拉米达县_(加利福尼亚州)	Alameda County_ (California) 
美洲解放者球场	Liberators of america 
许应深	Xu Yingshen 
缺宅男女	Homeless men and women 
六条天皇	Rokujo Emperor 
图林根的巴西娜	Basina of Thuringia 
奥萨苏纳竞技b队	Osasuna Athletic b team 
babaroga_(游戏公司)	babaroga_ (game company) 
航海体育场	Nautical Stadium 
李南星	Li Nanxing 
南部摇滚	Southern rock 
前206年	206 years ago 
kongstedlund	kongstedlund 
马尔他中央银行	Central Bank of Malta 
施人诚	Shi Rencheng 
葡萄牙18岁以下国家足球队	Portugal Under-18 National Football Team 
韩国流行	Korean pop 
班夫和布臣_(英国国会选区)	Banff and Bouchen_(British Parliamentary District) 
阿尔塞塔斯二世_(伊庇鲁斯)	Alsetas II_ (Epirus) 
李宪宰	Lee Hyun Jae 
banjarese	banjarese 
捷克国家银行	Czech National Bank 
乌克兰希腊礼天主教费城总主教	Ukrainian Greek Catholic Archbishop of Philadelphia 
墨西哥17岁以下国家足球队	Mexico Under-17 National Football Team 
沪杭磁悬浮交通项目	Shanghai-Hangzhou Maglev Transportation Project 
罗德岛大学	University of Rhode Island 
塞琉古四世	Seleucid IV 
inscript_(javascript_engine)	inscript_(javascript_engine) 
塞尔维亚王国	Kingdom of Serbia 
北高加索叛乱	North Caucasus Rebellion 
占语支	Cham 
爱贝克思唱片	Abex Records 
伊朗民族阵线	National Iranian Front 
大众帕萨特	Volkswagen Passat 
侠客行_(2002年电视剧)	Xia Ke Xing_ (2002 TV series) 
露丝·汉丁顿-维莉	Ruth Huntington-Villie 
爱媛县旗	Ehime Prefecture Flag 
原子轨道	Atomic orbital 
阿拉摩之战	Battle of the Alamo 
贝勒尼基一世	Beleniki I 
终极动员令：最后的幸存者	Ultimate Mobilization Order: The Last Survivor 
麦觉里_(澳大利亚国会选区)	Macquarie_(Australia Parliamentary District) 
捷克克朗	Czech Koruna 
吉本聪子	Yoshimoto Satoko 
s:中华人民共和国人民检察院组织法	s: Organic Law of the People's Procuratorate of the People's Republic of China 
伊拉克库尔德斯坦总理	Prime Minister of Iraqi Kurdistan 
汶莱-穆阿拉区	Brunei-Muara District 
皮尔马森斯足球俱乐部	Pirmasens Football Club 
蜂须贺正韶	Bee Suga Zhengshao 
横滨市歌	Yokohama City Song 
火蛇70航空火箭弹	Fire snake 70 aviation rocket 
地球同步轨道	Geosynchronous orbit 
英属处女群岛总督	Governor of the British Virgin Islands 
新竹fc女子足球队	Hsinchu fc women's football team 
机制设计	Mechanism design 
萨普里萨体育俱乐部	Saprisa Sports Club 
独立国家联合体	Commonwealth of Independent States 
波兰20岁以下国家足球队	Poland Under-20 National Football Team 
巴达隆拿足球会	Badalona Football Club 
韦景云	Wei Jingyun 
天中文化	Tianzhong Culture 
白文杰	Bai Wenjie 
华沙市长	Mayor of Warsaw 
战栗时空2：二部曲	Shivering Time 2: Two Steps 
轻小说	light novel 
马拉松体育俱乐部	Marathon Sports Club 
约翰尼·戴维斯_(篮球运动员)	Johnny Davis_ (basketball player) 
卡拉恰伊-切尔克斯共和国	Karachay-Cherkessia Republic 
格鲁吉亚梦想	Georgian dream 
藤原安子	Fujiwara Yasko 
刘建忻	Liu Jianxin 
托尼·霍克职业滑板系列	Tony Hawke Professional Skateboard Series 
亚历克西娅_(希腊公主)	Alexia_ (Princess of Greece) 
阿特南-普赫海姆	Attnang-Puchheim 
澳门特别行政区行政长官选举委员会	Chief Executive Election Committee of Macao Special Administrative Region 
西川公也	Koya Nishikawa 
淡滨尼流浪足球会	Tampines Rangers Football Club 
坂本和哉	Kazuya Sakamoto 
宇都宫恭三	Utsunomiya Kyzo 
慈善机构	Charity 
中央外事工作领导小组办公室	Office of the Central Leading Group for Foreign Affairs 
陈建生_(1956年)	Chen Jiansheng_ (1956) 
里德林根	Riedlingen 
塞琉古二世	Seleucus II 
蒙特利尔地铁	Montreal Metro 
冈田将生	Okada Masao 
马略卡足球俱乐部	Majorca Football Club 
钉宫磐	Nagiyawa 
海军元帅_(英国皇家海军)	Marshal_ (Royal Navy) 
北京地铁	Beijing subway 
爱媛之歌	Song of Ehime 
kotkan_työväen_palloilijat	Eagle Workers Ball Players 
马来西亚令吉	Malaysian Ringgit 
摩尔甘比足球俱乐部	Moregamby Football Club 
黎巴嫩陆军	Lebanese Army 
美国功勋勋章	American Medal of Merit 
老挝君主列表	List of Lao Monarchs 
天主教莫雷利亚总教区	Catholic Archdiocese of Morelia 
小布在哪里	Where is Xiaobu 
超导现象	Superconductivity 
雅基马县	Yakima County 
狐仙的恋爱入门	Introduction to Fox Fairy's Love 
美国东岸	US East Coast 
荷兰财政部	Dutch Ministry of Finance 
佛罗伦萨统治者列表	List of rulers of Florence 
神探伽利略	Detective Galileo 
耶和华见证人	Jehovah's Witnesses 
武部勤	Takebe 
模拟城市之大狂飙	Simulated City Hurricane 
帕克斯足球俱乐部	Parkes Football Club 
拉斯克基础医学研究奖	Lasker Basic Medical Research Award 
织田信秀	Nobuhide Oda 
马来西亚交通部	Ministry of Transport of Malaysia 
当别町	Tobetsu Town 
香港五毫硬币	Hong Kong Five Cents Coin 
德黑兰市长	Mayor of Tehran 
宜万铁路	Yiwan Railway 
和泉宗兵	Shuhei Izumi 
加泰罗尼亚语地区	Catalan region 
中村英之	Nakamura Hideyuki 
安条克公国	Principality of Anjo 
西南政法大学	Southwest University of Political Science and Law 
曼恩伯爵夫人列表	List of Countess Mann 
右翼政党	Right-wing party 
藤原延子_(藤原赖宗女)	Fujiwara Nobiko_(Fujiwara Yoshizong Daughter) 
翁以登	Weng Yideng 
立命馆大学	Ritsumeikan University 
辻野正人	Masato Tsujino 
岩波拓也	Takuya Iwanami 
日本-琉球语系	Japanese-Ryukyu Language 
大仁科技大学	Daren University of Technology 
新亚塞拜然党	New Azerbaijan Party 
爱的耳环	Love earrings 
欧阳常林	Ouyang Changlin 
燕京大学	Yenching University 
熊谷纯	Jun Kumagai 
a&m唱片	a&m record 
邵素云	Shao Suyun 
意大利南部	Southern Italy 
吉尔吉斯行政区划	Administrative divisions of Kyrgyzstan 
叙利亚民主力量	Syrian Democratic Forces 
十月廿五	October 25 
圣但尼_(留尼汪)	Saint-Denis_(Reunion) 
自然选择	natural selection 
民主党_(1996年)	Democratic Party_ (1996) 
詹笔涵	Zhan Bihan 
伊朗伊斯兰共和国防空军	Air Defense of the Islamic Republic of Iran 
古斯塔夫·德·莫利纳里	Gustave de Molinari 
巴尔的摩市议会	Baltimore City Council 
里米尼	Rimini 
妖兽都市(电台节目)	Monster City (radio show) 
苏联入侵波兰	Soviet invasion of Poland 
最终幻想vi	Final fantasy vi 
莫斯科州土星足球俱乐部	Saturn Football Club of Moscow Region 
新日本桥站	Shin Nihonbashi Station 
陈廷煌	Chen Tinghuang 
阿尔泰共和国国歌	National Anthem of the Altai Republic 
男人的故事	Man's story 
万博纪念竞技场	Expo '70 Memorial Arena 
亚洲运动会足球比赛	Asian Games football match 
玻色–爱因斯坦统计	Bose-Einstein Statistics 
韩国电信	Korea Telecom 
尼尔斯·玻尔研究所	Niels Bohr Institute 
中国共产党江西省委员会	Jiangxi Provincial Committee of the Communist Party of China 
多哥总统	President of Togo 
有栖川宫帜仁亲王	Prince Shiren 
南方卫理公会大学	Southern Methodist University 
赞比亚足球协会	Zambia Football Association 
福家勇辉	Fukuoka Yonghui 
皮拉_(西班牙公主)	Pila_ (Spanish Princess) 
安昙野市	Azumino City 
第8军团	8th Army 
老友记_(第六季)	Friends_ (Sixth Season) 
.kg	.kg 
rukiga	learn 
岸诚二	Kishi Seiji 
乔治·戈申，第二代戈申子爵	George Goshen, the second Viscount Goshen 
仍吉德王朝	Still Jidd Dynasty 
模拟农场	Simulation farm 
第三届夏赫里尔内阁	The 3rd Shahriel Cabinet 
岩松荣司	Iwamatsu Eiji 
南达科他州立大学	South Dakota State University 
印度财政部部长	Minister of Finance of India 
坊城伸子	Nobuko Bojo 
苏联国徽	Soviet Union National Emblem 
维格纳定理	Wigner theorem 
筑馆范男	Tsukate Norio 
越难越爱	The harder the more love 
威廉姆斯车队	Williams Team 
叶连娜·奥列格夫娜	Yelena Olegvna 
中川敬辅	Takashi Nakagawa 
nitro+	nitro+ 
德黑兰政治学院	Tehran Institute of Political Science 
青云大学音乐放送系	Department of Music Broadcasting, Qingyun University 
阮福映	Nguyen Phuc Anh 
小䴙䴘	Small creeps 
坦帕湾光芒	Tampa Bay Rays 
网页游戏	Web games 
缅甸联邦议会人民院	People's House of the Union of Myanmar 
凯尔特人公园球场	Celtic Park Stadium 
英国驻越南大使	British Ambassador to Vietnam 
湾仔足球队	Wan chai football team 
崔斗善	Choi Doo Sun 
莱索托首相列表	List of Prime Ministers of Lesotho 
克罗地亚足球乙级联赛	Croatian Football Second Division 
岸野靖之	Yasuyuki Kishino 
韩立明	Han Liming 
全世界无产者，联合起来！	Proletarians of the world, unite! 
黑山足球协会	Montenegro Football Association 
克里基塔特县	Creekitat county 
董冬冬	Dong Dongdong 
南圣卡埃塔诺	San Caetano do Sul 
mi-26直升机	mi-26 helicopter 
尹盛敏	Yin Shengmin 
环境部长	Environment minister 
变速箱软件公司	Transmission Software Company 
幸运薛达	Lucky Xue Da 
会飞的家乡	Hometown that can fly 
让-马丁·沙可	Jean-Martin Shaco 
北白川宫智成亲王	Prince Chisei Kitashirakawa 
首席工作专员	Chief Work Officer 
萨尔瓦多中央储备银行	Central Reserve Bank of El Salvador 
尾本敬	Omoto Kei 
哥利巴里	Colibri 
松平忠和_(岛原藩主)	Tadakazu Matsudaira_ (lord of the island) 
京都町	Kyoto town 
凌时差音乐	Time difference music 
放克核	Funk 
小泉欢晃	Koizumi Kanaki 
最小作用量原理	Principle of least action 
平妃_(康熙帝)	Ping Fei_(Kangxi Emperor) 
葡萄牙社会党	Portuguese Socialist Party 
板仓滉	Itakura 
美国驻英国大使	U.S. Ambassador to the United Kingdom 
大波兰省	Greater Poland 
长春西站	Changchun West Railway Station 
卡尔十六世	Karl XVI 
奥西里斯_(dc漫画)	Osiris_ (dc comics) 
韩国艺术综合大学	Korea National University of Arts 
中央情报总监	Director of Central Intelligence 
大巽他群岛	Greater Sunda Islands 
淑女之家	Ladies House 
大老婆的反击	Big wife's counterattack 
酉阳土家族苗族自治县	Youyang Tujia and Miao Autonomous County 
百货公司	Department store 
interscope唱片	interscope record 
银河铁道物语	Galaxy Railway Story 
丈夫死了	Husband is dead 
哈维若夫足球俱乐部	Haveroff Football Club 
嘉义县第二选举区_(2008年立法委员)	Second Election District of Chiayi County_ (2008 Legislative Councillor) 
环境音乐	Ambient music 
诺森伯兰县_(弗吉尼亚州)	Northumberland County_ (Virginia) 
剑桥大学莫德林学院	Modlin College, University of Cambridge 
marsanne_dr%3fme	marsanne_dr%3fme 
朱琳_(李鹏夫人)	Zhu Lin_(Mrs. Li Peng) 
格里斯兰大学	Grisland University 
大国文化	Big country culture 
卡带单曲	Cassette single 
木村麻美	Kimura Asami 
县委书记	County Party Secretary 
吴有明	Wu Youming 
温州蜜柑	Wenzhou Mandarin 
保加利亚足球联会	Bulgarian Football Federation 
竹内翼	Takeuchi Tsubasa 
波斯尼亚和黑塞哥维那国徽	National Emblem of Bosnia and Herzegovina 
沈芷凝	Shen Zhining 
波兰足球丙级联赛	Polish Football League C 
上海长远集团	Shanghai Changyuan Group 
西伯利亚联邦管区	Siberian Federal District 
尼奥尔岩羚羊足球俱乐部	Niort Chamois Football Club 
高加索诸语言	Caucasian languages 
红米手机2	Redmi 2 
香槟伯爵亨利二世	Henry II of Champagne 
巴西足球协会	Brazilian Football Association 
第二次爪哇海海战	The Second Java Sea Battle 
布尔诺足球俱乐部	Brno Football Club 
武藏陵区	Musashi Mausoleum 
保定英利易通	Baoding Yingli Autopass 
李云挺	Li Yunting 
阮刚猛	Ruan Gangmeng 
美国国家海洋和大气管理局	National Oceanic and Atmospheric Administration 
爱丁顿奖章	Eddington Medal 
奥川雅也	Masaya Okugawa 
天津话	Tianjin dialect 
刘昭文	Liu Zhaowen 
联合卫理公会	United Methodist Church 
美国州份列表	List of U.S. States 
纽约州众议院发言人	Speaker of the New York State House of Representatives 
奥地利总理	Austrian chancellor 
纽波特市议会	Newport City Council 
伏见宫邦家亲王	Prince of Fushimi Palace 
列宁国际学校	Lenin International School 
艾萨克·n·奎因	Isaac N. Quinn 
碧血盐岛	Jade Blood Salt Island 
米内罗竞技	Atletico Mineiro 
国立中央大学	National Central University 
温家宝政府	Wen Jiabao Government 
珣子内亲王	Prince of kunzi 
阿波马托克斯战役	Battle of Appomattox 
高级中学	High school 
中村将	Nakamura 
犹太教正统派	Judaism Orthodox 
荷兰裔苏里南人	Dutch Surinamese 
海涅－博雷尔定理	Heine-Borrel theorem 
爱沙尼亚摇滚	Estonian Rock 
初级中学	Junior high school 
成穆贵妃	Concubine Cheng Mu 
高利巴里	Golibari 
哈尔滨铁路局	Harbin Railway Bureau 
曼苏尔‧本‧扎耶德‧阿勒纳哈扬	Mansour Bin Zayed Al Nahyan 
杉浦正健	Seiken Sugiura 
成都钱宝	Chengdu Qianbao 
羽柴秀胜_(石松丸)	Hidekazu Hashiba_ (Ishimatsu Maru) 
浦那足球俱乐部	Pune Football Club 
第十六代沃里克伯爵夫人安妮·内维尔	Anne Neville, 16th Countess of Warwick 
北京大学地质学馆旧址	The old site of Peking University Geology Museum 
朱燕来	Zhu Yanlai 
日本23岁以下国家足球队	Japan Under-23 National Football Team 
天主教斯波莱托-诺尔恰总教区	Catholic Archdiocese of Spoleto-Norcia 
中国新华航空	China Xinhua Airlines 
香港警察历史	Hong Kong Police History 
告示牌百强单曲榜	Billboard Top 100 Singles Chart 
足利义嗣	Ashikaga 
阿拉贡君主列表	List of Aragonese monarchs 
哈尔滨太平国际机场	Harbin Taiping International Airport 
曼弗雷迪_(西西里国王)	Manfredi_ (King of Sicily) 
胜利车厂	Victory Depot 
客家电视台	Hakka TV 
今天情人节	Valentine's Day today 
四家启助	Shijia Kesuke 
镶蓝旗	Blue flag 
莫君虞	Mo Junyu 
变身！公主偶像	Transform! Princess idol 
不赛因	Nonsense 
村田翔	Murata Sho 
安东尼奥·加斯顿王子（奥尔良-布拉干萨）	Prince Antonio Gaston (Orleans-Braganza) 
孔艾尔夫	Kungalv 
西匈奴语支	Western Huns 
美味大挑战	Delicious challenge 
民主共和党联盟	Democratic Republican League 
上海聚运动	Shanghai Poly Sports 
湖南高等学堂	Hunan Higher School 
俄罗斯紧急情况部	Russian Ministry of Emergency Situations 
张希载	Zhang Xizai 
欧盟委员会	European Commission 
中国（天津）自由贸易试验区	China (Tianjin) Pilot Free Trade Zone 
拉博特尼基足球俱乐部	Labotniki Football Club 
乔治·蒙巴顿，第二代米尔福德黑文侯爵	George Mountbatten, the second Marquis of Milford Haven 
费雷拉足球俱乐部	Ferreira Football Club 
那珂市	Naka City 
欧洲保守与改革党群	European Conservative and Reform Party 
自由市场	free market 
公民不服从	Civil disobedience 
pravia	pravia 
马其顿共和国总理	Prime Minister of the Republic of Macedonia 
老上海旧居的外国人	Foreigners in old Shanghai 
首尔市长列表	List of mayors of Seoul 
富勒顿学院	Fullerton College 
奥斯特奖章	Oster Medal 
小爱德华·甘迺迪	Little Edward Kennedy 
中国合伙人	Chinese Partners 
gjelbrim_taipi	gjelbrim_taipi 
首里	Shuri 
怀化南站	Huaihua South Railway Station 
常宫昌子内亲王	Prince Changzi Nai 
舍伯恩修道院	Sherborne Abbey 
史达林奖	Stalin Award 
萨英战争	Sa-British War 
镜野町	Kagamino Town 
哥斯达黎加中央银行	Central Bank of Costa Rica 
南非兰特	South African Rand 
酷儿理论	Queer Theory 
宪政民主党	Constitutional Democratic Party 
乌德勒兹同盟	Utrecht League 
克里米亚国旗	Crimea flag 
恩施土家族苗族自治州	Enshi Tujia and Miao Autonomous Prefecture 
中央军事委员会后勤保障部	Logistics Support Department of the Central Military Commission 
科布雷素体育会	Cobrexo Sports Club 
乌江	Wujiang 
石田胜之	Ishida Katsuyuki 
土耳其行政区划	Administrative divisions of Turkey 
贵霜币	Guishuang Coin 
更强	Stronger 
京丹后市	Kyotango City 
亚塞尔·奥辛斯达拿	Yasser Ossinstadner 
红喉蜂鸟	Red Throated Hummingbird 
乔治敦_(开曼群岛)	Georgetown_(Cayman Islands) 
魔域幻境	Demon Realm 
社会哲学	Social philosophy 
第三代法夫公爵詹姆斯·卡内基	James Carnegie, the third Duke of Fife 
弗雷德里克·约翰·罗宾逊，第一代戈德里奇子爵	Frederick John Robinson, the first Viscount Goderich 
核酸结构	Nucleic acid structure 
宫崎县民歌	Miyazaki Folk Songs 
甘地社会主义	Gandhi Socialism 
fillér	penny 
西本雅崇	Masataka Nishimoto 
冈野刚	Okano Go 
格但斯克大学	University of Gdansk 
教育认证	Education certification 
角田秀松	Hidematsu Tsunoda 
格拉斯哥普鲁范_(苏格兰议会选区)	Glasgow Prufan_ (Scottish Parliament constituency) 
耶稣教堂	Church of jesus 
海军财务主管	Navy treasurer 
马杜赖	Madurai 
弗朗切斯科二世_(两西西里)	Francesco II_ (Two Sicily) 
日本电视台周六连续剧	Nippon TV Saturday series 
阿卜杜拉一世	Abdullah I 
空军司令指挥部	Air Force Command 
西大路站	Xidalu Station 
野垣内俊	Shun Nogaito 
巴林中央银行	Central Bank of Bahrain 
刘曙光	Liu Shuguang 
.இலங்கை	.Sri Lanka 
粉岭礼贤会中学	Fanling Rhenish Church Secondary School 
爱尔兰统一	Irish unity 
福克兰宪法	Falkland Constitution 
萧迺震	Xiao Ningzhen 
斯里兰卡空军体育会	Sri Lanka Air Force Sports Association 
桥本卓	Hashimoto Taku 
＊～米字键～	＊～米字key～ 
广西联壮柳粤足球俱乐部	Guangxi Lianzhuang Liuyue Football Club 
大广场_(布朗克斯)	Grand Place_ (Bronx) 
绯弹的亚莉亚角色列表	Aria the Scarlet Ammo Character List 
易筋锻骨篇	Easy Muscle Forging 
吕爱琼	Lu Aiqiong 
社会大众党	Social mass party 
泰伦拿体育馆	Arenal Arena 
河野广贵	Kono Hiroki 
罗密欧×茱丽叶	Romeo × Juliet 
苏联中央电视台	Soviet Central Television 
s:中华人民共和国中国人民银行法	s: The People's Bank of China Law 
加纳地方	Ghana place 
基础物理学突破奖	Fundamental Physics Breakthrough Award 
霍朗升	Huo Langsheng 
劲爆美式足球系列	Madden American Football Series 
三国演义_(电视剧)	Romance of the Three Kingdoms_(TV series) 
卡彭特乐队	Carpenter 
爱探险的朵拉	Dora the Explorer 
番禺广场站	Panyu Square Station 
威廉十世_(阿基坦公爵)	William X (Duke of Aquitaine) 
菲律宾参议院	Senate of the Philippines 
蒙古图格里克	Mongolian Tugrik 
贞善公主	Princess Zhenshan 
jp:藤原诠子	jp: Fujiwara Tsunko 
秘密花园_(韩国电视剧)	Secret Garden_ (Korean TV Drama) 
不列颠统治者	British ruler 
海合都	Haihedu 
大友启史	Keishi Ohtomo 
阿瑞斯足球俱乐部	Ares Football Club 
柏拉拿体育场	Parana Stadium 
鲍伟华	Bao Weihua 
维克士唐	Victor 
普奥战争	Prussian-Austrian War 
珠江新城站	Zhujiang New Town Station 
嘻哈浩室	Hip Hop House 
新潟体育场	Niigata Stadium 
大学研究联合会	University Research Association 
法兰西王国_(1791–1792)	Kingdom of France_(1791–1792) 
特尔纳纳足球俱乐部	Ternana Football Club 
波斯立宪革命	Persian Constitutional Revolution 
粟津温泉	Awazu Onsen 
料理情人梦	Cooking Lover's Dream 
魔法咪路咪路	Magic milu milu 
绿森林体育场	Green Forest Stadium 
香港教育专业人员协会	Hong Kong Education Professionals Association 
魏民洲	Wei Minzhou 
濑户山三男	Setoyama Sano 
西门子公司	Siemens 
丹麦国家银行	Danish National Bank 
夏乔士·罗便臣，第二代罗士敏男爵	Charlotte Robinson, the second generation of Baron Rossmin 
光复会	Liberation Association 
白星拿	White star 
无锡中央车站	Wuxi Central Station 
久保裕一	Yuichi Kubo 
约翰王子	Prince John 
藤卷润	Fujimaki Jun 
大不列颠的伊丽莎白公主	Princess Elizabeth of Great Britain 
快乐我的家	Happy my home 
内泽默体育会	Nezemo Sports Club 
皇家奖章	Royal Medal 
巴贝多独立日	Barbados Independence Day 
渝利铁路	Yuli Railway 
乌兹别克斯坦伊斯兰运动	Islamic Movement of Uzbekistan 
秋田书店	Akita Bookstore 
摩洛哥电信	Morocco Telecom 
未来穗香	Miku Suika 
动态语言	Dynamic language 
校园时代	Campus age 
谢伟琦	Xie Weiqi 
奥地利的康丝坦茨	Constance 
松下之纲	Matsushita Nozuna 
正仁亲王妃华子	Princess Zhengren Huazi 
金子恭之	Yasushi Kaneko 
后红里	Houhongli 
澳大利亚外交部长	Australian Minister of Foreign Affairs 
家用电器	Household appliances 
北高加索联邦管区	North Caucasus Federal District 
一条富子	A rich son 
.az	.the 
时间漩涡	Time vortex 
厦门高崎国际机场	Xiamen Gaoqi International Airport 
中国人民政治协商会议广州市委员会	Guangzhou Municipal Committee of the Chinese People's Political Consultative Conference 
多拉波拉战役	Battle of Dora Bora 
印度英军总司令	Commander-in-Chief of the British Army in India 
杨登魁	Yang Dengkui 
库珀_(澳大利亚国会选区)	Cooper_(Australian Parliamentary Constituency) 
基辅佩彻尔斯克修道院	Kiev Pechersk Monastery 
苏联军事史	Soviet military history 
因纽特人	Inuit 
中国历史	Chinese history 
加那利联盟	Canary Union 
奇幻魔法melody	Fantasy magic melody 
曹勇俊	Cao Yongjun 
拉纳王朝	Rana Dynasty 
丹麦克朗	Danish Krone 
美国第八集团军	U.S. Eighth Army 
北爱尔兰甲组足球联赛	Northern Ireland Football League 
巴西历史	Brazilian history 
乡村音乐年表	Country Music Chronology 
香槟-阿登	Champagne-Ardenne 
venini	venini 
邢国辉	Xing Guohui 
后庞复兴	Post-pang revival 
奥地利的伊莉莎白_(1554-1592)	Elizabeth of Austria (1554-1592) 
复活节岛	Easter island 
美国原子能委员会	American Atomic Energy Commission 
分布式计算	Distributed Computing 
回声号列车	Echo Train 
辉煌条纹	Brilliant stripes 
法布瑞欧‧莫瑞提	Fabrio Moretti 
印度力量车队	Force India 
查德宗教分布	Chad religious distribution 
杨开智	Yang Kaizhi 
威廉·史密斯_(废奴主义者)	William Smith_ (abolitionist) 
西班牙国会	Spanish Congress 
瑞典王位继承	Succession to the Swedish throne 
长崎体育场	Nagasaki Stadium 
卡尔·史瓦西奖章	Carl Schwarzschild Medal 
佛山高明新区体育中心	Foshan Gaoming New District Sports Center 
米赞比体育会	Mizanbe Sports Club 
池田晶子	Akiko Ikeda 
奥古斯特·博纳尔球场	August Bonnard Stadium 
亚历山大王子_第1代阿斯隆伯爵	Prince Alexander_The 1st Earl of Athlone 
混合鞭笞	Mixed flogging 
查尔斯·斯坦利·蒙克，第四代蒙克子爵	Charles Stanley Munch, 4th Viscount Munch 
真情相对	True love 
高河弓	Gaohe Bow 
中央文化革命小组	Central Cultural Revolution Group 
file:lockheed_martin.svg	file:lockheed_martin.svg 
利比亚国家元首列表	List of heads of state of Libya 
印度诸邦与联邦属地	Indian states and federal territories 
拓扑学	Topology 
category:c语言家族	category:c language family 
中井洽	Nakai Qa 
阿图瓦伯爵列表	List of Counts of Artois 
海峡两岸关系	Cross-strait relations 
呼和浩特体育场	Hohhot Stadium 
华城市	Hwaseong 
泡菜奶酪微笑	Kimchi cheese smile 
希腊银行	Bank of Greece 
天主教民主主义	Catholic Democracy 
东洋大学	Toyo University 
织田氏	Oda 
松大娱乐经纪股份有限公司	Songda Entertainment Brokerage Co., Ltd. 
巴谦美	Ba Qianmei 
category:交响金属乐团	category:Symphonic Metal Orchestra 
黄金时段艾美奖	Primetime Emmy Awards 
梁政相	Liang Zhengxiang 
约克公爵	Duke of York 
和硕淑慎公主	Princess He Shuo Shushen 
专辑导向摇滚	Album-oriented rock 
新田部皇女	Princess Niitabe 
拉韦纳足球俱乐部	Ravenna Football Club 
鹤冈阳太	Tsuruoka Yota 
奥斯曼皇室	Ottoman Royal Family 
p6微架构	p6 microarchitecture 
石油勘探	Oil prospecting 
j85发动机	j85 engine 
吴秋北	Wu Qiubei 
普雷绍夫足球俱乐部	Prešov Football Club 
杰克逊县_(密苏里州)	Jackson County_(Missouri) 
d-beat	d-beat 
科隆竞技俱乐部	Cologne Athletic Club 
翁长雄志	Weng Changxiongzhi 
中国足球乙级联赛	Chinese Football League Two 
虚拟现实	Virtual Reality 
墨西哥大奖赛	Mexican Grand Prix 
固铂轮胎	Cooper Tire 
绝缘栅双极晶体管	Insulated gate bipolar transistor 
日本炼瓦制造	Made in Japan 
噪音爵士乐	Noise jazz 
岳麓书院	Yuelu Academy 
冰沙国王中心	Smoothie King Center 
所罗门群岛战役	Battle of Solomon Islands 
公民力量党_(罗马尼亚)	Civic Force_ (Romania) 
欧洲右派_(1984–1989)	European Right_ (1984–1989) 
宗座拉特朗大学	Pontifical Lateran University 
南非参议院	South African Senate 
部长助理	Assistant minister 
塞尔维亚民主党	Serbian Democratic Party 
中国国际货运航空	Air China Cargo 
詹姆士·斯坦厄普，第一代斯坦厄普伯爵	James Stanhope, the first Earl of Stanhope 
下西里西亚省	Lower Silesia 
第一次维也纳勒令	First order in Vienna 
高加索的亚历山卓	Alessandro of the Caucasus 
三剑客	Three Musketeers 
高楠里	Gao Nanli 
瓜生外吉	Uryu Sotokichi 
瓜达拉哈拉竞技俱乐部	Athletic Club of Guadalajara 
路易吉·德尔内里	Luigi Del Neri 
毛里塔尼亚军队	Mauritanian Army 
蜘蛛女_(杰西卡·德鲁)	Spiderwoman_ (Jessica Drew) 
德国金马克	Golden Mark 
全国双拥模范城	National Double Support Model City 
沙特·本·阿卜杜勒-阿齐兹·阿勒沙特	Saudi bin Abdul Aziz Al Shat 
蓝山719行动	Operation Blue Mountain 719 
堪萨斯城巫师	Kansas City Wizard 
北京理工大学附属中学	High School Affiliated to Beijing Institute of Technology 
比雷埃夫斯竞技足球俱乐部	Piraeus Athletic Football Club 
动画配音	Animation dubbing 
希腊21岁以下国家足球队	Greece Under-21 National Football Team 
马来西亚交通部长	Minister of Transport of Malaysia 
圣安德鲁斯球场	St Andrews Stadium 
曹建成	Cao Jiancheng 
莲花杜鹃	Lotus Rhododendron 
佐藤和树	Sato Kazuki 
星座爱情双鱼女	Constellation love Pisces woman 
苏俄人民委员会主席	Chairman of the Soviet Russian People's Committee 
彻底经验主义	Radical empiricism 
精工体育会	Seiko Sports Association 
国家卫生城市	National Sanitation City 
多哥足球协会	Togo Football Association 
linux基金会	linux foundation 
朱鹭号列车	Toki Train 
标致3008	Peugeot 3008 
陈慧翎	Chen Huiling 
新闻杂志	News Magazine 
泰王冠勋章	Thai Crown Medal 
爱尔兰总理	Prime Minister of Ireland 
葡萄牙联赛杯	Portuguese League Cup 
饿死鬼叭噗	Starving ghost 
低音曼陀林	Bass mandolin 
红蝴蝶	Red butterfly 
酸性爵士	Acid jazz 
我们是安拉和祖国的战士	We are the warriors of Allah and the Motherland 
藏文转写系统	Tibetan transcription system 
克莱孟三世	Clement III 
白宫幕僚长	White House Chief of Staff 
蔚山广域市	Ulsan Metropolitan City 
叶红专	Ye Hongzhuan 
莱昂诺尔_(奥兰治-拿骚的阿姆斯博格伯爵)	Leonor_ (Earl of Armsberg of Orange-Nassau) 
あけゆく朝	Morning 
afc温布顿	afc Wimbledon 
意识流文学	Stream of Consciousness Literature 
查尔斯·卡斯卡特，第二代卡斯卡特伯爵	Charles Cascart, the second Earl of Cascart 
筿原弘次郎	Kojiro Kagehara 
新加坡海峡	Singapore Strait 
马里纳郡主_(肯特公爵夫人)	Sheriff Marina_ (Duchess of Kent) 
中国作家协会	Chinese Writers Association 
香港主权移交_(消歧义)	Hong Kong transfer of sovereignty_ (disambiguation) 
上海中邦	Shanghai Zhongbang 
"file:queens_university_belfast.png"]	"file:queens_university_belfast.png"] 
变色鸢尾	Iris 
音乐总监	Music Director 
渝怀铁路长寿长江大桥	Changshou Yangtze River Bridge on Yuhuai Railway 
电车男_(电视剧)	Tramboy_ (TV series) 
巴黎恋人	Lovers in Paris 
西雅图-塔科马国际机场	Seattle-Tacoma International Airport 
福斯2000影业	Fox 2000 Pictures 
凤源里	Fengyuanli 
纳米技术	nanotechnology 
嵌入式作业系统	Embedded operating system 
深圳人人	Shenzhen Renren 
植田谦吉	Kenkichi Ueda 
堀河豊子	Toyoko Horikawa 
甲南里	Kananli 
波兰足球协会	Polish Football Association 
内蒙古自治政府	Inner Mongolia Autonomous Government 
大屋翼	Big House Wing 
周刚_(足球裁判)	Zhou Gang_(Football Referee) 
高松宫宣仁亲王	Prince Sunhito Takamatsu Palace 
经典统一场论	Classical unified field theory 
解释学	Hermeneutics 
地利亚修女纪念学校	Delia Memorial School 
中国医科大学	China Medical University 
亚美尼亚足球总会	Armenian Football Association 
五大湖地区	Great Lakes Region 
瓦伦西亚足球俱乐部	Valencia Football Club 
fasm	fasm 
罗阿诺克_(维吉尼亚州)	Roanoke_ (Virginia) 
妖怪少爷	Master Monster 
约翰·荷巴特，第二代白金汉郡伯爵	John Hobart, second earl of Buckinghamshire 
第二次瓜分波兰	Partition of Poland for the second time 
野村政孝	Masataka Nomura 
鹿儿岛县旗	Kagoshima Prefecture Flag 
乌拉圭摇滚	Uruguay Rock 
室町幕府	Muromachi Shogunate 
杨谭爱莲	Yang Tan Ailian 
叶尼塞语系	Yenisei language family 
最终幻想xv	Final fantasy xv 
雒越	Luo Yue 
女王公园巡游者	Queens Park Rangers 
亚历山大·亚历山德罗夫_(足球运动员)	Alexander Alexandrov_ (football player) 
井原正巳	Masami Ihara 
大金川之战	Battle of Dajinchuan 
恩斯特二世_(萨克森-阿尔滕堡)	Ernst II_ (Saxony-Altenburg) 
以色列总统列表	List of Presidents of Israel 
锁清秋	Suo Qingqiu 
伯纳德·蒙哥马利，第一代阿拉曼的蒙哥马利子爵	Bernard Montgomery, Viscount Montgomery of the first Alamein 
西南格拉斯哥_(英国国会选区)	Southwest Glasgow_(British Parliamentary District) 
葡萄牙19岁以下国家足球队	Portugal Under-19 National Football Team 
乌尔济切尼足球俱乐部	Ulzicheni Football Club 
法兰西的罗贝尔	Robert of France 
圣阿尔坎杰洛-迪罗马涅	Santarcangelo di Romagna 
张铖	Zhang Cheng 
九江长江公路大桥	Jiujiang Yangtze River Highway Bridge 
葛山刚士	Geshan Takeshi 
英国军团_(1778年)	British Legion_ (1778) 
公立学院	Public school 
李滉	Li Huang 
gothabilly	gothabilly 
新北投支线	Xinbeitou Branch 
上海滩_(电视剧)	Shanghai Beach_(TV series) 
二元制君主立宪制	Dualistic constitutional monarchy 
核战略司令部	Nuclear Strategy Command 
李恩诚	Li Encheng 
殷一璀	Yin Yicui 
1906年俄罗斯宪法	Russian Constitution of 1906 
大河原邦男	Kunio Okawara 
普朗克黑体辐射定律	Planck's law of blackbody radiation 
一级方程式赛车致命事故列表	List of fatal accidents in Formula One 
沈吕巡	Sinking tour 
早安少女组。全b面单曲选辑	Morning Musume Group. Full b-side single selection 
最后的战役	The final battle 
国土交通副大臣	Deputy Minister of Land, Infrastructure and Transport 
乐器摇滚	Musical instrument rock 
竹中平藏	Heizo Takenaka 
中国基督教新教	Chinese Protestant Christianity 
非洲联赛冠军杯	African League Champions Cup 
跟随我	follow me 
罗香兰	Luo Xianglan 
福井县民歌	Folk Songs of Fukui Prefecture 
张睿_(女子足球运动员)	Zhang Rui_ (female football player) 
王国生_(湖北省长)	Wang Guosheng_(Governor of Hubei) 
大江户线	Oedo Line 
昭徳王	King Shotoku 
克里斯蒂安·奥古斯特_(荷尔斯泰因-戈托普)	Christian August_ (Holstein-Gotop) 
弗朗索瓦-亨利·皮诺	Francois-Henri Pinault 
巴西行政区划	Administrative divisions of Brazil 
印度储备银行	Reserve Bank of India 
萨莫耶德语族	Samoyed German 
爱丽丝公主_(阿斯隆伯爵夫人)	Princess Alice_ (Countess of Athlone) 
第八届全国人民代表大会常务委员会	Standing Committee of the Eighth National People's Congress 
铃木博文_(动画师)	Suzuki blog post_(animator) 
冲绳县民歌	Folk Songs of Okinawa Prefecture 
结婚定理	Marriage theorem 
尼斯蔚蓝海岸机场	Nice Côte d'Azur Airport 
法国国家太空研究中心	French National Space Research Center 
华盛顿与杰斐逊学院	Washington and Jefferson College 
普莱克斯学派	Praxair School 
北美乔柏	North American Job 
第二代索默塞特公爵埃德蒙·蒲福	Edmund Beaufort, Duke of Somerset 
全启相	Quan Qixiang 
刘卓辉	Liu Zhuohui 
洪都拉斯甲组足球联赛	Honduras First Division Football League 
终极动员令_红色警戒2：尤里的复仇	Ultimate Mobilization Order_Red Alert 2: Yuri’s Revenge 
柏德逊站	Paterson Station 
马夫拉体育会	Mafra Sports Club 
梁健恒	Liang Jianheng 
加贺美翔	Kaga Misho 
首尔市政府	Seoul Metropolitan Government 
上天梯	Go up the ladder 
中国奥林匹克委员会	Chinese Olympic Committee 
莫斯科语言学派	Moscow School of Linguistics 
皇家橡树站	Royal Oak Station 
柏林城市宫	Berlin City Palace 
那旁高卢行省	Gaul Province 
林保全	Lin Baoquan 
.kn	.kn 
公园街教堂	Park Street Church 
高卢伊比利亚语支	Gaul Iberian 
清河区_(淮安市)	Qinghe District_(Huai'an City) 
罗明(央视副台长)	Luo Ming (Deputy Director of CCTV) 
中山诗央里	Zhongshan Shiyangli 
东伊朗语支	East Iranian branch 
戴维斯_(加利福尼亚州)	Davis_ (California) 
铁道第三勘察设计院	The Third Railway Survey and Design Institute 
小碧潭站	Xiaobitan Station 
莱茵能源体育场	Rhein Energy Stadium 
九州帝国大学	Kyushu Imperial University 
洛克菲勒大学	Rockefeller University 
上野国	Kozuke 
普雷斯顿县_(西弗吉尼亚州)	Preston County_ (West Virginia) 
庆安公主	Princess Qing'an 
安德烈-路易·德比耶纳	André-Louis De Bienne 
全日空控股	All Nippon Airways Holdings 
努瓦永	Noyon 
开心魔法	Happy magic 
p-3aew&c蓝色哨兵式空中预警暨管制机	p-3aew&c blue sentry airborne early warning and control aircraft 
西索瓦·瓦差亚冯	Sisowath Vachayavon 
川崎龙介	Ryusuke Kawasaki 
英联邦王国	Commonwealth Kingdom 
福冈机场车站	Fukuoka Airport Station 
湖南省县级以上行政区面积列表	List of administrative areas above the county level in Hunan Province 
浦野一美	Kazumi Urano 
法政大学	Hosei University 
阿斯特拉足球俱乐部	Astra Football Club 
石川智晶	Ishikawa Zhijing 
中华民国国军军阶	Military rank of the Republic of China 
伦敦律师学院法学院	London Law School School of Law 
大勋位菊花章颈饰	Grand Order Chrysanthemum Necklace 
俄国社会民主工党	Russian Social Democratic Labor Party 
瓦伦丁公爵	Duke of Valentine 
舒安巴治拿	Shuan Bajina 
圣彼得堡民航国立大学	St. Petersburg State University of Civil Aviation 
剑与魔法	Sword and magic 
圣奥尔本斯大教堂	St Albans Cathedral 
民族联盟_(拉脱维亚)	National League_(Latvia) 
法本公司	Farben 
以色列国会	Israel Congress 
阿基坦公爵领地	Duchy of Aquitaine 
公民行动党	Citizen Action Party 
俄勒冈州第三国会选区	Oregon's third congressional district 
结城友奈是勇者	Yuki Yuna is a brave 
张鼎丞	Zhang Dingcheng 
legea	the law 
小野博信	Hiroshin Ono 
最终幻想iii	Final Fantasy III 
澳洲时间	Australia time 
阿尤西国师	Ayusi National Division 
阮文雪	Ruan Wenxue 
张璐劲	Zhang Lujin 
珀金奖章	Perkin Medal 
张晓容	Zhang Xiaorong 
隋唐演义_(2013年电视剧)	Sui and Tang Dynasties_ (2013 TV series) 
.al	.to the 
卢顿市政府大楼	Luton City Hall 
ウェリントン	Wellington 
美国第七集团军	US Seventh Army 
中途岛海战	Battle of Midway 
amiina	amiina 
中共对外宣传工作办公室	CPC Publicity Office 
daimond	diamond 
怀雅逊大学	Ryerson University 
维珍航空	Virgin Atlantic 
搜下留情	Search for mercy 
爱情小说	Romance novel 
阿瓦伊足球俱乐部	Awai Football Club 
李昂_(足球运动员)	Li Ang_ (football player) 
万代南梦宫	Bandai Namco 
纳瓦拉的贝伦加丽亚	Belengaria of Navarra 
孟买总督	Governor of Mumbai 
三军总长	Commander of the armed forces 
陈瑞杰	Chen Ruijie 
苏拉威西岛	Sulawesi 
正田酱油群马体育场	Masada Gunma Stadium 
中闪米特诸语	Middle Semitic 
曼谷联足球会	Bangkok United Football Club 
半点心	Half snack 
北洋军阀	Beiyang Warlord 
黄现璠	Huang Xianpan 
艾米利亚-罗马涅	Emilia Romagna 
布卢瓦王朝	House of Blois 
全国人民政权代表大会	National Congress of People's Power 
.mf	.mf 
邵维铭	Shao Weiming 
赫拉德茨-克拉洛韦州	Hradec Králové 
路易五世_(西法兰克)	Louis V_ (West Franco) 
共产党联盟－苏联共产党	Communist Party-Communist Party of the Soviet Union 
德铁网络	Deutsche Bahn 
布鲁塞尔足球俱乐部	Brussels Football Club 
坚尼_(英国货币)	Guinea_ (UK currency) 
中二病也想谈恋爱！	I also want to fall in love with Secondary II disease! 
第一神拳	Godly Punch 
哈伊杜克足球俱乐部	Hayduk Football Club 
格鲁吉亚字母	Georgian alphabet 
汉弗莱_(格洛斯特公爵)	Humphrey_ (Duke of Gloucester) 
南锡足球俱乐部	Nancy Football Club 
芬兰人党	Finn Party 
国际足球联合会主席列表	List of Presidents of the International Football Federation 
小牧交流道	Komaki Interchange 
越南人民军总参谋部	General Staff of the People's Army of Vietnam 
马斯科吉_(奥克拉荷马州)	Muskogee_ (Oklahoma) 
巴布亚企鹅	Gentoo Penguin 
美洲豹攻击机	Jaguar attack aircraft 
京那巴鲁山	Mount Kinabalu 
查谟-克什米尔邦首席部长列表	List of Chief Ministers of Jammu and Kashmir 
苏丹沙拉夫丁	Sultan Sharafuddin 
人生多美丽	Life is beautiful 
皇家化学学院	Royal College of Chemistry 
第五次俄土战争	The fifth Russian-Turkish war 
武吉知马	Bukit Timah 
空军上将	Air Force Admiral 
常陆那珂市	Hitachi Naka City 
李荣新	Li Rongxin 
尤尔马拉足球俱乐部	Jurmala Football Club 
体育用品	Sporting goods 
罗钧满	Luo Junman 
龙猫	Totoro 
第二次彼得斯堡战役	Second Battle of Petersburg 
帕斯卡的赌注	Pascal's bet 
文迪兹约克	Wendiz York 
石原克哉	Katsuya Ishihara 
汉语方言	Chinese dialect 
池上伸治	Shinji Ikegami 
内乡县衙	Neixiang County Office 
大伦敦政府	Greater London Government 
低地东库希特语支	Lowland East Kushitian 
特伦顿_(新泽西州)	Trenton_(New Jersey) 
波兰王国	Kingdom of Poland 
光荣特库摩控股	Koei Tecmo Holdings 
普拉克明堂区_(路易斯安那州)	Prakmin Parish_ (Louisiana) 
答里也忒迷失	The answer is also lost 
北京市第四中学	Beijing Fourth Middle School 
hardbag	hardbag 
张景惠	Zhang Jinghui 
chumbinho	pellet 
大岛僚太	Ryota Oshima 
西南斯拉夫亚语支	Southwest Slavic 
火炉壁的女孩	Girl by the stove wall 
樱井政博	Masahiro Sakurai 
模拟城镇	Simulated town 
安嫔_(嘉庆帝)	An Bin_ (Jiaqing Emperor) 
联合国军	United Nations Army 
迷失角色列表	List of lost characters 
星际大战：原力释放	Star Wars: The Force Unleashed 
彭越	Peng Yue 
米尔扎·穆罕默德-阿里汗	Mirza Mohamed-Ali Khan 
青岛颐中体育中心	Qingdao Yizhong Sports Center 
爸爸闭翳	Dad 
台湾数位光讯科技集团	Taiwan Digital Optical Technology Group 
尼斯塔德条约	Treaty of Nystad 
庆答应	Qingyue 
约翰·柏克莱，第五代斯特拉顿的柏克莱男爵	John Berkeley, Baron Berkeley, Fifth Generation Stratton 
王洛勇	Wang Luoyong 
小川直毅	Ogawa Naotake 
钢琴蓝调	Piano blues 
并发计算	Concurrent computing 
宾夕法尼亚州各县列表	List of counties in Pennsylvania 
意大利天主教教区列表	List of Catholic Dioceses in Italy 
匈牙利足球乙级联赛	Hungary Football League Two 
孛儿只斤氏	Peer Zhijinshi 
芬兰－乌戈尔语族	Finnish-Ugric 
何诚渊	He Chengyuan 
第5航空舰队_(德国空军)	5th Air Fleet_ (German Air Force) 
武汉商学院	Wuhan Business School 
吕晓霖	Lu Xiaolin 
织田信正	Oda Shinmasa 
能美市	Nomi City 
nifon	Niphon 
中坜车站	Zhongli Station 
拉卡战斗	Raqqa fight 
印度国徽	National Emblem of India 
台拉维夫大学	Tel Aviv University 
美因茨05二队	Mainz 05 Second Team 
索非亚大学	Sofia University 
望月奈奈	Nana Mochizuki 
file:tang_daizong.jpg	file:Tang_Dai Zong.jpg 
中东路事件	Middle East Road Incident 
藤田阳一	Fujita Yoichi 
小川大贵	Ogawa Daigui 
东海大学付属望星高等学校	Tokai University Fu is Wangxing High School 
彭铠立	Peng Kaili 
美国民主党总统候选人	U.S. Democratic presidential candidate 
奥古斯特王子(科哈里亲王)	Prince August (Prince Kohari) 
梅尔罗斯的沃尔特奥夫	Walter Off of Melrose 
皮埃尔·莫鲁瓦球场	Pierre Mauroy Stadium 
西部地下迷幻摇滚	West Underground Psychedelic Rock 
香川县旗	Flag of Kagawa 
nba中部赛区	NBA Central Division 
白沙黎族自治县	Baisha Li Autonomous County 
勇者斗恶龙_英雄集结_暗龙与世界树之城	Dragon Quest_Heroes Assembly_Dark Dragon and World Tree City 
美国偶像_(第十季)	American Idol_ (Tenth Season) 
黄龙体育中心	Huanglong Sports Center 
鼎山长江大桥	Dingshan Yangtze River Bridge 
新传媒制作（马来西亚）有限公司	New Media Production (Malaysia) Sdn Bhd 
上海传奇	Shanghai Legend 
华丽朋克	Gorgeous punk 
软骨鱼纲	Chondrichthyes 
sh-60直升机	sh-60 helicopter 
默尔特-摩泽尔省	Meurthe-Moselle 
唱片公司老板	Record company owner 
山野犹	Yamano Yu 
亨利·佩蒂-费茨莫里斯，第三代兰斯多恩侯爵	Henry Petty-Fitzmorris, third Marquis of Lansdowne 
巴里托语支	Barito language branch 
圣魔之血	Holy Demon Blood 
太田房江	Fusae Ohta 
无尽的天空	Endless sky 
钱大康	Qian Dakang 
上国料萌衣	Shangguo Mengyi 
美索不达米亚阿拉伯语	Mesopotamian Arabic 
.va	.We 
最终幻想xi	Final fantasy xi 
千叶市苏我球场	Chiba City Suga Stadium 
萱野长修	Kayano Gonbe 
高雄市政府捷运工程局	Kaohsiung City Government MRT Engineering Bureau 
冒险小说	Adventure novel 
市立体育场_(巴尼亚卢卡)	Municipal Stadium_ (Bania Luka) 
潘国山	Pan Guoshan 
南方集团军	Army South 
中国人民解放军后勤工程学院	Chinese People's Liberation Army Logistics Engineering College 
接力出版社	Relay Press 
file:koei_logo.gif	file:koei_logo.gif 
老挝人民革命党中央委员会	Lao People's Revolutionary Party Central Committee 
哈斯伍德电影公司	Haswood Film Company 
威廉·皮尔，第三代皮尔伯爵	William Peel, the third Earl of Peel 
外赫布里底群岛	Outer Hebrides 
帕差拉吉帝雅帕公主	Princess Phracha Rajdi Yapa 
台中市私立新民高级中学	Taichung City Private Xinmin Senior High School 
内湖省	Neihu 
波斯尼亚和黑塞哥维那政区	District of Bosnia and Herzegovina 
网页浏览器	browser 
赤都松赞	Chidu Songzan 
国际政治	International Politics 
尼布甲尼撒二世	Nebuchadnezzar II 
saminathan_rajendran	Sameenath_Rajendran 
昆明长水国际机场	Kunming Changshui International Airport 
伏见宫贞教亲王	Prince of Fushimi Palace 
辛普森一家大电影	The Simpsons Movie 
德国联邦铁路	German Federal Railways 
h8/300	h8/300 
苏佩尔加圣殿	Sanctuary of Superga 
瑞士历史	Swiss history 
科力士·韦德加	Kiris Widgar 
奶黄唱片	Custard Records 
尼日利亚17岁以下国家足球队	Nigeria Under-17 National Football Team 
墨西哥合众国_(1824–1864)	United Mexican States_(1824–1864) 
比什奴普莱利亚－曼尼浦尔语	Bishnu Prelia-Manipur 
美国中西部	Midwestern United States 
阿萨夫·贾赫七世	Assaf Jah VII 
石井谦伍	Ishii Kengo 
马德里王宫	Royal Palace of Madrid 
保土谷区	Hodogaya District 
叶问_(消歧义)	Ip Man_(Disambiguation) 
台湾客家话	Taiwanese Hakka 
中华电信mod	Chunghwa Telecom mod 
新西兰足球协会	New Zealand Football Association 
超级星光大道_(第五届)	Super Avenue of Stars_ (5th) 
广州南站	Guangzhou South Railway Station 
张晋僖	Zhang Jinxi 
恋爱女王	Queen of Love 
荷花水鸟图	Lotus water bird illustration 
希腊足球杯	Greece Football Cup 
大山启辅	Oyama 启辅 
室屋成	Muroyaki 
马来西亚民政运动党	Malaysian Civil Affairs Movement Party 
nrgi公园球场	nrgi park stadium 
射雕三部曲	The Eagle Trilogy 
史密斯学院	Smith College 
森崎和幸	Kazuyuki Morisaki 
保加利亚国民议会	National Assembly of Bulgaria 
德米特里_(腓力五世之子)	Dmitry_ (son of Philip V) 
中菲律宾语支	Central Filipino 
克里米亚联邦管区	Crimea Federal District 
s:行政院组织法	s: Organic Law of the Executive Yuan 
一木喜徳郎	Kitokuro Ichiki 
于若木	Yu Ruomu 
杨属	Populus 
马达加斯加国民议会	National Assembly of Madagascar 
中华人民共和国电子工业部	Ministry of Electronics Industry of the People's Republic of China 
石勒喀河	Shileka 
张靓颖@音乐	Zhang Liangying@音乐 
乔治·罗宾逊，第一代里彭侯爵	George Robinson, the first Marquis of Ripon 
中大西洋地区	Mid-Atlantic 
傅洁娴	Fu Jiexian 
公立研究型大学	Public research university 
黑林山区舍瑙	Schonau in the Black Forest 
吴睿勤	Wu Ruiqin 
白金汉_(英国国会选区)	Buckingham_(British Parliamentary District) 
麦克弗森_(澳大利亚国会选区)	Macpherson_(Australian Parliamentary Constituency) 
梅克内斯皇家军事学院	Meknes Royal Military Academy 
徐日勤	Xu Riqin 
徐嘉平	Xu Jiaping 
无名怨愤	Nameless resentment 
兴田里	Xingtianli 
迪金森学院	Dickinson College 
卡尔加里大学	University of Calgary 
法蒂玛·宾特·穆巴拉克·阿尔凯比	Fatima Bint Mubarak Al Kebi 
臭鼬工厂	Skunk Factory 
会津若松城	Aizuwakamatsu Castle 
宗座署理	Apostle 
滑板朋克	Skateboard punk 
汐留城市中心	Shiodome City Center 
摩顿湾区政府	Moreton Bay District Government 
奥兰治圣约瑟夫修女会	Sisters of St. Joseph of Orange 
顺子女王	Straight Queen 
上海东亚	Shanghai East Asia 
最高国家安全委员会	Supreme National Security Council 
比乌-曼达拉语支	Biu-Mandala 
萨普迪群岛	Sapudi Islands 
李忠琛	Li Zhongchen 
圣日耳曼条约	Treaty of Saint-Germain 
俄亥俄县_(西弗吉尼亚州)	Ohio County_(West Virginia) 
城市管理	City management 
幸福的钟声	Bells of happiness 
李佳臻	Li Jiazhen 
亡命暗杀令	Desperate assassination order 
utc-8	utc-8 
射雕英雄传_(2008年电视剧)	Legend of the Condor Heroes_ (2008 TV series) 
镰田克明	Kamada Katsuaki 
越南劳动党	Vietnam Labor Party 
挪威保守党	Norwegian Conservative Party 
朝鲜民主主义人民共和国人民武装力量部	Ministry of People's Armed Forces of the Democratic People's Republic of Korea 
昆士兰州东南部	Southeastern Queensland 
蔡和森	Cai Hesen 
马拉坎南宫	Malacañang 
高沙历	Gao Shali 
自由国民会议	Free national council 
札幌证券交易所	Sapporo Stock Exchange 
匈牙利足球总会	Hungary Football Association 
江政彦	Jiang Zhengyan 
德意志联邦银行	Deutsche Bundesbank 
足球骑士	Football knight 
穿透屋顶的high_kick！	The high_kick that penetrates the roof! 
多德勒支足球俱乐部	Dordrecht Football Club 
市政厅_(伦敦市)	City Hall_ (City of London) 
美国哥伦比亚特区联邦巡回上诉法院	U.S. Court of Appeals for the Federal Circuit, District of Columbia 
能看见鬼的警察处容	The policeman who can see ghosts 
乔丹–维格纳变换	Jordan--Wigner Transform 
政务院人民监察委员会	People's Supervision Committee of the State Council 
多范型编程语言	Multi-paradigm programming language 
国际体育联盟	International Sports Federation 
永山治	Nagayamaji 
行为科学	Behavioral Science 
俄罗斯联邦议会	Parliament of the Russian Federation 
竹园里	In the bamboo garden 
劳动和社会公正－选举替代	Labor and social justice-alternative to elections 
工人共产党	Workers' Communist Party 
无线电视台庆	TVB celebrates 
命令行界面	Command line interface 
第一次中日战争	The first Sino-Japanese war 
布达佩斯科技经济大学	Budapest University of Technology and Economics 
冰岛中央银行	Central Bank of Iceland 
万超岐	Wan Chaoqi 
马都拉语群	Madura Group 
古巴行政区划	Administrative divisions of Cuba 
美丽蓝旗	Beautiful blue flag 
杰西·罗布雷多	Jesse Robredo 
谢莫纳城钢铁工人足球俱乐部	Shemona City Steel Workers Football Club 
私有软体	Proprietary software 
甜蜜杀机	Sweet murder 
金彗星	Kim Hye Seong 
大连周水子国际机场	Dalian Zhoushuizi International Airport 
生存游戏	Survival game 
圣詹姆斯公园球场	St. James's Park 
行政院研究发展考核委员会	Executive Yuan Research and Development Evaluation Committee 
英国电影和电视艺术学院	British Academy of Film and Television Arts 
恋情告急	Romance 
阿尔巴尼亚国防部长	Minister of Defence of Albania 
埃尔夫沃德_(威塞克斯)	Elf Ward_ (Wessex) 
爱德华·劳伦斯·洛根将军国际机场	General Edward Lawrence Logan International Airport 
神武天皇	Emperor Jimmu 
小西蒙·玻利瓦尔·巴克纳	Simon Bolivar Buckner Jr 
艾纳杰夫足球俱乐部	Ainajaf Football Club 
散射矩阵	Scattering matrix 
mykhaylo_fomenko	mykhaylo fomenko 
樱桃树唱片公司	Cherry Tree Records 
布拉格波希米亚足球俱乐部	Prague Bohemia Football Club 
提迪攀	Tidipan 
布鲁塞尔自由大学	Free University of Brussels 
呼和浩特市体育场	Hohhot Stadium 
时田优	Tokada Yu 
高级专员	The High Commissioner 
王军_(企业家)	Wang Jun_ (Entrepreneur) 
新大久保站	Shin-Okubo Station 
李紫昕	Li Zixin 
堀北真希	Horikita Maki 
可米大伯制作有限公司	Komi Uncle Production Co., Ltd. 
王雪红	Wang Xuehong 
春武里足球俱乐部	Chonburi Football Club 
全球城市人口排名	Global city population ranking 
艾尔弗雷德·米尔纳，第一代米尔纳子爵	Alfred Milner, the first Viscount Milner 
芬兰民族进步党	Finnish National Progressive Party 
阿尔巴尼亚劳动青年联盟	Albanian Working Youth Union 
池田大介	Daisuke Ikeda 
格鲁吉亚正教会	Georgian Orthodox Church 
金田一少年之事件簿	Kindaichi Case Book 
石硖尾体育会	Shek Kip Mei Sports Association 
苏利亚足球俱乐部	Suria Football Club 
阿灵顿县_(维吉尼亚州)	Arlington County_(Virginia) 
香港保卫战	Defence of Hong Kong 
谭照华	Tan Zhaohua 
户越magome	Togoshi magome 
饭丰町	Iide Town 
自创女鞋品牌老板	Owner of self-made women's shoes brand 
野泽太三	Tazo Nosou 
林勇介	Lin Yongsuke 
奥地利的玛丽·瓦莱丽	Mary Valerie of Austria 
伊斯兰教历	Islamic calendar 
谢智安	Xie Zhian 
富士重工业	Fuji Heavy Industries 
路易斯维尔大学	University of Louisville 
国产实业集团	Domestic Industry Group 
京士顿河畔豪城西和希素_(英国国会选区)	Kingston Riverside City West and Xisu_ (British Parliamentary District) 
但丁·阿利吉耶里	Dante Alighieri 
巴伐利亚王后奥地利-埃斯特的玛丽亚·特蕾莎	Maria Theresa of Austria-Este, Queen of Bavaria 
存在主义心理学	Existential psychology 
约安-弗里索王子	Prince Joan Frisso 
赵美慧	Zhao Meihui 
杨家枪法	Yang's Spear 
梦想的翅膀	Dream wings 
东突厥语支	East Turkic 
超对称	Super symmetry 
华纳兄弟娱乐公司	Warner Bros. Entertainment 
全球华语科幻星云奖	Global Chinese Science Fiction Nebula Award 
索马里联邦政府	Somalia Federal Government 
p-funk	p-funk 
施连锡克	Schlensik 
动物行为学	Animal behavior 
循道中学	Methodist Middle School 
奥斯曼王朝	Ottoman Dynasty 
绿头鸭	Mallard 
查尔斯顿县_(南卡罗来纳州)	Charleston County_ (South Carolina) 
越南行政区划	Administrative divisions of Vietnam 
中寮里_(旗山区)	Zhongliao Li_(Qishan District) 
神宫杉	Jingu Sugi 
洛夫特斯路球场	Loftus Road Stadium 
曼谷大皇宫	Bangkok Grand Palace 
尚可喜	Shang Kexi 
全俄罗斯中央执行委员会	All-Russian Central Executive Committee 
八里湖体育中心	Balihu Sports Center 
真子秀德	Hidede Mako 
密支那	Myitkyina 
西奈和巴勒斯坦运动	Sinai and Palestine Movement 
rpga988b	rpga988b 
合成摇滚	Synthetic Rock 
义大利太空总署	Italian Space Agency 
abo血型系统	abo blood group system 
植竹繁雄	Shigeo Uetake 
东北育才学校	Northeast Yucai School 
刘震武	Liu Zhenwu 
高加索阿尔巴尼亚王国	Kingdom of Albania, Caucasus 
eclipse公共许可证	eclipse public license 
航空航天	Aerospace 
后藤友香里	Goto Yukari 
尹炳世	Yin Bing Se 
另一种灿烂生活	Another splendid life 
奥古斯塔号重巡洋舰_(ca-31)	USS Augusta heavy cruiser_ (ca-31) 
孔斯坦·范登·斯托克球场	Constance Vanden Stock Stadium 
米南加保足球俱乐部	Minangabao Football Club 
井内舞子	Maiko Iuchi 
国民教育与宣传部	Ministry of National Education and Propaganda 
bgn/pcgn罗马化系统	bgn/pcgn romanization system 
那不勒斯王国	Kingdom of Naples 
朝鲜族_朝-%7b%7d-鲜族	Korean_Chao-%7b%7d-Xian 
沈妃_(明思宗)	Concubine Shen_(Ming Sizong) 
伍嘉良	Wu Jialiang 
台湾客家语拼音方案	Taiwan Hakka Pinyin Plan 
德国第9军团	German 9th Army 
青岛中能	Qingdao Zhongneng 
南类班图语群	Southern Bantu Group 
唐·佩奇_(物理学家)	Don Page_ (physicist) 
卢提西行动	Operation Lutis 
雅赫摩斯-美丽塔蒙	Yahmos-Beautiful Tamon 
台北scsc女子足球队	Taipei scsc women's football team 
中国船舶重工集团	China Shipbuilding Industry Corporation 
五千日圆纸币	Five thousand yen banknotes 
信德院殿	Sindh Temple 
李国立	Li Guoli 
德国总理府	German Chancellery 
南非高级专员	High Commissioner of South Africa 
福斯探照灯影业	Fox Searchlight Pictures 
第三届全国人民代表大会	The Third National People's Congress 
翡翠东方	Emerald Oriental 
信浓町站	Shinanomachi Station 
伦敦大学柏贝克学院	Birkbeck, University of London 
兰达杰耶德联足球俱乐部	Randa Jayed United Football Club 
爱利亚学派	Eliya School 
青少年流行	Teen Pop 
利马索尔足球俱乐部	Limassol Football Club 
八大娱乐台	Eight entertainment stations 
管培俊	Guan Peijun 
李辜心	Li Guxin 
梁文华	Liang Wenhua 
阿梅迪奥八世	Amedio VIII 
古代汉语	ancient Chinese 
郴州市奥林匹克体育中心	Chenzhou Olympic Sports Center 
卡达竞技	Kada Sports 
苏联国防部	Soviet Ministry of Defense 
舞原贤三	Maihara Kenzo 
刘柏坚	Liu Baijian 
南宁普通话	Nanning Mandarin 
非凡电视台	Extraordinary TV 
匹兹堡大学	University of Pittsburgh 
幸福铁板烧	Happy Teppanyaki 
剑桥大学国王学院	King's College, Cambridge University 
首相署部长	Minister in the Prime Minister's Department 
第三组宇航员	The third group of astronauts 
广阳郡	Guangyang County 
强力流行	Powerful pop 
池田多惠子	Ikeda Taeko 
乌克兰共产党	Communist Party of Ukraine 
格迪米尼兹王朝	Gediminz Dynasty 
鸭志田一	Kamo Shidaichi 
面向侧面的程序设计	Aspect-oriented programming 
确认死亡	Confirmed death 
和光市	Wakwang 
中央电视台总部大楼	CCTV Headquarters Building 
杜希达联足球俱乐部	Duhida United Football Club 
波特县_(宾夕法尼亚州)	Porter County_(Pennsylvania) 
何雁诗	He Yanshi 
法属印度支那总督	Governor of French Indochina 
前700年代	700s before 
彼德拉河_(圣胡安河支流)	Piedra River_ (a tributary of the San Juan River) 
罗尚正	Luo Shangzheng 
永勤（宾夕法尼亚州）	Yong Qin (Pennsylvania) 
中国人民政治协商会议第八届全国委员会委员名单	List of members of the Eighth National Committee of the Chinese People's Political Consultative Conference 
美国野战炮兵进行曲	American Field Artillery March 
康涅狄格州州长	Governor of Connecticut 
小屋松知哉	Hut Matsutoya 
大众汽车	Volkswagen 
大明殿	Daming Hall 
袁英明	Yuan Yingming 
罗锡畴	Luo Xichou 
北港郡	Beigang County 
拉科鲁尼亚竞技	Atletico A Coruna 
朝鲜大学（日本）	Chosun University (Japan) 
古尔德带	Gould Belt 
国家学说	National doctrine 
伊德利卜市战役	Battle of Idlib 
亚历山德鲁伊万库扎大学	Alexandru Ivankuza University 
mr._probz	mr._probz 
yasodharapura	Yashodharapur 
布由德利的鲍德温伯爵	Earl Baldwin of Bewdley 
国立屏东大学	National Pingtung University 
偷偷爱着你	Secretly loving you 
罗克兰县_(纽约州)	Rockland County_(New York State) 
克莱门斯·温斯拉_(萨克森)	Clemens Winsla_ (Saxony) 
洛约什二世	Lojos II 
国际中间民主联盟	International union of middle democracy 
圣安瑟伦学院	Saint Anselm College 
天狼星卫星广播	Sirius Satellite Radio 
亨利七世	Henry VII 
汶莱国家足球协会	Brunei National Football Association 
寝宫侍臣	Courtier 
开普敦国际机场	Cape Town International Airport 
伊朗足球协会	Iran Football Association 
梁志荣	Liang Zhirong 
罗里_(北卡罗来纳州)	Rory_ (North Carolina) 
b-50超级堡垒轰炸机	b-50 superfortress bomber 
徐海贞	Xuhai 
第四代阿伯丁伯爵乔治·汉密尔顿-戈登	George Hamilton-Gordon, 4th Earl of Aberdeen 
欧阳靖_(消歧义)	Ouyang Jing_ (disambiguation) 
nbc新闻	nbc news 
国立台东高级商业职业学校	National Taitung Advanced Commercial Vocational School 
和田地区	Hotan area 
星空传媒	Star Media 
维高文化	Vigo Culture 
小川庆治朗	Ogawa Keijiro 
金子轻松出来吧	Let the gold come out easily 
比谢列	Biscele 
中国摇滚乐	Chinese Rock 
钱嘉东	Qian Jiadong 
细胞病理学	Cytopathology 
厄瓜多行政区划	Administrative divisions of Ecuador 
亚历山大二世	Alexander II 
起源中心	Origin Center 
天主教伯明翰总教区	Catholic Archdiocese of Birmingham 
世界拉力赛车	World Rally Car 
摩罗西亚国王列表	List of Kings of Morosia 
社会工作者	social worker 
杨省世	Yang Shengshi 
.to	.to 
国防部陆军司令部	Department of Defense Army Command 
纳兹里	Nazri 
指宿洋史	Hiroshi Ibusuki 
三户町	Sannohe Town 
州际公路系统	Interstate Highway System 
熊谷弘	Hiroshi Kumagai 
朝鲜国家少年足球队	North Korea National Junior Football Team 
五十岚广行	Igarashi Hiroyuki 
弗拉察博特夫足球俱乐部	Vracabotev Football Club 
墨西哥超级杯	Mexican Super Cup 
志水宗清	Munekiyo Shimizu 
武汉音乐学院	Wuhan Conservatory of Music 
乔子女王	Queen Joe 
黄金海岸联	Gold Coast United 
前莱茵河	Former Rhine 
坂本哲志	Tetsushi Sakamoto 
光子女王	Photon queen 
尚泰王	Shang Tai Wang 
中南工业大学	Central South University of Technology 
西班牙贵族	Spanish nobility 
法兰克·罗素，第二代罗素伯爵	Frank Russell, second generation Earl Russell 
诺沃克_(康涅狄格州)	Norwalk_ (Connecticut) 
北京北控女子足球俱乐部	Beijing Beikong Women's Football Club 
长荣国际	Evergreen International 
赛峰集团	Safran Group 
三司官	Three officers 
国立武汉大学	National Wuhan University 
时代华纳有线球场	Time Warner Cable Arena 
工会会员	Union member 
市参议员	City Senator 
后白河天皇	Emperor Shirakawa 
步步惊心：丽	Startling at every step: Li 
印度邮政编码	India Postcode 
二二六事件	226 event 
鲍克斯侯爵	Marquis of Box 
雷明顿兰德公司	Remington Rand Corporation 
大韩民国建国勋章	Medal for the Founding of the Republic of Korea 
"暴风雨行动"]	"Operation Storm"] 
芬兰中间党	Finnish Center Party 
温尼伯詹姆斯·阿姆斯特朗·理查森国际机场	Winnipeg James Armstrong Richardson International Airport 
清华学堂	Tsinghua Academy 
科瓦利斯_(俄勒冈州)	Corvallis_ (Oregon) 
畑野森生	Morio Hatano 
福斯国际电视网	Fox International Television Network 
卢安达宾菲加	Luanda Binfiga 
栉引一纪	Kushiyuki Ichiki 
澳门电台	Radio Macau 
梶山阳平	Kajiyama Yohei 
安妮阿伦德尔县	Anne Arundel County 
赞尼斯奥	Zanniso 
二十世纪福斯动画	Twentieth Century Fox Animation 
旃陀罗·笈多一世	Chandra Gupta I 
范成良	Fan Chengliang 
中华民国维新政府	Government of the Republic of China 
苏格兰高地	Scottish highlands 
南奥塞梯议会	South Ossetian Parliament 
蝙蝠女	Batgirl 
后宫_(电视剧)	Harem_(TV series) 
章瑞珍	Zhang Ruizhen 
s:国家安全会议组织法	s: National Security Conference Organic Law 
东罗马帝国皇帝	Eastern Roman Emperor 
叙利亚海军	Syrian Navy 
金郡_(华盛顿州)	King County_(Washington State) 
米沙鄢语支	Visayan branch 
德国邮政银行	Deutsche Post Bank 
山口正朗	Masao Yamaguchi 
板块构造论	Plate tectonics 
邝建新	Kwong Jianxin 
爱沙尼亚共产党	Communist Party of Estonia 
埃塞俄比亚君主列表	List of monarchs of Ethiopia 
欧洲学院	European Academy 
.th	.th 
印度尼西亚联邦共和国内阁	Cabinet of the Federal Republic of Indonesia 
长宁公主_(唐中宗之女)	Princess Changning_(Daughter of Tang Zhongzong) 
雅各比	Jacoby 
乌鲁木齐红山体育中心	Red Mountain Sports Center, Urumqi 
立陶宛共产党	Communist Party of Lithuania 
洛克希德公司	Lockheed Corporation 
约克大教堂	York Minster 
亚历山大大帝战争	Alexander the Great War 
栗原类	Kurihara 
英国摩托车大奖赛	British Motorcycle Grand Prix 
孝端显皇后	Xiao Duan Xian Queen 
爱尔兰国王	King of Ireland 
余政宪	Yu Zhengxian 
冲绳返还	Okinawa return 
理查德_(贝尔奈公爵)	Richard_ (Duke of Bernay) 
吴超觉	Wu Chaojue 
芬兰总督	Governor of Finland 
秦皇岛奥体中心	Qinhuangdao Olympic Sports Center 
史蒂芬·卡特_(巴恩斯的卡特男爵)	Stephen Carter_ (Baron Carter of Barnes) 
新古典音乐	Neoclassical music 
社会民粹主义	Social populism 
瓦伦萨_(巴伊亚州)	Valença_ (State of Bahia) 
太平公主	Princess Taiping 
小波兰省	Lesser Poland 
温特沃思_(澳大利亚国会选区)	Wentworth_ (Australian Parliamentary Constituency) 
中部标准时区	Central Standard Time Zone 
宗座梵蒂冈城国委员会	Pontifical Council of the Vatican City State 
国民收入	national income 
刘淑女_(明光宗)	Lady Liu_(Ming Guangzong) 
聊斋奇女子	Liao Zhai Qi Women 
i̇lhan_cavcav	i̇lhan_cavcav 
纽伯里_(英国国会选区)	Newbury_(British Parliamentary District) 
东线从军勋章	Eastern Frontier Medal 
方亭足球学院	Fangting Football Academy 
彩虹罗曼史	Rainbow Romance 
爱尔兰国会选区	Irish Parliamentary District 
邓六金	Deng Liujin 
皇极天皇	Emperor 
我的秘密饭店	My secret restaurant 
比利时摇滚	Belgian Rock 
剧院金属	Theater metal 
沈阳铁西体育场	Shenyang Tiexi Stadium 
空中巴士a300-600st	Airbus a300-600st 
渥太华麦克唐纳－卡蒂埃国际机场	Ottawa Macdonald-Cartier International Airport 
莱德维尔_(科罗拉多州)	Leadville_ (Colorado) 
兴宣大院君	Lord Xingxuan 
法国国立高等矿业学院集团	French National Higher School of Mining Group 
首部曲	First part 
国家发展委员会档案管理局	National Development Commission Archives Administration 
孝明高皇后	Empress Xiao Ming Gao 
英国入侵	British invasion 
怪物农场	Monster farm 
秕糠学会	The Chaff Society 
俄亥俄中心学院	Ohio Central College 
在线和离线	Online and offline 
昆明南动车运用所	Kunming South Railway Station 
大湾里	Dawanli 
戈尔诺-巴达赫尚自治州	Gorno-Badakhshan Autonomous Region 
韩国独立运动	Korean Independence Movement 
赫尔佐格和德梅隆	Herzog and De Meuron 
美国第2装甲师	U.S. 2nd Armored Division 
亨利王子_(帕尔马)	Prince Henry_ (Parma) 
滨海站	Binhai Station 
中谷元	Gen Nakatani 
苏利南中央银行	Central Bank of Suriname 
兰开斯特的约翰，第一代贝德福德公爵	John of Lancaster, the first Duke of Bedford 
新右派	New Right 
海港大桥	Harbour bridge 
社西里	Company Nishizato 
波利比乌斯	Polybius 
印度音乐	Indian music 
樋口宗孝	Munetaka Higuchi 
天彰有道	Tian Zhang Youdao 
渊男建	Yuan Nanjian 
20世纪	20th Century 
杨俊生_(足协官员)	Yang Junsheng_(Football Association Official) 
肯塔基州众议院	Kentucky House of Representatives 
安达赫治	Unterhaching 
南京五台山体育中心	Nanjing Wutaishan Sports Center 
ef-111a渡鸦式电子战飞机	ef-111a Raven electronic warfare aircraft 
波兰军团第一旅	First Brigade of the Polish Army 
弗里德里希·克里斯蒂安_(萨克森选侯)	Friedrich Christian_ (Elector of Saxony) 
下田北斗	Shimoda Hokuto 
圣伊波利特及圣露西亚同主教座堂	Cathedral of St. Hippolyte and St. Lucia 
浙江绿城	Zhejiang Greentown 
劲爆冰上曲棍球系列	Madden Ice Hockey Series 
广州恒大淘宝	Guangzhou Evergrande Taobao 
葡萄牙超级杯	Portuguese Super Cup 
崔民永	Cui Minyong 
全男孩竞技俱乐部	All Boys Athletic Club 
金球奖最佳电影女配角	Golden Globe Awards for Best Supporting Actress in a Movie 
首都师范大学附属中学	The High School Attached to Capital Normal University 
台湾栾树	Taiwan Luan Shu 
甄美里	Zhen Miri 
tarcienne	rubbing 
山明里	Akari Yama 
恭子女王	Queen Kyoko 
奥地利统治者列表	List of Austrian rulers 
蒂罗尔因斯布鲁克足球俱乐部	Tirol Innsbruck Football Club 
孙大川	Sun Dachuan 
小田急电铁	Odakyu Electric Railway 
令政策	Order policy 
长郡中学	Long County Middle School 
三月十八	March 18 
周群达	Zhou Qunda 
圣荷西市议会	San Jose City Council 
多语言	multi-language 
嘉当－迪厄多内定理	Cartan-Dieudon Theorem 
马里亚纳群岛及帛琉战事	Mariana Islands and Palau War 
冈崎和也	Kazuya Okazaki 
中丸雄一	Nakamaru Yuichi 
国际体育组织列表	List of International Sports Organizations 
凯恩与林奇：死人	Kane and Lynch: The Dead 
里斯本竞技b队	Sporting Lisbon b team 
能源方案球馆	Energy Solutions Arena 
赫塞哥维纳-涅雷特瓦州	Herzegovina-Neretva 
捷克斯洛伐克语言	Czechoslovak language 
白先勇	Bai Xianyong 
麦克唐纳飞行器公司	Macdonald Aircraft Company 
娜莉曼_(埃及王后)	Naliman_ (Queen of Egypt) 
波利萨里奥阵线	Polisario Front 
福尔斯彻奇_(维吉尼亚州)	Falls Church_ (Virginia) 
太宰府天满宫	Dazaifu Tenmangu Shrine 
【国家级人文社会科学重点研究基地】	【National Humanities and Social Sciences Key Research Base】 
file:明宪宗像.jpg	file: Munakata Munakata.jpg 
小布施町	Obuse Town 
.ga	.. But 
法国财政部长	French Minister of Finance 
巴西雷亚尔	Brazilian Real 
kolín	cologne 
非洲俱乐部	African club 
互动新闻台	Interactive News Channel 
厄里斯_(希腊神话)	Eris_ (Greek mythology) 
路易-安托万·加尔涅-帕热斯	Louis-Antoine Garnet-Pages 
密尔瓦基酿酒人	Milwaukee Brewers 
纳谷六朗	Nakuro 
雪佛兰科尔维特	Chevrolet Corvette 
森实阳三	Mori Yozo 
鲲洲里	Kunzhouli 
大冢站_(东京都)	Otsuka Station_(Tokyo) 
摩城唱片	Motown Records 
霹雳火	Thunderbolt 
孙国文	Sun Guowen 
田山凉成	Ryosei Tayama 
荷兰皇家海军学院	Royal Dutch Naval Academy 
伊伦·约里奥-居里	Irene Yorio-Curie 
荷尔斯泰因	Holstein 
一川保夫	Yasuo Ichikawa 
独立社会民主人士联盟	League of Independent Social Democrats 
比斯柏路夫斯	Bisbroughs 
阿基坦公爵	Duke of Aquitaine 
孙士毅	Sun Shiyi 
达尔文国际机场	Darwin International Airport 
欧洲篮球锦标赛	European Basketball Championship 
提克里特	Tikrit 
凯尔特音乐	Celtic Music 
美国航空中心	American Airlines Center 
阿道弗斯王子，第1代剑桥侯爵	Prince Adolphus, 1st Marquis of Cambridge 
苗金凤	Miao Jinfeng 
兰陵王_(电视剧)	King of Lanling_(TV series) 
下诺夫哥罗德州	Nizhny Novgorod Oblast 
法国革命战争	French Revolutionary War 
后庞克复兴	Post-punk revival 
郑春顺	Zheng Chunshun 
宾州大学	University of Pennsylvania 
福田靖	Fukuda Yasushi 
佛罗里达州州长	Governor of Florida 
罗曼天主教	Roman Catholic 
邦联制	Confederate System 
侯赛因-阿里·蒙塔泽里	Hussein-Ali Montazeri 
松山里	Songshanli 
小亨利·克莱	Henry Clay Jr. 
钢桁拱桥	Steel Truss Arch Bridge 
自杀黑金属	Suicide black metal 
弗里德里希·马格努斯六世_(索尔姆斯-韦尔登费尔斯)	Friedrich Magnus VI_ (Solms-Weldenfels) 
日本语系	Department of Japanese 
藤本修司	Shuji Fujimoto 
保加利亚足球先生	Bulgarian Footballer 
三级方程式大师赛	Formula 3 Masters 
宝藏王	Treasure King 
血汗泪	Blood, sweat and tears 
seganet	seganet 
北卡罗来纳大学	University of North Carolina 
贝勒尼基三世	Beleniki III 
里欧·梅麒麟	Leo Meiqilin 
aluminosilicate	aluminosilicate 
全联盟列宁主义青年共产主义联盟	All League Leninist Youth Communist League 
事业单位	Institutions 
日剧学院赏	Japanese Drama Academy Award 
美国国防部徽章	U.S. Department of Defense badge 
格鲁吉亚足球总会	Georgia Football Association 
法国23岁以下国家足球队	France U23 National Football Team 
legendaddy	legendaddy 
俄亥俄州行政区划	Ohio administrative divisions 
陆军联足球会	Army United Football Club 
中华民国一级上将列表	List of Generals of the Republic of China 
美国陆军第5军	U.S. Army 5th Corps 
乾隆帝皇九子	Emperor Qianlong's Nine Sons 
都东区	Dudong District 
扬尼克·韦斯特高	Yannick Westgaard 
中国伊斯兰教	Chinese Islam 
杜宇新	Du Yuxin 
变形本	Convertible 
金日成综合大学	Kim Il Sung University 
久保田城	Kubota Castle 
爱情食物链	Love food chain 
第二次萨姆特堡战役	Second Battle of Fort Sumter 
海军卿	Navy officer 
安德鲁·里克曼爵士	Sir Andrew Rickman 
匈牙利统治者列表	List of rulers of Hungary 
神游舞曲	Wandering dance 
塞尔维亚摇滚	Serbian Rock 
路易丝公主_(比利时)	Princess Louise_(Belgium) 
宫崎县旗	Flag of Miyazaki Prefecture 
南洲里	Nanzhouli 
读卖巨人	Yomiuri Giants 
休斯西部航空	Hughes West Air 
美国铸币局	United States Mint 
波兰人民党_(1945–1949)	Polish People's Party_(1945–1949) 
金道勋	Kim Do-hoon 
空军元帅	Air Marshal 
希腊邮政编码	Greece Postcode 
崇仁亲王妃百合子	Princess Chongren Yuriko 
谈情说案	Talk about the case 
国立交通大学	National Chiao Tung University 
巴黎条约_(1783年)	Treaty of Paris_ (1783) 
哈里斯县_(德克萨斯州)	Harris County_(Texas) 
里查·韦尔斯利，第一代韦尔斯利侯爵	Richard Wellesley, the first Marquis of Wellesley 
dr%3fme	dr%3fme 
冰岛摇滚	Icelandic Rock 
穆罕默德-巴盖尔·加利巴夫	Muhammad Bagher Galibuff 
诺福克县_(马萨诸塞州)	Norfolk County_(Massachusetts) 
中国证券监督管理委员会	China Securities Regulatory Commission 
保加利亚君主列表	List of Bulgarian monarchs 
克莱儿_(卢森堡王妃)	Claire_ (Princess of Luxembourg) 
桃乐丝·麦美伦夫人	Mrs. Dorothy McMillan 
祖伊约克	Zuyyok 
高城灵似	Similar to Reni Takagi 
乌克兰国立科学院	National Academy of Sciences of Ukraine 
匈牙利工人党	Hungarian workers' party 
唐古拉山脉	Tanggula Mountains 
波兰王后列表	List of Queens of Poland 
卢森堡中央银行	Central Bank of Luxembourg 
美国陆军第10山地师	U.S. Army 10th Mountain Division 
娱乐大网ㄎㄚ	Entertainment Big Net ㄎ ㄚ 
莫比尔机场	Mobile Airport 
德国绿党	German Green Party 
下坑里	In the pit 
浦项钢铁	Pohang Steel 
绫波零	Ayanami Zero 
义大利-西罗曼语支	Italian-Siromanese 
伯克县_(宾夕法尼亚州)	Burke County_(Pennsylvania) 
恋爱的力量	The power of love 
华盛顿州徽章	Washington State Coat of Arms 
马姓	Ma Surname 
亚利桑那响尾蛇	Arizona Rattlesnake 
地方分权制	Decentralization 
osakeyhtiö	limited company 
野末武志	Takeshi Nozue 
美国南部	Southern United States 
皇家卡塔赫纳	Royal Cartagena 
松山正治	Masaji Matsuyama 
神艺文化	Shenyi Culture 
洞里萨湖	Tonle Sap 
原子弹爆炸圆顶屋	Atomic Bomb Dome 
从属国	Dependent country 
美国演员工会奖最佳女主角	Screen Actors Guild Awards for Best Actress 
1603年联合法令	Union Act 1603 
住田贵彦	Sumita Toshihiko 
冯检基	Frederick 
内政部警政署	Police Department of the Ministry of the Interior 
瑞典中央银行	Central bank of sweden 
匈牙利青年共产主义联盟	Hungarian youth communist union 
乡田龙一	Goda Ryuichi 
明星保镳99天	Star Warrant 99 days 
经济管理学	Economic Management 
直接选举	Direct election 
东麻由美	Higashi Mayumi 
费加亚体育会	Fejaya Sports Club 
纳粹党掌权	Nazi Party in Power 
欧洲女子手球锦标赛	European Women's Handball Championship 
都会统计区	Metropolitan Statistical Area 
徐立毅	Xu Liyi 
索尼音乐娱乐公司	Sony Music Entertainment 
通州区_(南通市)	Tongzhou District_(Nantong City) 
阿尔西诺伊二世	Arcinoy II 
克罗地亚国家银行	Croatian National Bank 
波兰总统	President of Poland 
v8_(电视频道l)	v8_(TV channel l) 
阿根廷总统列表	List of Presidents of Argentina 
解放军女子足球俱乐部	People's Liberation Army Women's Football Club 
日本动画公司	Japan Animation Company 
丰臣秀次	Toyotomi Hideji 
连拿特	Linate 
昆西・普罗梅斯	Quincy Promes 
新居辰基	Xinju Chenji 
拿督端依布拉欣	Datuk Duan Ibrahim 
艾尔索达体育会	Al Soda Sports Club 
伊斯兰神学	Islamic Theology 
程序编程	Programming 
波兰下议院	Polish House of Commons 
中部赛区	Central Division 
宾福特足球俱乐部	Binford Football Club 
玛丽·斯图亚特_(英国长公主及奥兰治王妃)	Mary Stuart_ (The Princess of England and Princess of Orange) 
非政府组织	NGO 
维多利亚公主（萨克森-科堡-哥达）	Princess Victoria (Saxony-Coburg-Gotha) 
统合幕僚监部	Integrated Staff Supervision Department 
影子内阁外务大臣	Shadow cabinet foreign minister 
拉什塔特和约	Rashtat Peace Treaty 
黄绿	Yellow-green 
美国文理学院	American College of Arts and Sciences 
奥得河畔科斯琴	Koschen on Oder 
巴腾堡公主玛丽	Princess Marie of Battenberg 
我们的巴林	Our Bahrain 
南加州大学间体育联盟	Inter-University Sports League of Southern California 
太田吉彰	Yoshiaki Ota 
.mg	.mg 
西班牙邮编	Spain postcode 
社会共和党	Social Republican Party 
教宗利伯略	Pope Liberio 
史坦威公司	Steinway Corporation 
地方话	Local dialect 
兰州铁路局	Lanzhou Railway Bureau 
柳重言	Liu Zhongyan 
中国社会科学院研究生院	CASS Graduate School 
邵维锺	Shao Weizhong 
沪杭客运专线	Shanghai-Hangzhou Passenger Dedicated Line 
天伦_(无线电视剧)	Tianlun_ (wireless TV series) 
美国国防部部长	Secretary of Defense 
万物有灵	Animism 
卡希亚斯公爵城	Ducal City of Caxias 
.ki	. 
每局被上垒率	Base rate per game 
环渤海经济圈	Bohai Rim Economic Circle 
北易洛魁语族	Northern Iroquois 
utc-2	utc-2 
河本裕之	Hiroyuki Komoto 
德莉比娣丝	Delibidis 
亚历山大·九科夫	Alexander Jikov 
致，第三者	To the third party 
敦子女王	Queen Atsuko 
三色旗_(罗马尼亚)	Tricolor_(Romania) 
朴文路球场	Park Man Road Stadium 
疯克金属	Funk Metal 
大政绚	Omasasa 
刚果民主共和国国家足球队	Democratic Republic of the Congo National Football Team 
西安铁路局	Xi'an Railway Bureau 
立法会议	Legislative Council 
小手川弘基	Otegawa Hiroki 
中华人民共和国全国运动会	National Games of the People's Republic of China 
答剌麻八剌	Answer Mabala 
黑金属音乐列表	Black Metal Music List 
英格兰足球依斯米安联赛超联组	English Football Ismian League Super League 
赵冲久	Zhao Chongjiu 
格伦菲尔德_(莱斯特郡)	Glenfield_(Leicestershire) 
西子湾站	Xiziwan Station 
区检察长	District attorney general 
满洲国国务院	State Council of Manchuria 
伊朗军衔	Iranian military rank 
波映凯橡胶足球会	Boyingkai Rubber Football Club 
义大利力量党	Forza italy 
邓安宁	Deng Anning 
广州市市长列表	List of Mayors of Guangzhou 
迦纳总统	President of Ghana 
量子场论	Quantum field theory 
意大利王后列表	List of Queens of Italy 
伊朗军衔和徽章	Iranian military ranks and emblems 
住左边住右边	Live on the left and live on the right 
韩国总理列表	List of Prime Ministers of South Korea 
厄勒布鲁大学	University of Orebro 
中国国际广播电台	China Radio International 
清水溪_(集集镇)	Qingshuixi_(Jiji Town) 
一般均衡理论	General equilibrium theory 
韩达德	Handard 
第一世哲布尊丹巴呼图克图	The First Jebzundamba Hutuktu 
梁国新	Liang Guoxin 
义大利统一	Unification of Italy 
发生认识论	Genetic epistemology 
宗教改革	Religious reformation 
卢安达国际	Luanda International 
木之原贺子	Kinohara Kako 
烈日千阳	Thousand Suns 
王华庆	Wang Huaqing 
流行民谣	Popular ballad 
乃马真·脱列哥那	Naimajin Tregona 
沙福克军团	Suffolk Corps 
多元文化	Multiculturalism 
歌手价值	Singer value 
爱德华亲王_(约克和奥尔巴尼公爵)	Prince Edward_ (Duke of York and Albany) 
加拿大皇家学会	Royal Society of Canada 
费高云	Fei Gaoyun 
葡萄牙23岁以下国家足球队	Portugal U23 National Football Team 
德川齐	Tokugawa 
到21时为止的灰姑娘	Cinderella until 21 o'clock 
新施公案	Xin Shi Gong An 
中国铁路25t型客车	China Railway 25t passenger car 
金融服务	Financial Services 
三根和起	Three roots 
布罗姆利足球俱乐部	Bromley Football Club 
波兰左翼	Polish Left 
施比拉郡主_(萨克森-科堡-哥达)	Lord Spira_ (Saxony-Coburg-Gotha) 
因加·芬斯多特尔	Inga Finsdotter 
中央高地区政府	Central High Regional Government 
"釜山ipark足球俱乐部"]	"Busan ipark Football Club"] 
张龙敏	Zhang Longmin 
国民共和党	National Republican Party 
三星生命保险	Samsung Life Insurance 
村上爱	Murakami Ai 
土耳其大国民议会大楼	Grand National Assembly Building of Turkey 
井上裕大	Inoue Yuta 
雷森蒂足球俱乐部	Resenti Football Club 
许嘉栋	Xu Jiadong 
美国第66装甲团	U.S. 66th Armored Regiment 
中根芳三郎	Yoshisaburo Nakane 
周静帝	Zhou Jingdi 
克洛维二世	Clovis II 
汪一光	Wang Yiguang 
你好！小姐	Hello there! Miss 
jean-jacques_lecercle	jean-jacques_lecercle 
博雷尔－卡拉西奥多里理论	Borrell-Carathedori Theory 
马华公会	Malaysia Chinese Association 
雷玉其	Lei Yuqi 
剑桥大学彼得学院	Peter College, Cambridge University 
熊谷纱希	Kumagai Saki 
帕特帕塔尔─托赖语言	Pat Patar-Torai Language 
和味浓情	Harmony 
金斯敦_(诺福克岛)	Kingston_(Norfolk Island) 
私营企业	Private enterprise 
和歌山县旗	Wakayama flag 
义顺集选区	Yishun GRC 
前207年	207 years ago 
汉密尔顿学院	Hamilton College 
广州松日足球俱乐部	Guangzhou Songri Football Club 
塞提夫协定体育俱乐部	Setif Accord Sports Club 
苏联最高苏维埃	Supreme Soviet of the USSR 
胜安航空	SilkAir 
洲际弹道飞弹	Intercontinental ballistic missile 
芝加哥浩室	Chicago House 
托顿咸热刺足球会	Tottenham Hotspur Football Club 
斯摩棱斯克战役	Battle of Smolensk 
亚历山德拉女大公	Grand Duke Alexandra 
葡萄牙青年足球队	Portugal Youth Football Team 
保加利亚超级杯	Bulgaria Super Cup 
冬季奥林匹克运动会	Winter Olympic Games 
华盛顿会议	Washington Conference 
美国运通	American Express 
başcalia	bascalia 
伊拉克利翁	Heraklion 
tbs电视	tbs tv 
